Unformatted_API_UWI_12,API_UWI,WellName,ProducingMonth,TotalCompletionMonths,LiquidsProd_BBL,GasProd_MCF,WaterProd_BBL,CumLiquids_BBL,CumGas_MCF,CumWater_BBL
300153312200,30-015-33122,WEST MALAGA 12 STATE COM 001,2004-01-01,1,0,8100,2,0,8100,2
300153312200,30-015-33122,WEST MALAGA 12 STATE COM 001,2004-02-01,2,0,21804,58,0,29904,60
300153312200,30-015-33122,WEST MALAGA 12 STATE COM 001,2004-03-01,3,0,30425,116,0,60329,176
300153312200,30-015-33122,WEST MALAGA 12 STATE COM 001,2004-04-01,4,0,26487,54,0,86816,230
300153312200,30-015-33122,WEST MALAGA 12 STATE COM 001,2004-05-01,5,0,24846,126,0,111662,356
300153312200,30-015-33122,WEST MALAGA 12 STATE COM 001,2004-06-01,6,0,21850,119,0,133512,475
300153312200,30-015-33122,WEST MALAGA 12 STATE COM 001,2004-07-01,7,0,20581,81,0,154093,556
300153312200,30-015-33122,WEST MALAGA 12 STATE COM 001,2004-08-01,8,0,17266,71,0,171359,627
300153312200,30-015-33122,WEST MALAGA 12 STATE COM 001,2004-09-01,9,0,15189,46,0,186548,673
300153312200,30-015-33122,WEST MALAGA 12 STATE COM 001,2004-10-01,10,0,15615,75,0,202163,748
300153312200,30-015-33122,WEST MALAGA 12 STATE COM 001,2004-11-01,11,0,13324,74,0,215487,822
300153312200,30-015-33122,WEST MALAGA 12 STATE COM 001,2004-12-01,12,0,11744,69,0,227231,891
300153312200,30-015-33122,WEST MALAGA 12 STATE COM 001,2005-01-01,13,0,12564,116,0,239795,1007
300153312200,30-015-33122,WEST MALAGA 12 STATE COM 001,2005-02-01,14,0,10622,52,0,250417,1059
300153312200,30-015-33122,WEST MALAGA 12 STATE COM 001,2005-03-01,15,0,11278,101,0,261695,1160
300153312200,30-015-33122,WEST MALAGA 12 STATE COM 001,2005-04-01,16,0,10198,74,0,271893,1234
300153312200,30-015-33122,WEST MALAGA 12 STATE COM 001,2005-05-01,17,0,9554,141,0,281447,1375
300153312200,30-015-33122,WEST MALAGA 12 STATE COM 001,2005-06-01,18,0,8241,142,0,289688,1517
300153312200,30-015-33122,WEST MALAGA 12 STATE COM 001,2005-07-01,19,2,7637,42,2,297325,1559
300153312200,30-015-33122,WEST MALAGA 12 STATE COM 001,2005-08-01,20,0,8093,84,2,305418,1643
300153312200,30-015-33122,WEST MALAGA 12 STATE COM 001,2005-09-01,21,0,7435,51,2,312853,1694
300153312200,30-015-33122,WEST MALAGA 12 STATE COM 001,2005-10-01,22,0,7876,48,2,320729,1742
300153312200,30-015-33122,WEST MALAGA 12 STATE COM 001,2005-11-01,23,0,6718,48,2,327447,1790
300153312200,30-015-33122,WEST MALAGA 12 STATE COM 001,2005-12-01,24,0,5195,87,2,332642,1877
300153312200,30-015-33122,WEST MALAGA 12 STATE COM 001,2006-01-01,25,0,7264,219,2,339906,2096
300153312200,30-015-33122,WEST MALAGA 12 STATE COM 001,2006-02-01,26,0,6184,230,2,346090,2326
300153312200,30-015-33122,WEST MALAGA 12 STATE COM 001,2006-03-01,27,0,6545,93,2,352635,2419
300153312200,30-015-33122,WEST MALAGA 12 STATE COM 001,2006-04-01,28,0,6057,90,2,358692,2509
300153312200,30-015-33122,WEST MALAGA 12 STATE COM 001,2006-05-01,29,0,5661,78,2,364353,2587
300153312200,30-015-33122,WEST MALAGA 12 STATE COM 001,2006-06-01,30,0,5495,59,2,369848,2646
300153312200,30-015-33122,WEST MALAGA 12 STATE COM 001,2006-07-01,31,0,4217,134,2,374065,2780
300153312200,30-015-33122,WEST MALAGA 12 STATE COM 001,2006-08-01,32,0,5200,103,2,379265,2883
300153312200,30-015-33122,WEST MALAGA 12 STATE COM 001,2006-09-01,33,0,4384,104,2,383649,2987
300153312200,30-015-33122,WEST MALAGA 12 STATE COM 001,2006-10-01,34,0,3285,18,2,386934,3005
300153312200,30-015-33122,WEST MALAGA 12 STATE COM 001,2006-11-01,35,0,3205,44,2,390139,3049
300153312200,30-015-33122,WEST MALAGA 12 STATE COM 001,2006-12-01,36,0,7828,24,2,397967,3073
300153312200,30-015-33122,WEST MALAGA 12 STATE COM 001,2007-01-01,37,0,5958,23,2,403925,3096
300153312200,30-015-33122,WEST MALAGA 12 STATE COM 001,2007-02-01,38,0,3028,184,2,406953,3280
300153312200,30-015-33122,WEST MALAGA 12 STATE COM 001,2007-03-01,39,0,6593,35,2,413546,3315
300153312200,30-015-33122,WEST MALAGA 12 STATE COM 001,2007-04-01,40,0,7144,132,2,420690,3447
300153312200,30-015-33122,WEST MALAGA 12 STATE COM 001,2007-05-01,41,0,7161,67,2,427851,3514
300153312200,30-015-33122,WEST MALAGA 12 STATE COM 001,2007-06-01,42,0,6672,140,2,434523,3654
300153312200,30-015-33122,WEST MALAGA 12 STATE COM 001,2007-07-01,43,0,6629,118,2,441152,3772
300153312200,30-015-33122,WEST MALAGA 12 STATE COM 001,2007-08-01,44,0,5422,89,2,446574,3861
300153312200,30-015-33122,WEST MALAGA 12 STATE COM 001,2007-09-01,45,0,4039,21,2,450613,3882
300153312200,30-015-33122,WEST MALAGA 12 STATE COM 001,2007-10-01,46,0,4764,136,2,455377,4018
300153312200,30-015-33122,WEST MALAGA 12 STATE COM 001,2007-11-01,47,0,3820,113,2,459197,4131
300153312200,30-015-33122,WEST MALAGA 12 STATE COM 001,2007-12-01,48,0,3604,127,2,462801,4258
300153312200,30-015-33122,WEST MALAGA 12 STATE COM 001,2008-01-01,49,0,3309,93,2,466110,4351
300153312200,30-015-33122,WEST MALAGA 12 STATE COM 001,2008-02-01,50,0,5349,132,2,471459,4483
300153312200,30-015-33122,WEST MALAGA 12 STATE COM 001,2008-03-01,51,0,5452,4,2,476911,4487
300153312200,30-015-33122,WEST MALAGA 12 STATE COM 001,2008-04-01,52,0,4565,34,2,481476,4521
300153312200,30-015-33122,WEST MALAGA 12 STATE COM 001,2008-05-01,53,0,4774,39,2,486250,4560
300153312200,30-015-33122,WEST MALAGA 12 STATE COM 001,2008-06-01,54,0,3942,10,2,490192,4570
300153312200,30-015-33122,WEST MALAGA 12 STATE COM 001,2008-07-01,55,0,3822,3,2,494014,4573
300153312200,30-015-33122,WEST MALAGA 12 STATE COM 001,2008-08-01,56,0,3497,29,2,497511,4602
300153312200,30-015-33122,WEST MALAGA 12 STATE COM 001,2008-09-01,57,0,2722,46,2,500233,4648
300153312200,30-015-33122,WEST MALAGA 12 STATE COM 001,2008-10-01,58,0,2542,9,2,502775,4657
300153312200,30-015-33122,WEST MALAGA 12 STATE COM 001,2008-11-01,59,0,2204,2,2,504979,4659
300153312200,30-015-33122,WEST MALAGA 12 STATE COM 001,2008-12-01,60,0,1826,0,2,506805,4659
300153312200,30-015-33122,WEST MALAGA 12 STATE COM 001,2009-01-01,61,0,1856,0,2,508661,4659
300153312200,30-015-33122,WEST MALAGA 12 STATE COM 001,2009-02-01,62,0,939,0,2,509600,4659
300153312200,30-015-33122,WEST MALAGA 12 STATE COM 001,2009-03-01,63,0,1512,0,2,511112,4659
300153312200,30-015-33122,WEST MALAGA 12 STATE COM 001,2009-04-01,64,0,1430,0,2,512542,4659
300153312200,30-015-33122,WEST MALAGA 12 STATE COM 001,2009-05-01,65,0,1460,0,2,514002,4659
300153312200,30-015-33122,WEST MALAGA 12 STATE COM 001,2009-06-01,66,0,2027,0,2,516029,4659
300153312200,30-015-33122,WEST MALAGA 12 STATE COM 001,2009-07-01,67,0,1272,0,2,517301,4659
300153312200,30-015-33122,WEST MALAGA 12 STATE COM 001,2009-08-01,68,0,727,0,2,518028,4659
300153312200,30-015-33122,WEST MALAGA 12 STATE COM 001,2009-09-01,69,0,503,0,2,518531,4659
300153312200,30-015-33122,WEST MALAGA 12 STATE COM 001,2009-10-01,70,0,601,0,2,519132,4659
300153312200,30-015-33122,WEST MALAGA 12 STATE COM 001,2009-11-01,71,0,659,0,2,519791,4659
300153312200,30-015-33122,WEST MALAGA 12 STATE COM 001,2009-12-01,72,0,578,0,2,520369,4659
300153312200,30-015-33122,WEST MALAGA 12 STATE COM 001,2010-01-01,73,0,1869,0,2,522238,4659
300153312200,30-015-33122,WEST MALAGA 12 STATE COM 001,2010-02-01,74,0,1308,0,2,523546,4659
300153312200,30-015-33122,WEST MALAGA 12 STATE COM 001,2010-03-01,75,0,908,52,2,524454,4711
300153312200,30-015-33122,WEST MALAGA 12 STATE COM 001,2010-04-01,76,0,522,0,2,524976,4711
300153312200,30-015-33122,WEST MALAGA 12 STATE COM 001,2010-05-01,77,0,1431,0,2,526407,4711
300153312200,30-015-33122,WEST MALAGA 12 STATE COM 001,2010-06-01,78,0,547,0,2,526954,4711
300153312200,30-015-33122,WEST MALAGA 12 STATE COM 001,2010-07-01,79,0,252,0,2,527206,4711
300153312200,30-015-33122,WEST MALAGA 12 STATE COM 001,2010-08-01,80,0,229,0,2,527435,4711
300153312200,30-015-33122,WEST MALAGA 12 STATE COM 001,2010-09-01,81,0,297,0,2,527732,4711
300153312200,30-015-33122,WEST MALAGA 12 STATE COM 001,2010-10-01,82,0,260,0,2,527992,4711
300153312200,30-015-33122,WEST MALAGA 12 STATE COM 001,2010-11-01,83,0,236,0,2,528228,4711
300153312200,30-015-33122,WEST MALAGA 12 STATE COM 001,2010-12-01,84,0,219,0,2,528447,4711
300153312200,30-015-33122,WEST MALAGA 12 STATE COM 001,2011-01-01,85,0,292,0,2,528739,4711
300153312200,30-015-33122,WEST MALAGA 12 STATE COM 001,2011-02-01,86,0,406,0,2,529145,4711
300153312200,30-015-33122,WEST MALAGA 12 STATE COM 001,2011-03-01,87,0,269,0,2,529414,4711
300153312200,30-015-33122,WEST MALAGA 12 STATE COM 001,2011-04-01,88,0,181,0,2,529595,4711
300153312200,30-015-33122,WEST MALAGA 12 STATE COM 001,2011-05-01,89,0,273,0,2,529868,4711
300153312200,30-015-33122,WEST MALAGA 12 STATE COM 001,2011-06-01,90,0,1384,0,2,531252,4711
300153312200,30-015-33122,WEST MALAGA 12 STATE COM 001,2011-07-01,91,0,2047,0,2,533299,4711
300153312200,30-015-33122,WEST MALAGA 12 STATE COM 001,2011-08-01,92,0,2304,3,2,535603,4714
300153312200,30-015-33122,WEST MALAGA 12 STATE COM 001,2011-09-01,93,0,859,0,2,536462,4714
300153312200,30-015-33122,WEST MALAGA 12 STATE COM 001,2011-10-01,94,0,482,0,2,536944,4714
300153312200,30-015-33122,WEST MALAGA 12 STATE COM 001,2011-11-01,95,0,3614,344,2,540558,5058
300153312200,30-015-33122,WEST MALAGA 12 STATE COM 001,2011-12-01,96,0,4869,181,2,545427,5239
300153312200,30-015-33122,WEST MALAGA 12 STATE COM 001,2012-01-01,97,0,6129,332,2,551556,5571
300153312200,30-015-33122,WEST MALAGA 12 STATE COM 001,2012-02-01,98,0,8389,340,2,559945,5911
300153312200,30-015-33122,WEST MALAGA 12 STATE COM 001,2012-03-01,99,0,5657,198,2,565602,6109
300153312200,30-015-33122,WEST MALAGA 12 STATE COM 001,2012-04-01,100,0,6197,205,2,571799,6314
300153312200,30-015-33122,WEST MALAGA 12 STATE COM 001,2012-05-01,101,0,5804,107,2,577603,6421
300153312200,30-015-33122,WEST MALAGA 12 STATE COM 001,2012-06-01,102,0,7038,272,2,584641,6693
300153312200,30-015-33122,WEST MALAGA 12 STATE COM 001,2012-07-01,103,0,7369,316,2,592010,7009
300153312200,30-015-33122,WEST MALAGA 12 STATE COM 001,2012-08-01,104,0,6752,268,2,598762,7277
300153312200,30-015-33122,WEST MALAGA 12 STATE COM 001,2012-09-01,105,0,6340,300,2,605102,7577
300153312200,30-015-33122,WEST MALAGA 12 STATE COM 001,2012-10-01,106,0,5431,140,2,610533,7717
300153312200,30-015-33122,WEST MALAGA 12 STATE COM 001,2012-11-01,107,0,6316,292,2,616849,8009
300153312200,30-015-33122,WEST MALAGA 12 STATE COM 001,2012-12-01,108,0,6548,282,2,623397,8291
300153312200,30-015-33122,WEST MALAGA 12 STATE COM 001,2013-01-01,109,0,6627,176,2,630024,8467
300153312200,30-015-33122,WEST MALAGA 12 STATE COM 001,2013-02-01,110,0,6621,321,2,636645,8788
300153312200,30-015-33122,WEST MALAGA 12 STATE COM 001,2013-03-01,111,0,7506,254,2,644151,9042
300153312200,30-015-33122,WEST MALAGA 12 STATE COM 001,2013-04-01,112,0,7728,262,2,651879,9304
300153312200,30-015-33122,WEST MALAGA 12 STATE COM 001,2013-05-01,113,0,5764,55,2,657643,9359
300153312200,30-015-33122,WEST MALAGA 12 STATE COM 001,2013-06-01,114,0,6465,65,2,664108,9424
300153312200,30-015-33122,WEST MALAGA 12 STATE COM 001,2013-07-01,115,0,3730,84,2,667838,9508
300153312200,30-015-33122,WEST MALAGA 12 STATE COM 001,2013-08-01,116,0,5196,1,2,673034,9509
300153312200,30-015-33122,WEST MALAGA 12 STATE COM 001,2013-09-01,117,0,2826,38,2,675860,9547
300153312200,30-015-33122,WEST MALAGA 12 STATE COM 001,2013-10-01,118,0,5890,94,2,681750,9641
300153312200,30-015-33122,WEST MALAGA 12 STATE COM 001,2013-11-01,119,0,6139,152,2,687889,9793
300153312200,30-015-33122,WEST MALAGA 12 STATE COM 001,2013-12-01,120,0,4391,36,2,692280,9829
300153312200,30-015-33122,WEST MALAGA 12 STATE COM 001,2014-01-01,121,0,4039,75,2,696319,9904
300153312200,30-015-33122,WEST MALAGA 12 STATE COM 001,2014-02-01,122,0,3304,5,2,699623,9909
300153312200,30-015-33122,WEST MALAGA 12 STATE COM 001,2014-03-01,123,0,5696,160,2,705319,10069
300153312200,30-015-33122,WEST MALAGA 12 STATE COM 001,2014-04-01,124,0,6562,154,2,711881,10223
300153312200,30-015-33122,WEST MALAGA 12 STATE COM 001,2014-05-01,125,0,5876,147,2,717757,10370
300153312200,30-015-33122,WEST MALAGA 12 STATE COM 001,2014-06-01,126,0,5828,174,2,723585,10544
300153312200,30-015-33122,WEST MALAGA 12 STATE COM 001,2014-07-01,127,0,5533,125,2,729118,10669
300153312200,30-015-33122,WEST MALAGA 12 STATE COM 001,2014-08-01,128,0,5823,157,2,734941,10826
300153312200,30-015-33122,WEST MALAGA 12 STATE COM 001,2014-09-01,129,0,3834,0,2,738775,10826
300153312200,30-015-33122,WEST MALAGA 12 STATE COM 001,2014-10-01,130,0,4569,129,2,743344,10955
300153312200,30-015-33122,WEST MALAGA 12 STATE COM 001,2014-11-01,131,0,4705,23,2,748049,10978
300153312200,30-015-33122,WEST MALAGA 12 STATE COM 001,2014-12-01,132,0,5210,0,2,753259,10978
300153312200,30-015-33122,WEST MALAGA 12 STATE COM 001,2015-01-01,133,0,2477,0,2,755736,10978
300153312200,30-015-33122,WEST MALAGA 12 STATE COM 001,2015-02-01,134,0,5991,0,2,761727,10978
300153312200,30-015-33122,WEST MALAGA 12 STATE COM 001,2015-03-01,135,0,6136,27,2,767863,11005
300153312200,30-015-33122,WEST MALAGA 12 STATE COM 001,2015-04-01,136,0,4225,62,2,772088,11067
300153312200,30-015-33122,WEST MALAGA 12 STATE COM 001,2015-05-01,137,0,5438,1,2,777526,11068
300153312200,30-015-33122,WEST MALAGA 12 STATE COM 001,2015-06-01,138,0,4899,51,2,782425,11119
300153312200,30-015-33122,WEST MALAGA 12 STATE COM 001,2015-07-01,139,0,4638,198,2,787063,11317
300153312200,30-015-33122,WEST MALAGA 12 STATE COM 001,2015-08-01,140,0,6130,122,2,793193,11439
300153312200,30-015-33122,WEST MALAGA 12 STATE COM 001,2015-09-01,141,0,5477,134,2,798670,11573
300153312200,30-015-33122,WEST MALAGA 12 STATE COM 001,2015-10-01,142,0,5093,164,2,803763,11737
300153312200,30-015-33122,WEST MALAGA 12 STATE COM 001,2015-11-01,143,0,4110,92,2,807873,11829
300153312200,30-015-33122,WEST MALAGA 12 STATE COM 001,2015-12-01,144,0,4689,169,2,812562,11998
300153312200,30-015-33122,WEST MALAGA 12 STATE COM 001,2016-01-01,145,0,6369,188,2,818931,12186
300153312200,30-015-33122,WEST MALAGA 12 STATE COM 001,2016-02-01,146,0,6016,151,2,824947,12337
300153312200,30-015-33122,WEST MALAGA 12 STATE COM 001,2016-03-01,147,0,6257,139,2,831204,12476
300153312200,30-015-33122,WEST MALAGA 12 STATE COM 001,2016-04-01,148,0,5513,125,2,836717,12601
300153312200,30-015-33122,WEST MALAGA 12 STATE COM 001,2016-05-01,149,0,5289,107,2,842006,12708
300153312200,30-015-33122,WEST MALAGA 12 STATE COM 001,2016-06-01,150,0,5290,120,2,847296,12828
300153312200,30-015-33122,WEST MALAGA 12 STATE COM 001,2016-07-01,151,0,4946,59,2,852242,12887
300153312200,30-015-33122,WEST MALAGA 12 STATE COM 001,2016-08-01,152,0,4940,55,2,857182,12942
300153312200,30-015-33122,WEST MALAGA 12 STATE COM 001,2016-09-01,153,0,4378,49,2,861560,12991
300153312200,30-015-33122,WEST MALAGA 12 STATE COM 001,2016-10-01,154,0,4578,28,2,866138,13019
300153312200,30-015-33122,WEST MALAGA 12 STATE COM 001,2016-11-01,155,0,4269,64,2,870407,13083
300153312200,30-015-33122,WEST MALAGA 12 STATE COM 001,2016-12-01,156,0,4254,64,2,874661,13147
300153312200,30-015-33122,WEST MALAGA 12 STATE COM 001,2017-01-01,157,0,3642,0,2,878303,13147
300153312200,30-015-33122,WEST MALAGA 12 STATE COM 001,2017-02-01,158,0,5176,0,2,883479,13147
300153312200,30-015-33122,WEST MALAGA 12 STATE COM 001,2017-03-01,159,0,4941,177,2,888420,13324
300153312200,30-015-33122,WEST MALAGA 12 STATE COM 001,2017-04-01,160,0,4492,53,2,892912,13377
300153312200,30-015-33122,WEST MALAGA 12 STATE COM 001,2017-05-01,161,0,5148,87,2,898060,13464
300153312200,30-015-33122,WEST MALAGA 12 STATE COM 001,2017-06-01,162,0,4711,90,2,902771,13554
300153312200,30-015-33122,WEST MALAGA 12 STATE COM 001,2017-07-01,163,0,4576,102,2,907347,13656
300153312200,30-015-33122,WEST MALAGA 12 STATE COM 001,2017-08-01,164,0,4861,100,2,912208,13756
300153312200,30-015-33122,WEST MALAGA 12 STATE COM 001,2017-09-01,165,0,4750,88,2,916958,13844
300153312200,30-015-33122,WEST MALAGA 12 STATE COM 001,2017-10-01,166,0,4821,88,2,921779,13932
300153312200,30-015-33122,WEST MALAGA 12 STATE COM 001,2017-11-01,167,0,4374,203,2,926153,14135
300153312200,30-015-33122,WEST MALAGA 12 STATE COM 001,2017-12-01,168,0,4669,87,2,930822,14222
300153312200,30-015-33122,WEST MALAGA 12 STATE COM 001,2018-01-01,169,0,4332,106,2,935154,14328
300153312200,30-015-33122,WEST MALAGA 12 STATE COM 001,2018-02-01,170,0,3870,124,2,939024,14452
300153312200,30-015-33122,WEST MALAGA 12 STATE COM 001,2018-03-01,171,0,3021,2,2,942045,14454
300153312200,30-015-33122,WEST MALAGA 12 STATE COM 001,2018-04-01,172,0,1392,0,2,943437,14454
300153312200,30-015-33122,WEST MALAGA 12 STATE COM 001,2018-05-01,173,0,4386,96,2,947823,14550
300153312200,30-015-33122,WEST MALAGA 12 STATE COM 001,2018-06-01,174,0,4353,50,2,952176,14600
300153312200,30-015-33122,WEST MALAGA 12 STATE COM 001,2018-07-01,175,0,4010,90,2,956186,14690
300153312200,30-015-33122,WEST MALAGA 12 STATE COM 001,2018-08-01,176,0,3765,8,2,959951,14698
300153312200,30-015-33122,WEST MALAGA 12 STATE COM 001,2018-09-01,177,0,3408,70,2,963359,14768
300153312200,30-015-33122,WEST MALAGA 12 STATE COM 001,2018-10-01,178,0,4318,1,2,967677,14769
300153312200,30-015-33122,WEST MALAGA 12 STATE COM 001,2018-11-01,179,0,3498,0,2,971175,14769
300153312200,30-015-33122,WEST MALAGA 12 STATE COM 001,2018-12-01,180,0,3842,0,2,975017,14769
300153312200,30-015-33122,WEST MALAGA 12 STATE COM 001,2019-01-01,181,0,3627,1,2,978644,14770
300153312200,30-015-33122,WEST MALAGA 12 STATE COM 001,2019-02-01,182,0,3493,0,2,982137,14770
300153312200,30-015-33122,WEST MALAGA 12 STATE COM 001,2019-03-01,183,0,3809,0,2,985946,14770
300153312200,30-015-33122,WEST MALAGA 12 STATE COM 001,2019-04-01,184,0,159,0,2,986105,14770
300153312200,30-015-33122,WEST MALAGA 12 STATE COM 001,2019-05-01,185,0,1190,0,2,987295,14770
300153312200,30-015-33122,WEST MALAGA 12 STATE COM 001,2019-06-01,186,0,1188,0,2,988483,14770
300153312200,30-015-33122,WEST MALAGA 12 STATE COM 001,2019-07-01,187,0,2352,0,2,990835,14770
300153312200,30-015-33122,WEST MALAGA 12 STATE COM 001,2019-08-01,188,0,1479,0,2,992314,14770
300153312200,30-015-33122,WEST MALAGA 12 STATE COM 001,2019-09-01,189,0,4763,0,2,997077,14770
300153312200,30-015-33122,WEST MALAGA 12 STATE COM 001,2019-10-01,190,0,5861,0,2,1002938,14770
300153312200,30-015-33122,WEST MALAGA 12 STATE COM 001,2019-11-01,191,0,4919,0,2,1007857,14770
300153312200,30-015-33122,WEST MALAGA 12 STATE COM 001,2019-12-01,192,0,4768,0,2,1012625,14770
300153312200,30-015-33122,WEST MALAGA 12 STATE COM 001,2020-01-01,193,0,4635,0,2,1017260,14770
300153312200,30-015-33122,WEST MALAGA 12 STATE COM 001,2020-02-01,194,0,4449,0,2,1021709,14770
300153312200,30-015-33122,WEST MALAGA 12 STATE COM 001,2020-03-01,195,0,778,0,2,1022487,14770
300153312200,30-015-33122,WEST MALAGA 12 STATE COM 001,2020-04-01,196,0,74,0,2,1022561,14770
300153312200,30-015-33122,WEST MALAGA 12 STATE COM 001,2020-05-01,197,0,7116,0,2,1029677,14770
300153312200,30-015-33122,WEST MALAGA 12 STATE COM 001,2020-06-01,198,0,3668,0,2,1033345,14770
300153312200,30-015-33122,WEST MALAGA 12 STATE COM 001,2020-07-01,199,0,2415,0,2,1035760,14770
300153312200,30-015-33122,WEST MALAGA 12 STATE COM 001,2020-08-01,200,0,224,0,2,1035984,14770
300153312200,30-015-33122,WEST MALAGA 12 STATE COM 001,2020-09-01,201,0,5458,0,2,1041442,14770
300153312200,30-015-33122,WEST MALAGA 12 STATE COM 001,2020-10-01,202,0,4765,80,2,1046207,14850
300153312200,30-015-33122,WEST MALAGA 12 STATE COM 001,2020-11-01,203,0,4614,181,2,1050821,15031
300153312200,30-015-33122,WEST MALAGA 12 STATE COM 001,2020-12-01,204,0,4114,69,2,1054935,15100
300153312200,30-015-33122,WEST MALAGA 12 STATE COM 001,2021-01-01,205,0,2782,38,2,1057717,15138
300153312200,30-015-33122,WEST MALAGA 12 STATE COM 001,2021-02-01,206,0,2911,88,2,1060628,15226
300153312200,30-015-33122,WEST MALAGA 12 STATE COM 001,2021-03-01,207,0,3357,60,2,1063985,15286
300153312200,30-015-33122,WEST MALAGA 12 STATE COM 001,2021-04-01,208,0,1643,16,2,1065628,15302
300153312200,30-015-33122,WEST MALAGA 12 STATE COM 001,2021-05-01,209,0,2483,68,2,1068111,15370
300153312200,30-015-33122,WEST MALAGA 12 STATE COM 001,2021-06-01,210,0,2924,105,2,1071035,15475
300153312200,30-015-33122,WEST MALAGA 12 STATE COM 001,2021-07-01,211,0,2975,64,2,1074010,15539
300153312200,30-015-33122,WEST MALAGA 12 STATE COM 001,2021-08-01,212,0,3237,114,2,1077247,15653
300153312200,30-015-33122,WEST MALAGA 12 STATE COM 001,2021-09-01,213,0,2650,53,2,1079897,15706
300153312200,30-015-33122,WEST MALAGA 12 STATE COM 001,2021-10-01,214,0,2782,58,2,1082679,15764
300153312200,30-015-33122,WEST MALAGA 12 STATE COM 001,2021-11-01,215,0,3108,106,2,1085787,15870
300153312200,30-015-33122,WEST MALAGA 12 STATE COM 001,2021-12-01,216,0,1145,58,2,1086932,15928
300153312200,30-015-33122,WEST MALAGA 12 STATE COM 001,2022-01-01,217,0,2887,8,2,1089819,15936
300153312200,30-015-33122,WEST MALAGA 12 STATE COM 001,2022-02-01,218,0,2389,51,2,1092208,15987
300153312200,30-015-33122,WEST MALAGA 12 STATE COM 001,2022-03-01,219,0,2704,69,2,1094912,16056
300153312200,30-015-33122,WEST MALAGA 12 STATE COM 001,2022-04-01,220,0,3254,127,2,1098166,16183
300153312200,30-015-33122,WEST MALAGA 12 STATE COM 001,2022-05-01,221,0,1740,9,2,1099906,16192
300153312200,30-015-33122,WEST MALAGA 12 STATE COM 001,2022-06-01,222,0,3434,38,2,1103340,16230
300153312200,30-015-33122,WEST MALAGA 12 STATE COM 001,2022-07-01,223,0,2213,60,2,1105553,16290
300153312200,30-015-33122,WEST MALAGA 12 STATE COM 001,2022-08-01,224,0,15,1,2,1105568,16291
300153312200,30-015-33122,WEST MALAGA 12 STATE COM 001,2022-09-01,225,0,3281,2,2,1108849,16293
300153312200,30-015-33122,WEST MALAGA 12 STATE COM 001,2022-10-01,226,0,1272,0,2,1110121,16293
300153312200,30-015-33122,WEST MALAGA 12 STATE COM 001,2022-11-01,227,0,3688,70,2,1113809,16363
300153312200,30-015-33122,WEST MALAGA 12 STATE COM 001,2022-12-01,228,0,938,1,2,1114747,16364
300153312200,30-015-33122,WEST MALAGA 12 STATE COM 001,2023-01-01,229,0,2339,0,2,1117086,16364
300153312200,30-015-33122,WEST MALAGA 12 STATE COM 001,2023-02-01,230,0,3709,0,2,1120795,16364
300153312200,30-015-33122,WEST MALAGA 12 STATE COM 001,2023-03-01,231,0,1746,0,2,1122541,16364
300153312200,30-015-33122,WEST MALAGA 12 STATE COM 001,2023-04-01,232,0,232,0,2,1122773,16364
300153312200,30-015-33122,WEST MALAGA 12 STATE COM 001,2023-05-01,233,0,237,0,2,1123010,16364
300153312200,30-015-33122,WEST MALAGA 12 STATE COM 001,2023-06-01,234,0,140,0,2,1123150,16364
300153312200,30-015-33122,WEST MALAGA 12 STATE COM 001,2023-07-01,235,0,618,14,2,1123768,16378
300152322100,30-015-23221,HUMIDOR BML STATE COM 002,2006-01-01,1,290,16488,167,290,16488,167
300152322100,30-015-23221,HUMIDOR BML STATE COM 002,2006-02-01,2,57,7731,9,347,24219,176
300152322100,30-015-23221,HUMIDOR BML STATE COM 002,2006-03-01,3,0,5230,0,347,29449,176
300152322100,30-015-23221,HUMIDOR BML STATE COM 002,2006-04-01,4,0,4532,0,347,33981,176
300152322100,30-015-23221,HUMIDOR BML STATE COM 002,2006-05-01,5,0,4571,0,347,38552,176
300152322100,30-015-23221,HUMIDOR BML STATE COM 002,2006-06-01,6,0,4403,0,347,42955,176
300152322100,30-015-23221,HUMIDOR BML STATE COM 002,2006-07-01,7,0,4502,0,347,47457,176
300152322100,30-015-23221,HUMIDOR BML STATE COM 002,2006-08-01,8,0,4421,0,347,51878,176
300152322100,30-015-23221,HUMIDOR BML STATE COM 002,2006-09-01,9,0,4239,0,347,56117,176
300152322100,30-015-23221,HUMIDOR BML STATE COM 002,2006-10-01,10,0,4331,0,347,60448,176
300152322100,30-015-23221,HUMIDOR BML STATE COM 002,2006-11-01,11,0,4173,0,347,64621,176
300152322100,30-015-23221,HUMIDOR BML STATE COM 002,2006-12-01,12,0,4290,0,347,68911,176
300152322100,30-015-23221,HUMIDOR BML STATE COM 002,2007-01-01,13,0,4203,0,347,73114,176
300152322100,30-015-23221,HUMIDOR BML STATE COM 002,2007-02-01,14,0,3839,0,347,76953,176
300152322100,30-015-23221,HUMIDOR BML STATE COM 002,2007-03-01,15,1,4169,0,348,81122,176
300152322100,30-015-23221,HUMIDOR BML STATE COM 002,2007-04-01,16,0,3991,0,348,85113,176
300152322100,30-015-23221,HUMIDOR BML STATE COM 002,2007-05-01,17,0,4130,0,348,89243,176
300152322100,30-015-23221,HUMIDOR BML STATE COM 002,2007-06-01,18,0,3978,0,348,93221,176
300152322100,30-015-23221,HUMIDOR BML STATE COM 002,2007-07-01,19,0,4114,0,348,97335,176
300152322100,30-015-23221,HUMIDOR BML STATE COM 002,2007-08-01,20,0,4108,0,348,101443,176
300152322100,30-015-23221,HUMIDOR BML STATE COM 002,2007-09-01,21,0,4055,11,348,105498,187
300152322100,30-015-23221,HUMIDOR BML STATE COM 002,2007-10-01,22,0,4162,12,348,109660,199
300152322100,30-015-23221,HUMIDOR BML STATE COM 002,2007-11-01,23,43,2041,5,391,111701,204
300152322100,30-015-23221,HUMIDOR BML STATE COM 002,2007-12-01,24,653,509,2235,1044,112210,2439
300152322100,30-015-23221,HUMIDOR BML STATE COM 002,2008-01-01,1,613,1453,5443,1657,113663,7882
300152322100,30-015-23221,HUMIDOR BML STATE COM 002,2008-02-01,2,701,916,3457,2358,114579,11339
300152322100,30-015-23221,HUMIDOR BML STATE COM 002,2008-03-01,3,578,2082,3734,2936,116661,15073
300152322100,30-015-23221,HUMIDOR BML STATE COM 002,2008-04-01,4,440,600,2785,3376,117261,17858
300152322100,30-015-23221,HUMIDOR BML STATE COM 002,2008-05-01,5,420,925,2595,3796,118186,20453
300152322100,30-015-23221,HUMIDOR BML STATE COM 002,2008-06-01,6,395,954,2424,4191,119140,22877
300152322100,30-015-23221,HUMIDOR BML STATE COM 002,2008-07-01,7,500,4245,757,4691,123385,23634
300152322100,30-015-23221,HUMIDOR BML STATE COM 002,2008-08-01,8,575,12384,689,5266,135769,24323
300152322100,30-015-23221,HUMIDOR BML STATE COM 002,2008-09-01,9,148,9215,192,5414,144984,24515
300152322100,30-015-23221,HUMIDOR BML STATE COM 002,2008-10-01,10,47,5173,57,5461,150157,24572
300152322100,30-015-23221,HUMIDOR BML STATE COM 002,2008-11-01,11,36,3978,8,5497,154135,24580
300152322100,30-015-23221,HUMIDOR BML STATE COM 002,2008-12-01,12,30,4438,0,5527,158573,24580
300152322100,30-015-23221,HUMIDOR BML STATE COM 002,2009-01-01,13,25,4300,0,5552,162873,24580
300152322100,30-015-23221,HUMIDOR BML STATE COM 002,2009-02-01,14,3,4072,0,5555,166945,24580
300152322100,30-015-23221,HUMIDOR BML STATE COM 002,2009-03-01,15,19,4409,0,5574,171354,24580
300152322100,30-015-23221,HUMIDOR BML STATE COM 002,2009-04-01,16,74,3989,0,5648,175343,24580
300152322100,30-015-23221,HUMIDOR BML STATE COM 002,2009-05-01,17,81,4402,9,5729,179745,24589
300152322100,30-015-23221,HUMIDOR BML STATE COM 002,2009-06-01,18,55,4319,21,5784,184064,24610
300152322100,30-015-23221,HUMIDOR BML STATE COM 002,2009-07-01,19,72,4392,12,5856,188456,24622
300152322100,30-015-23221,HUMIDOR BML STATE COM 002,2009-08-01,20,85,4356,3,5941,192812,24625
300152322100,30-015-23221,HUMIDOR BML STATE COM 002,2009-09-01,21,75,4050,0,6016,196862,24625
300152322100,30-015-23221,HUMIDOR BML STATE COM 002,2009-10-01,22,85,4302,0,6101,201164,24625
300152322100,30-015-23221,HUMIDOR BML STATE COM 002,2009-11-01,23,74,3986,0,6175,205150,24625
300152322100,30-015-23221,HUMIDOR BML STATE COM 002,2009-12-01,24,61,4192,0,6236,209342,24625
300152322100,30-015-23221,HUMIDOR BML STATE COM 002,2010-01-01,25,85,4199,0,6321,213541,24625
300152322100,30-015-23221,HUMIDOR BML STATE COM 002,2010-02-01,26,71,3814,0,6392,217355,24625
300152322100,30-015-23221,HUMIDOR BML STATE COM 002,2010-03-01,27,89,4283,0,6481,221638,24625
300152322100,30-015-23221,HUMIDOR BML STATE COM 002,2010-04-01,28,86,4056,0,6567,225694,24625
300152322100,30-015-23221,HUMIDOR BML STATE COM 002,2010-05-01,29,93,4225,0,6660,229919,24625
300152322100,30-015-23221,HUMIDOR BML STATE COM 002,2010-06-01,30,75,3986,0,6735,233905,24625
300152322100,30-015-23221,HUMIDOR BML STATE COM 002,2010-07-01,31,115,4071,0,6850,237976,24625
300152322100,30-015-23221,HUMIDOR BML STATE COM 002,2010-08-01,32,78,4229,0,6928,242205,24625
300152322100,30-015-23221,HUMIDOR BML STATE COM 002,2010-09-01,33,72,3326,0,7000,245531,24625
300152322100,30-015-23221,HUMIDOR BML STATE COM 002,2010-10-01,34,94,3437,0,7094,248968,24625
300152322100,30-015-23221,HUMIDOR BML STATE COM 002,2010-11-01,35,35,2868,12,7129,251836,24637
300152322100,30-015-23221,HUMIDOR BML STATE COM 002,2010-12-01,36,115,3820,41,7244,255656,24678
300152322100,30-015-23221,HUMIDOR BML STATE COM 002,2011-01-01,37,95,3823,5,7339,259479,24683
300152322100,30-015-23221,HUMIDOR BML STATE COM 002,2011-02-01,38,105,3140,11,7444,262619,24694
300152322100,30-015-23221,HUMIDOR BML STATE COM 002,2011-03-01,39,99,3985,0,7543,266604,24694
300152322100,30-015-23221,HUMIDOR BML STATE COM 002,2011-04-01,40,167,4321,880,7710,270925,25574
300152322100,30-015-23221,HUMIDOR BML STATE COM 002,2011-05-01,41,74,4714,501,7784,275639,26075
300152322100,30-015-23221,HUMIDOR BML STATE COM 002,2011-06-01,42,88,3840,89,7872,279479,26164
300152322100,30-015-23221,HUMIDOR BML STATE COM 002,2011-07-01,43,78,4557,203,7950,284036,26367
300152322100,30-015-23221,HUMIDOR BML STATE COM 002,2011-08-01,44,209,4020,41,8159,288056,26408
300152322100,30-015-23221,HUMIDOR BML STATE COM 002,2011-09-01,45,89,3703,27,8248,291759,26435
300152322100,30-015-23221,HUMIDOR BML STATE COM 002,2011-10-01,46,80,3420,39,8328,295179,26474
300152322100,30-015-23221,HUMIDOR BML STATE COM 002,2011-11-01,47,52,3875,146,8380,299054,26620
300152322100,30-015-23221,HUMIDOR BML STATE COM 002,2011-12-01,48,124,4005,0,8504,303059,26620
300152322100,30-015-23221,HUMIDOR BML STATE COM 002,2012-01-01,49,102,4015,0,8606,307074,26620
300152322100,30-015-23221,HUMIDOR BML STATE COM 002,2012-02-01,50,63,3701,66,8669,310775,26686
300152322100,30-015-23221,HUMIDOR BML STATE COM 002,2012-03-01,51,190,4744,626,8859,315519,27312
300152322100,30-015-23221,HUMIDOR BML STATE COM 002,2012-04-01,52,117,3815,447,8976,319334,27759
300152322100,30-015-23221,HUMIDOR BML STATE COM 002,2012-05-01,53,99,3683,318,9075,323017,28077
300152322100,30-015-23221,HUMIDOR BML STATE COM 002,2012-06-01,54,117,3860,360,9192,326877,28437
300152322100,30-015-23221,HUMIDOR BML STATE COM 002,2012-07-01,55,89,3567,264,9281,330444,28701
300152322100,30-015-23221,HUMIDOR BML STATE COM 002,2012-08-01,56,46,3814,235,9327,334258,28936
300152322100,30-015-23221,HUMIDOR BML STATE COM 002,2012-09-01,57,88,3727,213,9415,337985,29149
300152322100,30-015-23221,HUMIDOR BML STATE COM 002,2012-10-01,58,88,4081,277,9503,342066,29426
300152322100,30-015-23221,HUMIDOR BML STATE COM 002,2012-11-01,59,90,3618,148,9593,345684,29574
300152322100,30-015-23221,HUMIDOR BML STATE COM 002,2012-12-01,60,119,4256,138,9712,349940,29712
300152322100,30-015-23221,HUMIDOR BML STATE COM 002,2013-01-01,61,120,4484,187,9832,354424,29899
300152322100,30-015-23221,HUMIDOR BML STATE COM 002,2013-02-01,62,214,4213,210,10046,358637,30109
300152322100,30-015-23221,HUMIDOR BML STATE COM 002,2013-03-01,63,171,3073,125,10217,361710,30234
300152322100,30-015-23221,HUMIDOR BML STATE COM 002,2013-04-01,64,289,6787,329,10506,368497,30563
300152322100,30-015-23221,HUMIDOR BML STATE COM 002,2013-05-01,65,170,4369,289,10676,372866,30852
300152322100,30-015-23221,HUMIDOR BML STATE COM 002,2013-06-01,66,143,5929,780,10819,378795,31632
300152322100,30-015-23221,HUMIDOR BML STATE COM 002,2013-07-01,67,259,3141,226,11078,381936,31858
300152322100,30-015-23221,HUMIDOR BML STATE COM 002,2013-08-01,68,176,3876,732,11254,385812,32590
300152322100,30-015-23221,HUMIDOR BML STATE COM 002,2013-09-01,69,227,3826,140,11481,389638,32730
300152322100,30-015-23221,HUMIDOR BML STATE COM 002,2013-10-01,70,264,3735,312,11745,393373,33042
300152322100,30-015-23221,HUMIDOR BML STATE COM 002,2013-11-01,71,240,2540,218,11985,395913,33260
300152322100,30-015-23221,HUMIDOR BML STATE COM 002,2013-12-01,72,221,3671,207,12206,399584,33467
300152322100,30-015-23221,HUMIDOR BML STATE COM 002,2014-01-01,73,271,3456,475,12477,403040,33942
300152322100,30-015-23221,HUMIDOR BML STATE COM 002,2014-02-01,74,182,3284,760,12659,406324,34702
300152322100,30-015-23221,HUMIDOR BML STATE COM 002,2014-03-01,75,655,4070,586,13314,410394,35288
300152322100,30-015-23221,HUMIDOR BML STATE COM 002,2014-04-01,76,173,3734,186,13487,414128,35474
300152322100,30-015-23221,HUMIDOR BML STATE COM 002,2014-05-01,77,187,4519,195,13674,418647,35669
300152322100,30-015-23221,HUMIDOR BML STATE COM 002,2014-06-01,78,26,3864,166,13700,422511,35835
300152322100,30-015-23221,HUMIDOR BML STATE COM 002,2014-07-01,79,107,4260,164,13807,426771,35999
300152322100,30-015-23221,HUMIDOR BML STATE COM 002,2014-08-01,80,0,4136,137,13807,430907,36136
300152322100,30-015-23221,HUMIDOR BML STATE COM 002,2014-09-01,81,0,3852,245,13807,434759,36381
300152322100,30-015-23221,HUMIDOR BML STATE COM 002,2014-10-01,82,0,3077,204,13807,437836,36585
300152322100,30-015-23221,HUMIDOR BML STATE COM 002,2014-11-01,83,0,2641,63,13807,440477,36648
300152322100,30-015-23221,HUMIDOR BML STATE COM 002,2014-12-01,84,355,4512,1110,14162,444989,37758
300152322100,30-015-23221,HUMIDOR BML STATE COM 002,2015-01-01,85,165,4188,638,14327,449177,38396
300152322100,30-015-23221,HUMIDOR BML STATE COM 002,2015-02-01,86,185,3811,1333,14512,452988,39729
300152322100,30-015-23221,HUMIDOR BML STATE COM 002,2015-03-01,87,362,4405,1016,14874,457393,40745
300152322100,30-015-23221,HUMIDOR BML STATE COM 002,2015-04-01,88,387,3712,1158,15261,461105,41903
300152322100,30-015-23221,HUMIDOR BML STATE COM 002,2015-05-01,89,169,3745,965,15430,464850,42868
300152322100,30-015-23221,HUMIDOR BML STATE COM 002,2015-06-01,90,346,4657,1191,15776,469507,44059
300152322100,30-015-23221,HUMIDOR BML STATE COM 002,2015-07-01,91,0,3249,139,15776,472756,44198
300152322100,30-015-23221,HUMIDOR BML STATE COM 002,2015-08-01,92,0,4178,0,15776,476934,44198
300152322100,30-015-23221,HUMIDOR BML STATE COM 002,2015-09-01,93,0,3539,122,15776,480473,44320
300152322100,30-015-23221,HUMIDOR BML STATE COM 002,2015-10-01,94,0,4210,0,15776,484683,44320
300152322100,30-015-23221,HUMIDOR BML STATE COM 002,2015-11-01,95,0,3859,0,15776,488542,44320
300152322100,30-015-23221,HUMIDOR BML STATE COM 002,2015-12-01,96,0,3121,0,15776,491663,44320
300152322100,30-015-23221,HUMIDOR BML STATE COM 002,2016-01-01,97,0,2978,0,15776,494641,44320
300152322100,30-015-23221,HUMIDOR BML STATE COM 002,2016-02-01,98,0,4880,0,15776,499521,44320
300152322100,30-015-23221,HUMIDOR BML STATE COM 002,2016-03-01,99,47,4226,631,15823,503747,44951
300152322100,30-015-23221,HUMIDOR BML STATE COM 002,2016-04-01,100,0,4048,757,15823,507795,45708
300152322100,30-015-23221,HUMIDOR BML STATE COM 002,2016-05-01,101,6,3614,389,15829,511409,46097
300152322100,30-015-23221,HUMIDOR BML STATE COM 002,2016-06-01,102,0,3501,454,15829,514910,46551
300152322100,30-015-23221,HUMIDOR BML STATE COM 002,2016-07-01,103,0,3529,277,15829,518439,46828
300152322100,30-015-23221,HUMIDOR BML STATE COM 002,2016-08-01,104,5,3564,274,15834,522003,47102
300152322100,30-015-23221,HUMIDOR BML STATE COM 002,2016-09-01,105,0,3511,536,15834,525514,47638
300152322100,30-015-23221,HUMIDOR BML STATE COM 002,2016-10-01,106,0,3521,274,15834,529035,47912
300152322100,30-015-23221,HUMIDOR BML STATE COM 002,2016-11-01,107,0,3954,368,15834,532989,48280
300152322100,30-015-23221,HUMIDOR BML STATE COM 002,2016-12-01,108,0,3465,170,15834,536454,48450
300152322100,30-015-23221,HUMIDOR BML STATE COM 002,2017-01-01,109,0,3393,167,15834,539847,48617
300152322100,30-015-23221,HUMIDOR BML STATE COM 002,2017-02-01,110,0,2954,170,15834,542801,48787
300152322100,30-015-23221,HUMIDOR BML STATE COM 002,2017-03-01,111,0,2930,44,15834,545731,48831
300152322100,30-015-23221,HUMIDOR BML STATE COM 002,2017-04-01,112,3,2666,0,15837,548397,48831
300152322100,30-015-23221,HUMIDOR BML STATE COM 002,2017-05-01,113,0,2673,0,15837,551070,48831
300152322100,30-015-23221,HUMIDOR BML STATE COM 002,2017-06-01,114,0,2607,0,15837,553677,48831
300152322100,30-015-23221,HUMIDOR BML STATE COM 002,2017-07-01,115,0,2636,0,15837,556313,48831
300152322100,30-015-23221,HUMIDOR BML STATE COM 002,2017-08-01,116,21,3552,454,15858,559865,49285
300152322100,30-015-23221,HUMIDOR BML STATE COM 002,2017-09-01,117,0,2981,27,15858,562846,49312
300152322100,30-015-23221,HUMIDOR BML STATE COM 002,2017-10-01,118,0,3176,9,15858,566022,49321
300152322100,30-015-23221,HUMIDOR BML STATE COM 002,2017-11-01,119,0,3394,0,15858,569416,49321
300152322100,30-015-23221,HUMIDOR BML STATE COM 002,2017-12-01,120,0,3332,8,15858,572748,49329
300152322100,30-015-23221,HUMIDOR BML STATE COM 002,2018-01-01,121,58,2972,483,15916,575720,49812
300152322100,30-015-23221,HUMIDOR BML STATE COM 002,2018-02-01,122,187,2874,729,16103,578594,50541
300152322100,30-015-23221,HUMIDOR BML STATE COM 002,2018-03-01,123,160,3109,745,16263,581703,51286
300152322100,30-015-23221,HUMIDOR BML STATE COM 002,2018-04-01,124,137,2688,486,16400,584391,51772
300152322100,30-015-23221,HUMIDOR BML STATE COM 002,2018-05-01,125,110,2955,542,16510,587346,52314
300152322100,30-015-23221,HUMIDOR BML STATE COM 002,2018-06-01,126,152,2779,284,16662,590125,52598
300152322100,30-015-23221,HUMIDOR BML STATE COM 002,2018-07-01,127,89,2783,344,16751,592908,52942
300152322100,30-015-23221,HUMIDOR BML STATE COM 002,2018-08-01,128,110,2769,211,16861,595677,53153
300152322100,30-015-23221,HUMIDOR BML STATE COM 002,2018-09-01,129,66,2665,66,16927,598342,53219
300152322100,30-015-23221,HUMIDOR BML STATE COM 002,2018-10-01,130,52,2713,90,16979,601055,53309
300152322100,30-015-23221,HUMIDOR BML STATE COM 002,2018-11-01,131,73,2560,183,17052,603615,53492
300152322100,30-015-23221,HUMIDOR BML STATE COM 002,2018-12-01,132,71,2826,226,17123,606441,53718
300152322100,30-015-23221,HUMIDOR BML STATE COM 002,2019-01-01,133,61,2802,221,17184,609243,53939
300152322100,30-015-23221,HUMIDOR BML STATE COM 002,2019-02-01,134,62,2571,333,17246,611814,54272
300152322100,30-015-23221,HUMIDOR BML STATE COM 002,2019-03-01,135,121,2789,177,17367,614603,54449
300152322100,30-015-23221,HUMIDOR BML STATE COM 002,2019-04-01,136,80,2640,213,17447,617243,54662
300152322100,30-015-23221,HUMIDOR BML STATE COM 002,2019-05-01,137,11,2159,83,17458,619402,54745
300152322100,30-015-23221,HUMIDOR BML STATE COM 002,2019-06-01,138,46,2681,74,17504,622083,54819
300152322100,30-015-23221,HUMIDOR BML STATE COM 002,2019-07-01,139,44,2292,26,17548,624375,54845
300152322100,30-015-23221,HUMIDOR BML STATE COM 002,2019-08-01,140,47,2288,38,17595,626663,54883
300152322100,30-015-23221,HUMIDOR BML STATE COM 002,2019-09-01,141,77,2188,11,17672,628851,54894
300152322100,30-015-23221,HUMIDOR BML STATE COM 002,2019-10-01,142,25,2541,21,17697,631392,54915
300152322100,30-015-23221,HUMIDOR BML STATE COM 002,2019-11-01,143,63,2483,41,17760,633875,54956
300152322100,30-015-23221,HUMIDOR BML STATE COM 002,2019-12-01,144,50,2321,57,17810,636196,55013
300152322100,30-015-23221,HUMIDOR BML STATE COM 002,2020-01-01,145,55,2254,66,17865,638450,55079
300152322100,30-015-23221,HUMIDOR BML STATE COM 002,2020-02-01,146,76,2460,6,17941,640910,55085
300152322100,30-015-23221,HUMIDOR BML STATE COM 002,2020-03-01,147,63,2497,22,18004,643407,55107
300152322100,30-015-23221,HUMIDOR BML STATE COM 002,2020-04-01,148,12,2271,0,18016,645678,55107
300152322100,30-015-23221,HUMIDOR BML STATE COM 002,2020-05-01,149,0,509,18,18016,646187,55125
300152322100,30-015-23221,HUMIDOR BML STATE COM 002,2020-06-01,150,36,1915,25,18052,648102,55150
300152322100,30-015-23221,HUMIDOR BML STATE COM 002,2020-07-01,151,3,2129,0,18055,650231,55150
300152322100,30-015-23221,HUMIDOR BML STATE COM 002,2020-08-01,152,16,2048,19,18071,652279,55169
300152322100,30-015-23221,HUMIDOR BML STATE COM 002,2020-09-01,153,4,2069,6,18075,654348,55175
300152322100,30-015-23221,HUMIDOR BML STATE COM 002,2020-10-01,154,10,1929,12,18085,656277,55187
300152322100,30-015-23221,HUMIDOR BML STATE COM 002,2020-11-01,155,17,2058,25,18102,658335,55212
300152322100,30-015-23221,HUMIDOR BML STATE COM 002,2020-12-01,156,2,2073,3,18104,660408,55215
300152322100,30-015-23221,HUMIDOR BML STATE COM 002,2021-01-01,157,16,2086,9,18120,662494,55224
300152322100,30-015-23221,HUMIDOR BML STATE COM 002,2021-02-01,158,2,1844,2,18122,664338,55226
300152322100,30-015-23221,HUMIDOR BML STATE COM 002,2021-03-01,159,0,2029,6,18122,666367,55232
300152322100,30-015-23221,HUMIDOR BML STATE COM 002,2021-04-01,160,0,1937,0,18122,668304,55232
300152322100,30-015-23221,HUMIDOR BML STATE COM 002,2021-05-01,161,14,1885,3,18136,670189,55235
300152322100,30-015-23221,HUMIDOR BML STATE COM 002,2021-06-01,162,7,1832,6,18143,672021,55241
300152322100,30-015-23221,HUMIDOR BML STATE COM 002,2021-07-01,163,8,1928,0,18151,673949,55241
300152322100,30-015-23221,HUMIDOR BML STATE COM 002,2021-08-01,164,3,1885,3,18154,675834,55244
300152322100,30-015-23221,HUMIDOR BML STATE COM 002,2021-09-01,165,0,2057,3,18154,677891,55247
300152322100,30-015-23221,HUMIDOR BML STATE COM 002,2021-10-01,166,0,2111,0,18154,680002,55247
300152322100,30-015-23221,HUMIDOR BML STATE COM 002,2021-11-01,167,0,1998,0,18154,682000,55247
300152322100,30-015-23221,HUMIDOR BML STATE COM 002,2021-12-01,168,0,2387,0,18154,684387,55247
300152322100,30-015-23221,HUMIDOR BML STATE COM 002,2022-01-01,169,0,2403,0,18154,686790,55247
300152322100,30-015-23221,HUMIDOR BML STATE COM 002,2022-02-01,170,0,2024,0,18154,688814,55247
300152322100,30-015-23221,HUMIDOR BML STATE COM 002,2022-03-01,171,5,2039,7,18159,690853,55254
300152322100,30-015-23221,HUMIDOR BML STATE COM 002,2022-04-01,172,13,1892,3,18172,692745,55257
300152322100,30-015-23221,HUMIDOR BML STATE COM 002,2022-05-01,173,12,1901,6,18184,694646,55263
300152322100,30-015-23221,HUMIDOR BML STATE COM 002,2022-06-01,174,32,1857,3,18216,696503,55266
300152322100,30-015-23221,HUMIDOR BML STATE COM 002,2022-07-01,175,12,1930,3,18228,698433,55269
300152322100,30-015-23221,HUMIDOR BML STATE COM 002,2022-08-01,176,21,1847,0,18249,700280,55269
300152322100,30-015-23221,HUMIDOR BML STATE COM 002,2022-09-01,177,0,1666,0,18249,701946,55269
300152322100,30-015-23221,HUMIDOR BML STATE COM 002,2022-10-01,178,39,1489,12,18288,703435,55281
300152322100,30-015-23221,HUMIDOR BML STATE COM 002,2022-11-01,179,24,1599,0,18312,705034,55281
300152322100,30-015-23221,HUMIDOR BML STATE COM 002,2022-12-01,180,11,1292,0,18323,706326,55281
300152322100,30-015-23221,HUMIDOR BML STATE COM 002,2023-01-01,181,58,1577,0,18381,707903,55281
300152322100,30-015-23221,HUMIDOR BML STATE COM 002,2023-02-01,182,0,1222,0,18381,709125,55281
300152322100,30-015-23221,HUMIDOR BML STATE COM 002,2023-03-01,183,6,1561,0,18387,710686,55281
300152322100,30-015-23221,HUMIDOR BML STATE COM 002,2023-04-01,184,16,1232,0,18403,711918,55281
300152322100,30-015-23221,HUMIDOR BML STATE COM 002,2023-05-01,185,17,1188,0,18420,713106,55281
300152322100,30-015-23221,HUMIDOR BML STATE COM 002,2023-06-01,186,5,1641,0,18425,714747,55281
300152322100,30-015-23221,HUMIDOR BML STATE COM 002,2023-07-01,187,0,1785,0,18425,716532,55281
300153649901,30-015-36499,PERDOMO BMP STATE COM 001H,2010-08-01,1,1038,26071,15664,1038,26071,15664
300153649901,30-015-36499,PERDOMO BMP STATE COM 001H,2010-09-01,2,919,55649,6772,1957,81720,22436
300153649901,30-015-36499,PERDOMO BMP STATE COM 001H,2010-10-01,3,472,39102,3327,2429,120822,25763
300153649901,30-015-36499,PERDOMO BMP STATE COM 001H,2010-11-01,4,312,26846,2119,2741,147668,27882
300153649901,30-015-36499,PERDOMO BMP STATE COM 001H,2010-12-01,5,273,22286,1542,3014,169954,29424
300153649901,30-015-36499,PERDOMO BMP STATE COM 001H,2011-01-01,6,208,12419,1287,3222,182373,30711
300153649901,30-015-36499,PERDOMO BMP STATE COM 001H,2011-02-01,7,133,13799,1245,3355,196172,31956
300153649901,30-015-36499,PERDOMO BMP STATE COM 001H,2011-03-01,8,208,23415,1146,3563,219587,33102
300153649901,30-015-36499,PERDOMO BMP STATE COM 001H,2011-04-01,9,137,21371,790,3700,240958,33892
300153649901,30-015-36499,PERDOMO BMP STATE COM 001H,2011-05-01,10,119,19907,786,3819,260865,34678
300153649901,30-015-36499,PERDOMO BMP STATE COM 001H,2011-06-01,11,17,4140,171,3836,265005,34849
300153649901,30-015-36499,PERDOMO BMP STATE COM 001H,2011-07-01,12,14,0,0,3850,265005,34849
300153649901,30-015-36499,PERDOMO BMP STATE COM 001H,2011-08-01,13,0,0,0,3850,265005,34849
300153649901,30-015-36499,PERDOMO BMP STATE COM 001H,2011-09-01,14,11,0,0,3861,265005,34849
300153649901,30-015-36499,PERDOMO BMP STATE COM 001H,2011-10-01,15,0,0,0,3861,265005,34849
300153649901,30-015-36499,PERDOMO BMP STATE COM 001H,2011-11-01,16,161,23536,565,4022,288541,35414
300153649901,30-015-36499,PERDOMO BMP STATE COM 001H,2011-12-01,17,92,25515,1330,4114,314056,36744
300153649901,30-015-36499,PERDOMO BMP STATE COM 001H,2012-01-01,18,108,19548,958,4222,333604,37702
300153649901,30-015-36499,PERDOMO BMP STATE COM 001H,2012-02-01,19,1,67,304,4223,333671,38006
300153649901,30-015-36499,PERDOMO BMP STATE COM 001H,2012-03-01,20,24,8419,639,4247,342090,38645
300153649901,30-015-36499,PERDOMO BMP STATE COM 001H,2012-04-01,21,75,19294,813,4322,361384,39458
300153649901,30-015-36499,PERDOMO BMP STATE COM 001H,2012-05-01,22,64,16329,892,4386,377713,40350
300153649901,30-015-36499,PERDOMO BMP STATE COM 001H,2012-06-01,23,50,14565,579,4436,392278,40929
300153649901,30-015-36499,PERDOMO BMP STATE COM 001H,2012-07-01,24,50,12019,533,4486,404297,41462
300153649901,30-015-36499,PERDOMO BMP STATE COM 001H,2012-08-01,25,44,13216,495,4530,417513,41957
300153649901,30-015-36499,PERDOMO BMP STATE COM 001H,2012-09-01,26,50,11401,229,4580,428914,42186
300153649901,30-015-36499,PERDOMO BMP STATE COM 001H,2012-10-01,27,36,11024,386,4616,439938,42572
300153649901,30-015-36499,PERDOMO BMP STATE COM 001H,2012-11-01,28,53,9534,180,4669,449472,42752
300153649901,30-015-36499,PERDOMO BMP STATE COM 001H,2012-12-01,29,95,9186,213,4764,458658,42965
300153649901,30-015-36499,PERDOMO BMP STATE COM 001H,2013-01-01,30,210,9407,133,4974,468065,43098
300153649901,30-015-36499,PERDOMO BMP STATE COM 001H,2013-02-01,31,221,7668,389,5195,475733,43487
300153649901,30-015-36499,PERDOMO BMP STATE COM 001H,2013-03-01,32,138,7534,292,5333,483267,43779
300153649901,30-015-36499,PERDOMO BMP STATE COM 001H,2013-04-01,33,207,12796,690,5540,496063,44469
300153649901,30-015-36499,PERDOMO BMP STATE COM 001H,2013-05-01,34,106,7107,233,5646,503170,44702
300153649901,30-015-36499,PERDOMO BMP STATE COM 001H,2013-06-01,35,155,7788,399,5801,510958,45101
300153649901,30-015-36499,PERDOMO BMP STATE COM 001H,2013-07-01,36,169,9601,301,5970,520559,45402
300153649901,30-015-36499,PERDOMO BMP STATE COM 001H,2013-08-01,37,117,10925,256,6087,531484,45658
300153649901,30-015-36499,PERDOMO BMP STATE COM 001H,2013-09-01,38,174,8785,145,6261,540269,45803
300153649901,30-015-36499,PERDOMO BMP STATE COM 001H,2013-10-01,39,236,10305,214,6497,550574,46017
300153649901,30-015-36499,PERDOMO BMP STATE COM 001H,2013-11-01,40,213,8969,212,6710,559543,46229
300153649901,30-015-36499,PERDOMO BMP STATE COM 001H,2013-12-01,41,166,8094,190,6876,567637,46419
300153649901,30-015-36499,PERDOMO BMP STATE COM 001H,2014-01-01,42,197,8885,256,7073,576522,46675
300153649901,30-015-36499,PERDOMO BMP STATE COM 001H,2014-02-01,43,164,6031,170,7237,582553,46845
300153649901,30-015-36499,PERDOMO BMP STATE COM 001H,2014-03-01,44,181,6866,170,7418,589419,47015
300153649901,30-015-36499,PERDOMO BMP STATE COM 001H,2014-04-01,45,292,7915,135,7710,597334,47150
300153649901,30-015-36499,PERDOMO BMP STATE COM 001H,2014-05-01,46,325,8070,180,8035,605404,47330
300153649901,30-015-36499,PERDOMO BMP STATE COM 001H,2014-06-01,47,71,3982,111,8106,609386,47441
300153649901,30-015-36499,PERDOMO BMP STATE COM 001H,2014-07-01,48,49,2364,225,8155,611750,47666
300153649901,30-015-36499,PERDOMO BMP STATE COM 001H,2014-08-01,49,14,7621,248,8169,619371,47914
300153649901,30-015-36499,PERDOMO BMP STATE COM 001H,2014-09-01,50,11,6202,1135,8180,625573,49049
300153649901,30-015-36499,PERDOMO BMP STATE COM 001H,2014-10-01,51,11,6722,240,8191,632295,49289
300153649901,30-015-36499,PERDOMO BMP STATE COM 001H,2014-11-01,52,11,4257,0,8202,636552,49289
300153649901,30-015-36499,PERDOMO BMP STATE COM 001H,2014-12-01,53,86,4355,902,8288,640907,50191
300153649901,30-015-36499,PERDOMO BMP STATE COM 001H,2015-01-01,54,2,3133,18,8290,644040,50209
300153649901,30-015-36499,PERDOMO BMP STATE COM 001H,2015-02-01,55,39,7005,604,8329,651045,50813
300153649901,30-015-36499,PERDOMO BMP STATE COM 001H,2015-03-01,56,14,3607,190,8343,654652,51003
300153649901,30-015-36499,PERDOMO BMP STATE COM 001H,2015-04-01,57,11,3834,223,8354,658486,51226
300153649901,30-015-36499,PERDOMO BMP STATE COM 001H,2015-05-01,58,28,5617,216,8382,664103,51442
300153649901,30-015-36499,PERDOMO BMP STATE COM 001H,2015-06-01,59,28,5768,272,8410,669871,51714
300153649901,30-015-36499,PERDOMO BMP STATE COM 001H,2015-07-01,60,0,1718,3,8410,671589,51717
300153649901,30-015-36499,PERDOMO BMP STATE COM 001H,2015-08-01,61,0,3030,1,8410,674619,51718
300153649901,30-015-36499,PERDOMO BMP STATE COM 001H,2015-09-01,62,4,0,17,8414,674619,51735
300153649901,30-015-36499,PERDOMO BMP STATE COM 001H,2015-10-01,63,0,267,1,8414,674886,51736
300153649901,30-015-36499,PERDOMO BMP STATE COM 001H,2015-11-01,64,0,0,0,8414,674886,51736
300153649901,30-015-36499,PERDOMO BMP STATE COM 001H,2015-12-01,65,5,338,0,8419,675224,51736
300153649901,30-015-36499,PERDOMO BMP STATE COM 001H,2016-01-01,66,0,1785,0,8419,677009,51736
300153649901,30-015-36499,PERDOMO BMP STATE COM 001H,2016-02-01,67,129,2339,392,8548,679348,52128
300153649901,30-015-36499,PERDOMO BMP STATE COM 001H,2016-03-01,68,136,10374,4244,8684,689722,56372
300153649901,30-015-36499,PERDOMO BMP STATE COM 001H,2016-04-01,69,11,8388,680,8695,698110,57052
300153649901,30-015-36499,PERDOMO BMP STATE COM 001H,2016-05-01,70,6,5695,185,8701,703805,57237
300153649901,30-015-36499,PERDOMO BMP STATE COM 001H,2016-06-01,71,0,2596,1,8701,706401,57238
300153649901,30-015-36499,PERDOMO BMP STATE COM 001H,2016-07-01,72,0,1376,0,8701,707777,57238
300153649901,30-015-36499,PERDOMO BMP STATE COM 001H,2016-08-01,73,0,1004,0,8701,708781,57238
300153649901,30-015-36499,PERDOMO BMP STATE COM 001H,2016-09-01,74,43,3195,110,8744,711976,57348
300153649901,30-015-36499,PERDOMO BMP STATE COM 001H,2016-10-01,75,34,9259,505,8778,721235,57853
300153649901,30-015-36499,PERDOMO BMP STATE COM 001H,2016-11-01,76,16,7089,395,8794,728324,58248
300153649901,30-015-36499,PERDOMO BMP STATE COM 001H,2016-12-01,77,16,7411,259,8810,735735,58507
300153649901,30-015-36499,PERDOMO BMP STATE COM 001H,2017-01-01,78,14,7362,202,8824,743097,58709
300153649901,30-015-36499,PERDOMO BMP STATE COM 001H,2017-02-01,79,11,6431,265,8835,749528,58974
300153649901,30-015-36499,PERDOMO BMP STATE COM 001H,2017-03-01,80,11,5931,102,8846,755459,59076
300153649901,30-015-36499,PERDOMO BMP STATE COM 001H,2017-04-01,81,7,5747,68,8853,761206,59144
300153649901,30-015-36499,PERDOMO BMP STATE COM 001H,2017-05-01,82,37,5402,111,8890,766608,59255
300153649901,30-015-36499,PERDOMO BMP STATE COM 001H,2017-06-01,83,18,5217,217,8908,771825,59472
300153649901,30-015-36499,PERDOMO BMP STATE COM 001H,2017-07-01,84,13,7045,308,8921,778870,59780
300153649901,30-015-36499,PERDOMO BMP STATE COM 001H,2017-08-01,85,11,8914,339,8932,787784,60119
300153649901,30-015-36499,PERDOMO BMP STATE COM 001H,2017-09-01,86,24,8849,471,8956,796633,60590
300153649901,30-015-36499,PERDOMO BMP STATE COM 001H,2017-10-01,87,6,4498,469,8962,801131,61059
300153649901,30-015-36499,PERDOMO BMP STATE COM 001H,2017-11-01,88,0,3797,287,8962,804928,61346
300153649901,30-015-36499,PERDOMO BMP STATE COM 001H,2017-12-01,89,0,3149,370,8962,808077,61716
300153649901,30-015-36499,PERDOMO BMP STATE COM 001H,2018-01-01,90,0,3144,351,8962,811221,62067
300153649901,30-015-36499,PERDOMO BMP STATE COM 001H,2018-02-01,91,0,2987,299,8962,814208,62366
300153649901,30-015-36499,PERDOMO BMP STATE COM 001H,2018-03-01,92,0,3248,331,8962,817456,62697
300153649901,30-015-36499,PERDOMO BMP STATE COM 001H,2018-04-01,93,0,2896,321,8962,820352,63018
300153649901,30-015-36499,PERDOMO BMP STATE COM 001H,2018-05-01,94,0,2935,325,8962,823287,63343
300153649901,30-015-36499,PERDOMO BMP STATE COM 001H,2018-06-01,95,0,2716,301,8962,826003,63644
300153649901,30-015-36499,PERDOMO BMP STATE COM 001H,2018-07-01,96,0,2766,302,8962,828769,63946
300153649901,30-015-36499,PERDOMO BMP STATE COM 001H,2018-08-01,97,0,2550,310,8962,831319,64256
300153649901,30-015-36499,PERDOMO BMP STATE COM 001H,2018-09-01,98,0,2534,301,8962,833853,64557
300153649901,30-015-36499,PERDOMO BMP STATE COM 001H,2018-10-01,99,0,2514,306,8962,836367,64863
300153649901,30-015-36499,PERDOMO BMP STATE COM 001H,2018-11-01,100,0,2202,283,8962,838569,65146
300153649901,30-015-36499,PERDOMO BMP STATE COM 001H,2018-12-01,101,0,2359,287,8962,840928,65433
300153649901,30-015-36499,PERDOMO BMP STATE COM 001H,2019-01-01,102,11,5539,286,8973,846467,65719
300153649901,30-015-36499,PERDOMO BMP STATE COM 001H,2019-02-01,103,10,4694,248,8983,851161,65967
300153649901,30-015-36499,PERDOMO BMP STATE COM 001H,2019-03-01,104,0,5298,276,8983,856459,66243
300153649901,30-015-36499,PERDOMO BMP STATE COM 001H,2019-04-01,105,10,5476,276,8993,861935,66519
300153649901,30-015-36499,PERDOMO BMP STATE COM 001H,2019-05-01,106,11,4919,266,9004,866854,66785
300153649901,30-015-36499,PERDOMO BMP STATE COM 001H,2019-06-01,107,11,5438,257,9015,872292,67042
300153649901,30-015-36499,PERDOMO BMP STATE COM 001H,2019-07-01,108,9,5620,256,9024,877912,67298
300153649901,30-015-36499,PERDOMO BMP STATE COM 001H,2019-08-01,109,0,5551,261,9024,883463,67559
300153649901,30-015-36499,PERDOMO BMP STATE COM 001H,2019-09-01,110,4,5516,249,9028,888979,67808
300153649901,30-015-36499,PERDOMO BMP STATE COM 001H,2019-10-01,111,3,6765,216,9031,895744,68024
300153649901,30-015-36499,PERDOMO BMP STATE COM 001H,2019-11-01,112,6,5599,227,9037,901343,68251
300153649901,30-015-36499,PERDOMO BMP STATE COM 001H,2019-12-01,113,8,5499,238,9045,906842,68489
300153649901,30-015-36499,PERDOMO BMP STATE COM 001H,2020-01-01,114,7,5308,229,9052,912150,68718
300153649901,30-015-36499,PERDOMO BMP STATE COM 001H,2020-02-01,115,104,6744,198,9156,918894,68916
300153649901,30-015-36499,PERDOMO BMP STATE COM 001H,2020-03-01,116,76,5500,90,9232,924394,69006
300153649901,30-015-36499,PERDOMO BMP STATE COM 001H,2020-04-01,117,12,5595,206,9244,929989,69212
300153649901,30-015-36499,PERDOMO BMP STATE COM 001H,2020-05-01,118,0,3057,0,9244,933046,69212
300153649901,30-015-36499,PERDOMO BMP STATE COM 001H,2020-06-01,119,21,5781,191,9265,938827,69403
300153649901,30-015-36499,PERDOMO BMP STATE COM 001H,2020-07-01,120,14,5444,196,9279,944271,69599
300153649901,30-015-36499,PERDOMO BMP STATE COM 001H,2020-08-01,121,8,5060,119,9287,949331,69718
300153649901,30-015-36499,PERDOMO BMP STATE COM 001H,2020-09-01,122,23,4928,239,9310,954259,69957
300153649901,30-015-36499,PERDOMO BMP STATE COM 001H,2020-10-01,123,11,4580,191,9321,958839,70148
300153649901,30-015-36499,PERDOMO BMP STATE COM 001H,2020-11-01,124,15,5422,212,9336,964261,70360
300153649901,30-015-36499,PERDOMO BMP STATE COM 001H,2020-12-01,125,15,5807,180,9351,970068,70540
300153649901,30-015-36499,PERDOMO BMP STATE COM 001H,2021-01-01,126,8,5968,128,9359,976036,70668
300153649901,30-015-36499,PERDOMO BMP STATE COM 001H,2021-02-01,127,21,5442,213,9380,981478,70881
300153649901,30-015-36499,PERDOMO BMP STATE COM 001H,2021-03-01,128,11,5515,172,9391,986993,71053
300153649901,30-015-36499,PERDOMO BMP STATE COM 001H,2021-04-01,129,11,4865,174,9402,991858,71227
300153649901,30-015-36499,PERDOMO BMP STATE COM 001H,2021-05-01,130,11,5067,175,9413,996925,71402
300153649901,30-015-36499,PERDOMO BMP STATE COM 001H,2021-06-01,131,23,4951,255,9436,1001876,71657
300153649901,30-015-36499,PERDOMO BMP STATE COM 001H,2021-07-01,132,20,5340,269,9456,1007216,71926
300153649901,30-015-36499,PERDOMO BMP STATE COM 001H,2021-08-01,133,17,5047,317,9473,1012263,72243
300153649901,30-015-36499,PERDOMO BMP STATE COM 001H,2021-09-01,134,4,4259,289,9477,1016522,72532
300153649901,30-015-36499,PERDOMO BMP STATE COM 001H,2021-10-01,135,13,4931,314,9490,1021453,72846
300153649901,30-015-36499,PERDOMO BMP STATE COM 001H,2021-11-01,136,18,4601,253,9508,1026054,73099
300153649901,30-015-36499,PERDOMO BMP STATE COM 001H,2021-12-01,137,7,5098,253,9515,1031152,73352
300153649901,30-015-36499,PERDOMO BMP STATE COM 001H,2022-01-01,138,10,5039,202,9525,1036191,73554
300153649901,30-015-36499,PERDOMO BMP STATE COM 001H,2022-02-01,139,16,4439,192,9541,1040630,73746
300153649901,30-015-36499,PERDOMO BMP STATE COM 001H,2022-03-01,140,13,5158,232,9554,1045788,73978
300153649901,30-015-36499,PERDOMO BMP STATE COM 001H,2022-04-01,141,12,2992,212,9566,1048780,74190
300153649901,30-015-36499,PERDOMO BMP STATE COM 001H,2022-05-01,142,12,5303,95,9578,1054083,74285
300153649901,30-015-36499,PERDOMO BMP STATE COM 001H,2022-06-01,143,3,3106,10,9581,1057189,74295
300153649901,30-015-36499,PERDOMO BMP STATE COM 001H,2022-07-01,144,0,3335,0,9581,1060524,74295
300153649901,30-015-36499,PERDOMO BMP STATE COM 001H,2022-08-01,145,0,3063,0,9581,1063587,74295
300153649901,30-015-36499,PERDOMO BMP STATE COM 001H,2022-09-01,146,0,2003,0,9581,1065590,74295
300153649901,30-015-36499,PERDOMO BMP STATE COM 001H,2022-10-01,147,0,2501,0,9581,1068091,74295
300153649901,30-015-36499,PERDOMO BMP STATE COM 001H,2022-11-01,148,0,3021,0,9581,1071112,74295
300153649901,30-015-36499,PERDOMO BMP STATE COM 001H,2022-12-01,149,0,2663,0,9581,1073775,74295
300153649901,30-015-36499,PERDOMO BMP STATE COM 001H,2023-01-01,150,0,2252,0,9581,1076027,74295
300153649901,30-015-36499,PERDOMO BMP STATE COM 001H,2023-02-01,151,0,2263,63,9581,1078290,74358
300153649901,30-015-36499,PERDOMO BMP STATE COM 001H,2023-03-01,152,0,3987,2,9581,1082277,74360
300153649901,30-015-36499,PERDOMO BMP STATE COM 001H,2023-04-01,153,0,172,0,9581,1082449,74360
300153649901,30-015-36499,PERDOMO BMP STATE COM 001H,2023-05-01,154,0,4223,0,9581,1086672,74360
300153649901,30-015-36499,PERDOMO BMP STATE COM 001H,2023-06-01,155,2,3612,0,9583,1090284,74360
300153649901,30-015-36499,PERDOMO BMP STATE COM 001H,2023-07-01,156,0,2730,1,9583,1093014,74361
300154095000,30-015-40950,BONGO FEE 001H,2013-06-01,1,5505,1387,17853,5505,1387,17853
300154095000,30-015-40950,BONGO FEE 001H,2013-07-01,2,6693,25790,46963,12198,27177,64816
300154095000,30-015-40950,BONGO FEE 001H,2013-08-01,3,4265,18419,35798,16463,45596,100614
300154095000,30-015-40950,BONGO FEE 001H,2013-09-01,4,3256,12153,26981,19719,57749,127595
300154095000,30-015-40950,BONGO FEE 001H,2013-10-01,5,2545,10092,19449,22264,67841,147044
300154095000,30-015-40950,BONGO FEE 001H,2013-11-01,6,2488,7771,15375,24752,75612,162419
300154095000,30-015-40950,BONGO FEE 001H,2013-12-01,7,2046,6260,13266,26798,81872,175685
300154095000,30-015-40950,BONGO FEE 001H,2014-01-01,8,454,1260,2104,27252,83132,177789
300154095000,30-015-40950,BONGO FEE 001H,2014-02-01,9,556,662,86,27808,83794,177875
300154095000,30-015-40950,BONGO FEE 001H,2014-03-01,10,2060,3390,4287,29868,87184,182162
300154095000,30-015-40950,BONGO FEE 001H,2014-04-01,11,1449,3138,3977,31317,90322,186139
300154095000,30-015-40950,BONGO FEE 001H,2014-05-01,12,903,1961,3040,32220,92283,189179
300154095000,30-015-40950,BONGO FEE 001H,2014-06-01,13,936,1709,1841,33156,93992,191020
300154095000,30-015-40950,BONGO FEE 001H,2014-07-01,14,1798,1513,4296,34954,95505,195316
300154095000,30-015-40950,BONGO FEE 001H,2014-08-01,15,1246,3081,3978,36200,98586,199294
300154095000,30-015-40950,BONGO FEE 001H,2014-09-01,16,932,2224,2958,37132,100810,202252
300154095000,30-015-40950,BONGO FEE 001H,2014-10-01,17,1225,2521,3682,38357,103331,205934
300154095000,30-015-40950,BONGO FEE 001H,2014-11-01,18,1215,2968,4671,39572,106299,210605
300154095000,30-015-40950,BONGO FEE 001H,2014-12-01,19,1040,1324,4387,40612,107623,214992
300154095000,30-015-40950,BONGO FEE 001H,2015-01-01,20,1106,1175,4078,41718,108798,219070
300154095000,30-015-40950,BONGO FEE 001H,2015-02-01,21,973,1623,3712,42691,110421,222782
300154095000,30-015-40950,BONGO FEE 001H,2015-03-01,22,839,365,3022,43530,110786,225804
300154095000,30-015-40950,BONGO FEE 001H,2015-04-01,23,68,225,199,43598,111011,226003
300154095000,30-015-40950,BONGO FEE 001H,2015-05-01,24,971,610,2030,44569,111621,228033
300154095000,30-015-40950,BONGO FEE 001H,2015-06-01,25,1248,191,7079,45817,111812,235112
300154095000,30-015-40950,BONGO FEE 001H,2015-07-01,26,1091,1161,6566,46908,112973,241678
300154095000,30-015-40950,BONGO FEE 001H,2015-08-01,27,1011,483,6450,47919,113456,248128
300154095000,30-015-40950,BONGO FEE 001H,2015-09-01,28,946,0,5785,48865,113456,253913
300154095000,30-015-40950,BONGO FEE 001H,2015-10-01,29,920,0,6920,49785,113456,260833
300154095000,30-015-40950,BONGO FEE 001H,2015-11-01,30,856,0,5563,50641,113456,266396
300154095000,30-015-40950,BONGO FEE 001H,2015-12-01,31,718,1555,4432,51359,115011,270828
300154095000,30-015-40950,BONGO FEE 001H,2016-01-01,32,772,2457,3513,52131,117468,274341
300154095000,30-015-40950,BONGO FEE 001H,2016-02-01,33,877,3751,5042,53008,121219,279383
300154095000,30-015-40950,BONGO FEE 001H,2016-03-01,34,805,4000,4862,53813,125219,284245
300154095000,30-015-40950,BONGO FEE 001H,2016-04-01,35,737,3713,4434,54550,128932,288679
300154095000,30-015-40950,BONGO FEE 001H,2016-05-01,36,675,3191,3053,55225,132123,291732
300154095000,30-015-40950,BONGO FEE 001H,2016-06-01,37,620,2953,2703,55845,135076,294435
300154095000,30-015-40950,BONGO FEE 001H,2016-07-01,38,624,2761,3199,56469,137837,297634
300154095000,30-015-40950,BONGO FEE 001H,2016-08-01,39,675,2516,3055,57144,140353,300689
300154095000,30-015-40950,BONGO FEE 001H,2016-09-01,40,650,2581,3205,57794,142934,303894
300154095000,30-015-40950,BONGO FEE 001H,2016-10-01,41,635,2442,3069,58429,145376,306963
300154095000,30-015-40950,BONGO FEE 001H,2016-11-01,42,615,2494,2896,59044,147870,309859
300154095000,30-015-40950,BONGO FEE 001H,2016-12-01,43,582,2287,2558,59626,150157,312417
300154095000,30-015-40950,BONGO FEE 001H,2017-01-01,44,691,2958,4075,60317,153115,316492
300154095000,30-015-40950,BONGO FEE 001H,2017-02-01,45,562,2591,3515,60879,155706,320007
300154095000,30-015-40950,BONGO FEE 001H,2017-03-01,46,362,1394,1278,61241,157100,321285
300154095000,30-015-40950,BONGO FEE 001H,2017-04-01,47,523,1963,2494,61764,159063,323779
300154095000,30-015-40950,BONGO FEE 001H,2017-05-01,48,713,2726,4828,62477,161789,328607
300154095000,30-015-40950,BONGO FEE 001H,2017-06-01,49,601,2694,4622,63078,164483,333229
300154095000,30-015-40950,BONGO FEE 001H,2017-07-01,50,580,2965,4851,63658,167448,338080
300154095000,30-015-40950,BONGO FEE 001H,2017-08-01,51,532,3342,4434,64190,170790,342514
300154095000,30-015-40950,BONGO FEE 001H,2017-09-01,52,544,3218,4620,64734,174008,347134
300154095000,30-015-40950,BONGO FEE 001H,2017-10-01,53,528,2967,3898,65262,176975,351032
300154095000,30-015-40950,BONGO FEE 001H,2017-11-01,54,555,2999,3678,65817,179974,354710
300154095000,30-015-40950,BONGO FEE 001H,2017-12-01,55,580,3498,4537,66397,183472,359247
300154095000,30-015-40950,BONGO FEE 001H,2018-01-01,56,489,2923,3207,66886,186395,362454
300154095000,30-015-40950,BONGO FEE 001H,2018-02-01,57,483,2743,3400,67369,189138,365854
300154095000,30-015-40950,BONGO FEE 001H,2018-03-01,58,457,2441,3394,67826,191579,369248
300154095000,30-015-40950,BONGO FEE 001H,2018-04-01,59,413,1843,2078,68239,193422,371326
300154095000,30-015-40950,BONGO FEE 001H,2018-05-01,60,401,2256,1547,68640,195678,372873
300154095000,30-015-40950,BONGO FEE 001H,2018-06-01,61,403,2104,1633,69043,197782,374506
300154095000,30-015-40950,BONGO FEE 001H,2018-07-01,62,375,1851,1677,69418,199633,376183
300154095000,30-015-40950,BONGO FEE 001H,2018-08-01,63,410,1705,1610,69828,201338,377793
300154095000,30-015-40950,BONGO FEE 001H,2018-09-01,64,599,2444,4111,70427,203782,381904
300154095000,30-015-40950,BONGO FEE 001H,2018-10-01,65,577,2855,4594,71004,206637,386498
300154095000,30-015-40950,BONGO FEE 001H,2018-11-01,66,558,2860,4672,71562,209497,391170
300154095000,30-015-40950,BONGO FEE 001H,2018-12-01,67,564,3413,5228,72126,212910,396398
300154095000,30-015-40950,BONGO FEE 001H,2019-01-01,68,450,3190,4415,72576,216100,400813
300154095000,30-015-40950,BONGO FEE 001H,2019-02-01,69,522,3267,3594,73098,219367,404407
300154095000,30-015-40950,BONGO FEE 001H,2019-03-01,70,500,3818,4603,73598,223185,409010
300154095000,30-015-40950,BONGO FEE 001H,2019-04-01,71,443,3686,3965,74041,226871,412975
300154095000,30-015-40950,BONGO FEE 001H,2019-05-01,72,337,3017,3716,74378,229888,416691
300154095000,30-015-40950,BONGO FEE 001H,2019-06-01,73,414,3428,4493,74792,233316,421184
300154095000,30-015-40950,BONGO FEE 001H,2019-07-01,74,507,4104,4726,75299,237420,425910
300154095000,30-015-40950,BONGO FEE 001H,2019-08-01,75,449,3984,4551,75748,241404,430461
300154095000,30-015-40950,BONGO FEE 001H,2019-09-01,76,467,3597,3647,76215,245001,434108
300154095000,30-015-40950,BONGO FEE 001H,2019-10-01,77,468,4068,4545,76683,249069,438653
300154095000,30-015-40950,BONGO FEE 001H,2019-11-01,78,425,4009,4842,77108,253078,443495
300154095000,30-015-40950,BONGO FEE 001H,2019-12-01,79,440,4040,4959,77548,257118,448454
300154095000,30-015-40950,BONGO FEE 001H,2020-01-01,80,376,3770,3833,77924,260888,452287
300154095000,30-015-40950,BONGO FEE 001H,2020-02-01,81,431,3699,3920,78355,264587,456207
300154095000,30-015-40950,BONGO FEE 001H,2020-03-01,82,416,3725,4053,78771,268312,460260
300154095000,30-015-40950,BONGO FEE 001H,2020-04-01,83,378,3743,4051,79149,272055,464311
300154095000,30-015-40950,BONGO FEE 001H,2020-05-01,84,422,3907,4423,79571,275962,468734
300154095000,30-015-40950,BONGO FEE 001H,2020-06-01,85,352,3313,3336,79923,279275,472070
300154095000,30-015-40950,BONGO FEE 001H,2020-07-01,86,376,3284,3246,80299,282559,475316
300154095000,30-015-40950,BONGO FEE 001H,2020-08-01,87,393,3559,2976,80692,286118,478292
300154095000,30-015-40950,BONGO FEE 001H,2020-09-01,88,416,3595,3645,81108,289713,481937
300154095000,30-015-40950,BONGO FEE 001H,2020-10-01,89,364,3224,2461,81472,292937,484398
300154095000,30-015-40950,BONGO FEE 001H,2020-11-01,90,348,3046,2566,81820,295983,486964
300154095000,30-015-40950,BONGO FEE 001H,2020-12-01,91,399,3010,2730,82219,298993,489694
300154095000,30-015-40950,BONGO FEE 001H,2021-01-01,92,385,3130,2079,82604,302123,491773
300154095000,30-015-40950,BONGO FEE 001H,2021-02-01,93,369,2682,2297,82973,304805,494070
300154095000,30-015-40950,BONGO FEE 001H,2021-03-01,94,356,2975,2391,83329,307780,496461
300154095000,30-015-40950,BONGO FEE 001H,2021-04-01,95,332,2930,2587,83661,310710,499048
300154095000,30-015-40950,BONGO FEE 001H,2021-05-01,96,341,2871,2774,84002,313581,501822
300154095000,30-015-40950,BONGO FEE 001H,2021-06-01,97,371,2851,2439,84373,316432,504261
300154095000,30-015-40950,BONGO FEE 001H,2021-07-01,98,385,3107,3056,84758,319539,507317
300154095000,30-015-40950,BONGO FEE 001H,2021-08-01,99,340,2886,3217,85098,322425,510534
300154095000,30-015-40950,BONGO FEE 001H,2021-09-01,100,335,2707,2780,85433,325132,513314
300154095000,30-015-40950,BONGO FEE 001H,2021-10-01,101,359,2937,3038,85792,328069,516352
300154095000,30-015-40950,BONGO FEE 001H,2021-11-01,102,324,2654,2613,86116,330723,518965
300154095000,30-015-40950,BONGO FEE 001H,2021-12-01,103,328,2712,2340,86444,333435,521305
300154095000,30-015-40950,BONGO FEE 001H,2022-01-01,104,207,1848,1112,86651,335283,522417
300154095000,30-015-40950,BONGO FEE 001H,2022-02-01,105,379,2628,2690,87030,337911,525107
300154095000,30-015-40950,BONGO FEE 001H,2022-03-01,106,344,2792,2819,87374,340703,527926
300154095000,30-015-40950,BONGO FEE 001H,2022-04-01,107,197,1959,918,87571,342662,528844
300154095000,30-015-40950,BONGO FEE 001H,2022-05-01,108,259,2018,1063,87830,344680,529907
300154095000,30-015-40950,BONGO FEE 001H,2022-06-01,109,173,1662,773,88003,346342,530680
300154095000,30-015-40950,BONGO FEE 001H,2022-07-01,110,126,1313,162,88129,347655,530842
300154095000,30-015-40950,BONGO FEE 001H,2022-08-01,111,432,2929,2561,88561,350584,533403
300154095000,30-015-40950,BONGO FEE 001H,2022-09-01,112,410,2842,3998,88971,353426,537401
300154095000,30-015-40950,BONGO FEE 001H,2022-10-01,113,205,1794,1454,89176,355220,538855
300154095000,30-015-40950,BONGO FEE 001H,2022-11-01,114,282,2200,1562,89458,357420,540417
300154095000,30-015-40950,BONGO FEE 001H,2022-12-01,115,314,1964,1873,89772,359384,542290
300154095000,30-015-40950,BONGO FEE 001H,2023-01-01,116,446,2873,3759,90218,362257,546049
300154095000,30-015-40950,BONGO FEE 001H,2023-02-01,117,320,2102,3296,90538,364359,549345
300154095000,30-015-40950,BONGO FEE 001H,2023-03-01,118,331,2294,2470,90869,366653,551815
300154095000,30-015-40950,BONGO FEE 001H,2023-04-01,119,306,2146,2947,91175,368799,554762
300154095000,30-015-40950,BONGO FEE 001H,2023-05-01,120,259,2027,2417,91434,370826,557179
300154095000,30-015-40950,BONGO FEE 001H,2023-06-01,121,163,1635,1298,91597,372461,558477
300154095000,30-015-40950,BONGO FEE 001H,2023-07-01,122,364,2501,2748,91961,374962,561225
300152451300,30-015-24513,NEW MEXICO DM STATE 001,1983-11-01,1,576,288,2318,576,288,2318
300152451300,30-015-24513,NEW MEXICO DM STATE 001,1983-12-01,2,496,248,1996,1072,536,4314
300152451300,30-015-24513,NEW MEXICO DM STATE 001,1984-01-01,3,284,142,1143,1356,678,5457
300152451300,30-015-24513,NEW MEXICO DM STATE 001,1984-02-01,4,303,152,1220,1659,830,6677
300152451300,30-015-24513,NEW MEXICO DM STATE 001,1984-03-01,5,172,62,688,1831,892,7365
300152451300,30-015-24513,NEW MEXICO DM STATE 001,1984-04-01,6,237,86,948,2068,978,8313
300152451300,30-015-24513,NEW MEXICO DM STATE 001,1984-05-01,7,107,38,416,2175,1016,8729
300152451300,30-015-24513,NEW MEXICO DM STATE 001,1984-06-01,8,198,71,792,2373,1087,9521
300152451300,30-015-24513,NEW MEXICO DM STATE 001,1984-07-01,9,163,59,652,2536,1146,10173
300152451300,30-015-24513,NEW MEXICO DM STATE 001,1984-08-01,10,138,50,552,2674,1196,10725
300152451300,30-015-24513,NEW MEXICO DM STATE 001,1984-09-01,11,115,42,460,2789,1238,11185
300152451300,30-015-24513,NEW MEXICO DM STATE 001,1984-10-01,12,156,56,624,2945,1294,11809
300152451300,30-015-24513,NEW MEXICO DM STATE 001,1984-11-01,13,141,51,936,3086,1345,12745
300152451300,30-015-24513,NEW MEXICO DM STATE 001,1984-12-01,14,138,50,552,3224,1395,13297
300152451300,30-015-24513,NEW MEXICO DM STATE 001,1985-01-01,15,127,58,12,3351,1453,13309
300152451300,30-015-24513,NEW MEXICO DM STATE 001,1985-02-01,16,74,33,6,3425,1486,13315
300152451300,30-015-24513,NEW MEXICO DM STATE 001,1985-03-01,17,88,39,7,3513,1525,13322
300152451300,30-015-24513,NEW MEXICO DM STATE 001,1985-04-01,18,105,47,9,3618,1572,13331
300152451300,30-015-24513,NEW MEXICO DM STATE 001,1985-05-01,19,105,47,9,3723,1619,13340
300152451300,30-015-24513,NEW MEXICO DM STATE 001,1985-06-01,20,82,36,7,3805,1655,13347
300152451300,30-015-24513,NEW MEXICO DM STATE 001,1985-07-01,21,99,44,8,3904,1699,13355
300152451300,30-015-24513,NEW MEXICO DM STATE 001,1985-08-01,22,74,33,6,3978,1732,13361
300152451300,30-015-24513,NEW MEXICO DM STATE 001,1985-09-01,23,76,34,504,4054,1766,13865
300152451300,30-015-24513,NEW MEXICO DM STATE 001,1985-10-01,24,0,0,0,4054,1766,13865
300152451300,30-015-24513,NEW MEXICO DM STATE 001,1985-11-01,25,8,0,0,4062,1766,13865
300154275500,30-015-42755,HUMIDOR BML STATE COM 005H,2015-07-01,1,8425,15419,41440,8425,15419,41440
300154275500,30-015-42755,HUMIDOR BML STATE COM 005H,2015-08-01,2,11426,44255,42805,19851,59674,84245
300154275500,30-015-42755,HUMIDOR BML STATE COM 005H,2015-09-01,3,14571,29332,52149,34422,89006,136394
300154275500,30-015-42755,HUMIDOR BML STATE COM 005H,2015-10-01,4,12099,26107,38231,46521,115113,174625
300154275500,30-015-42755,HUMIDOR BML STATE COM 005H,2015-11-01,5,10938,25062,39714,57459,140175,214339
300154275500,30-015-42755,HUMIDOR BML STATE COM 005H,2015-12-01,6,9940,21524,37432,67399,161699,251771
300154275500,30-015-42755,HUMIDOR BML STATE COM 005H,2016-01-01,7,9928,17715,37403,77327,179414,289174
300154275500,30-015-42755,HUMIDOR BML STATE COM 005H,2016-02-01,8,6989,12441,21687,84316,191855,310861
300154275500,30-015-42755,HUMIDOR BML STATE COM 005H,2016-03-01,9,10263,18353,39931,94579,210208,350792
300154275500,30-015-42755,HUMIDOR BML STATE COM 005H,2016-04-01,10,6332,11419,23819,100911,221627,374611
300154275500,30-015-42755,HUMIDOR BML STATE COM 005H,2016-05-01,11,8962,16040,37785,109873,237667,412396
300154275500,30-015-42755,HUMIDOR BML STATE COM 005H,2016-06-01,12,7777,11696,32868,117650,249363,445264
300154275500,30-015-42755,HUMIDOR BML STATE COM 005H,2016-07-01,13,7412,14883,45539,125062,264246,490803
300154275500,30-015-42755,HUMIDOR BML STATE COM 005H,2016-08-01,14,6397,7362,32045,131459,271608,522848
300154275500,30-015-42755,HUMIDOR BML STATE COM 005H,2016-09-01,15,7012,15601,41380,138471,287209,564228
300154275500,30-015-42755,HUMIDOR BML STATE COM 005H,2016-10-01,16,6642,15023,37268,145113,302232,601496
300154275500,30-015-42755,HUMIDOR BML STATE COM 005H,2016-11-01,17,6166,12017,34371,151279,314249,635867
300154275500,30-015-42755,HUMIDOR BML STATE COM 005H,2016-12-01,18,6039,13062,33609,157318,327311,669476
300154275500,30-015-42755,HUMIDOR BML STATE COM 005H,2017-01-01,19,5728,11525,34085,163046,338836,703561
300154275500,30-015-42755,HUMIDOR BML STATE COM 005H,2017-02-01,20,5193,11906,30500,168239,350742,734061
300154275500,30-015-42755,HUMIDOR BML STATE COM 005H,2017-03-01,21,5087,11931,30793,173326,362673,764854
300154275500,30-015-42755,HUMIDOR BML STATE COM 005H,2017-04-01,22,4757,9498,30670,178083,372171,795524
300154275500,30-015-42755,HUMIDOR BML STATE COM 005H,2017-05-01,23,4630,9483,28244,182713,381654,823768
300154275500,30-015-42755,HUMIDOR BML STATE COM 005H,2017-06-01,24,4188,10132,26377,186901,391786,850145
300154275500,30-015-42755,HUMIDOR BML STATE COM 005H,2017-07-01,25,4351,13586,29635,191252,405372,879780
300154275500,30-015-42755,HUMIDOR BML STATE COM 005H,2017-08-01,26,4271,11931,22877,195523,417303,902657
300154275500,30-015-42755,HUMIDOR BML STATE COM 005H,2017-09-01,27,4081,11787,25970,199604,429090,928627
300154275500,30-015-42755,HUMIDOR BML STATE COM 005H,2017-10-01,28,6142,12014,25894,205746,441104,954521
300154275500,30-015-42755,HUMIDOR BML STATE COM 005H,2017-11-01,29,3882,11252,19467,209628,452356,973988
300154275500,30-015-42755,HUMIDOR BML STATE COM 005H,2017-12-01,30,4211,13332,25111,213839,465688,999099
300154275500,30-015-42755,HUMIDOR BML STATE COM 005H,2018-01-01,31,4020,12924,23844,217859,478612,1022943
300154275500,30-015-42755,HUMIDOR BML STATE COM 005H,2018-02-01,32,3180,10891,20337,221039,489503,1043280
300154275500,30-015-42755,HUMIDOR BML STATE COM 005H,2018-03-01,33,3678,11556,22490,224717,501059,1065770
300154275500,30-015-42755,HUMIDOR BML STATE COM 005H,2018-04-01,34,3521,11818,21785,228238,512877,1087555
300154275500,30-015-42755,HUMIDOR BML STATE COM 005H,2018-05-01,35,3534,12375,22096,231772,525252,1109651
300154275500,30-015-42755,HUMIDOR BML STATE COM 005H,2018-06-01,36,3272,11636,20419,235044,536888,1130070
300154275500,30-015-42755,HUMIDOR BML STATE COM 005H,2018-07-01,37,3284,11483,20533,238328,548371,1150603
300154275500,30-015-42755,HUMIDOR BML STATE COM 005H,2018-08-01,38,3248,11884,21044,241576,560255,1171647
300154275500,30-015-42755,HUMIDOR BML STATE COM 005H,2018-09-01,39,3157,11347,20439,244733,571602,1192086
300154275500,30-015-42755,HUMIDOR BML STATE COM 005H,2018-10-01,40,3158,11291,20796,247891,582893,1212882
300154275500,30-015-42755,HUMIDOR BML STATE COM 005H,2018-11-01,41,3166,9054,19216,251057,591947,1232098
300154275500,30-015-42755,HUMIDOR BML STATE COM 005H,2018-12-01,42,3188,8852,19508,254245,600799,1251606
300154275500,30-015-42755,HUMIDOR BML STATE COM 005H,2019-01-01,43,3146,8302,19418,257391,609101,1271024
300154275500,30-015-42755,HUMIDOR BML STATE COM 005H,2019-02-01,44,2760,7092,16819,260151,616193,1287843
300154275500,30-015-42755,HUMIDOR BML STATE COM 005H,2019-03-01,45,2994,7967,18721,263145,624160,1306564
300154275500,30-015-42755,HUMIDOR BML STATE COM 005H,2019-04-01,46,2775,7468,18748,265920,631628,1325312
300154275500,30-015-42755,HUMIDOR BML STATE COM 005H,2019-05-01,47,2779,8692,18058,268699,640320,1343370
300154275500,30-015-42755,HUMIDOR BML STATE COM 005H,2019-06-01,48,2758,8552,17419,271457,648872,1360789
300154275500,30-015-42755,HUMIDOR BML STATE COM 005H,2019-07-01,49,2794,9295,17400,274251,658167,1378189
300154275500,30-015-42755,HUMIDOR BML STATE COM 005H,2019-08-01,50,2731,8959,17698,276982,667126,1395887
300154275500,30-015-42755,HUMIDOR BML STATE COM 005H,2019-09-01,51,2664,8804,16929,279646,675930,1412816
300154275500,30-015-42755,HUMIDOR BML STATE COM 005H,2019-10-01,52,2676,8091,14677,282322,684021,1427493
300154275500,30-015-42755,HUMIDOR BML STATE COM 005H,2019-11-01,53,2724,8226,15400,285046,692247,1442893
300154275500,30-015-42755,HUMIDOR BML STATE COM 005H,2019-12-01,54,2667,8150,16154,287713,700397,1459047
300154275500,30-015-42755,HUMIDOR BML STATE COM 005H,2020-01-01,55,2524,6959,15526,290237,707356,1474573
300154275500,30-015-42755,HUMIDOR BML STATE COM 005H,2020-02-01,56,2902,6238,13476,293139,713594,1488049
300154275500,30-015-42755,HUMIDOR BML STATE COM 005H,2020-03-01,57,2558,7753,14911,295697,721347,1502960
300154275500,30-015-42755,HUMIDOR BML STATE COM 005H,2020-04-01,58,2188,6907,12600,297885,728254,1515560
300154275500,30-015-42755,HUMIDOR BML STATE COM 005H,2020-05-01,59,2121,5676,8414,300006,733930,1523974
300154275500,30-015-42755,HUMIDOR BML STATE COM 005H,2020-06-01,60,2303,6128,12422,302309,740058,1536396
300154275500,30-015-42755,HUMIDOR BML STATE COM 005H,2020-07-01,61,2067,6494,12749,304376,746552,1549145
300154275500,30-015-42755,HUMIDOR BML STATE COM 005H,2020-08-01,62,2314,7412,14886,306690,753964,1564031
300154275500,30-015-42755,HUMIDOR BML STATE COM 005H,2020-09-01,63,2005,6854,14041,308695,760818,1578072
300154275500,30-015-42755,HUMIDOR BML STATE COM 005H,2020-10-01,64,2173,7024,14534,310868,767842,1592606
300154275500,30-015-42755,HUMIDOR BML STATE COM 005H,2020-11-01,65,1983,6219,13195,312851,774061,1605801
300154275500,30-015-42755,HUMIDOR BML STATE COM 005H,2020-12-01,66,2132,6360,13756,314983,780421,1619557
300154275500,30-015-42755,HUMIDOR BML STATE COM 005H,2021-01-01,67,2115,6115,13990,317098,786536,1633547
300154275500,30-015-42755,HUMIDOR BML STATE COM 005H,2021-02-01,68,1563,4577,9853,318661,791113,1643400
300154275500,30-015-42755,HUMIDOR BML STATE COM 005H,2021-03-01,69,2005,6061,12761,320666,797174,1656161
300154275500,30-015-42755,HUMIDOR BML STATE COM 005H,2021-04-01,70,1996,5961,12666,322662,803135,1668827
300154275500,30-015-42755,HUMIDOR BML STATE COM 005H,2021-05-01,71,1960,6005,12756,324622,809140,1681583
300154275500,30-015-42755,HUMIDOR BML STATE COM 005H,2021-06-01,72,1939,5964,12720,326561,815104,1694303
300154275500,30-015-42755,HUMIDOR BML STATE COM 005H,2021-07-01,73,1996,5986,12182,328557,821090,1706485
300154275500,30-015-42755,HUMIDOR BML STATE COM 005H,2021-08-01,74,1939,5903,11907,330496,826993,1718392
300154275500,30-015-42755,HUMIDOR BML STATE COM 005H,2021-09-01,75,1864,5474,12482,332360,832467,1730874
300154275500,30-015-42755,HUMIDOR BML STATE COM 005H,2021-10-01,76,2042,6788,14451,334402,839255,1745325
300154275500,30-015-42755,HUMIDOR BML STATE COM 005H,2021-11-01,77,1878,6462,13149,336280,845717,1758474
300154275500,30-015-42755,HUMIDOR BML STATE COM 005H,2021-12-01,78,1901,6671,13478,338181,852388,1771952
300154275500,30-015-42755,HUMIDOR BML STATE COM 005H,2022-01-01,79,409,1312,2667,338590,853700,1774619
300154275500,30-015-42755,HUMIDOR BML STATE COM 005H,2022-02-01,80,2131,4702,5809,340721,858402,1780428
300154275500,30-015-42755,HUMIDOR BML STATE COM 005H,2022-03-01,81,1494,4275,7518,342215,862677,1787946
300154275500,30-015-42755,HUMIDOR BML STATE COM 005H,2022-04-01,82,1297,2651,3511,343512,865328,1791457
300154275500,30-015-42755,HUMIDOR BML STATE COM 005H,2022-05-01,83,1639,4012,5896,345151,869340,1797353
300154275500,30-015-42755,HUMIDOR BML STATE COM 005H,2022-06-01,84,928,1945,2570,346079,871285,1799923
300154275500,30-015-42755,HUMIDOR BML STATE COM 005H,2022-07-01,85,552,1301,1961,346631,872586,1801884
300154275500,30-015-42755,HUMIDOR BML STATE COM 005H,2022-08-01,86,665,1511,1621,347296,874097,1803505
300154275500,30-015-42755,HUMIDOR BML STATE COM 005H,2022-09-01,87,1178,2024,2375,348474,876121,1805880
300154275500,30-015-42755,HUMIDOR BML STATE COM 005H,2022-10-01,88,659,1718,1368,349133,877839,1807248
300154275500,30-015-42755,HUMIDOR BML STATE COM 005H,2022-11-01,89,542,1587,1349,349675,879426,1808597
300154275500,30-015-42755,HUMIDOR BML STATE COM 005H,2022-12-01,90,33,315,94,349708,879741,1808691
300154275500,30-015-42755,HUMIDOR BML STATE COM 005H,2023-01-01,91,1521,2676,2291,351229,882417,1810982
300154275500,30-015-42755,HUMIDOR BML STATE COM 005H,2023-02-01,92,876,1419,684,352105,883836,1811666
300154275500,30-015-42755,HUMIDOR BML STATE COM 005H,2023-03-01,93,999,1796,979,353104,885632,1812645
300154275500,30-015-42755,HUMIDOR BML STATE COM 005H,2023-04-01,94,0,0,0,353104,885632,1812645
300154275500,30-015-42755,HUMIDOR BML STATE COM 005H,2023-05-01,95,13040,25070,32713,366144,910702,1845358
300154275500,30-015-42755,HUMIDOR BML STATE COM 005H,2023-06-01,96,11283,20271,32014,377427,930973,1877372
300154275500,30-015-42755,HUMIDOR BML STATE COM 005H,2023-07-01,97,4268,6419,36062,381695,937392,1913434
300154319401,30-015-43194,RUSTLER BREAKS 12 24 27 204H,2017-03-01,1,7528,13943,83807,7528,13943,83807
300154319401,30-015-43194,RUSTLER BREAKS 12 24 27 204H,2017-04-01,2,25054,43714,96535,32582,57657,180342
300154319401,30-015-43194,RUSTLER BREAKS 12 24 27 204H,2017-05-01,3,17099,29161,55194,49681,86818,235536
300154319401,30-015-43194,RUSTLER BREAKS 12 24 27 204H,2017-06-01,4,17706,29029,56850,67387,115847,292386
300154319401,30-015-43194,RUSTLER BREAKS 12 24 27 204H,2017-07-01,5,15025,32263,54728,82412,148110,347114
300154319401,30-015-43194,RUSTLER BREAKS 12 24 27 204H,2017-08-01,6,12382,34173,49531,94794,182283,396645
300154319401,30-015-43194,RUSTLER BREAKS 12 24 27 204H,2017-09-01,7,10618,29219,43113,105412,211502,439758
300154319401,30-015-43194,RUSTLER BREAKS 12 24 27 204H,2017-10-01,8,9700,26726,38179,115112,238228,477937
300154319401,30-015-43194,RUSTLER BREAKS 12 24 27 204H,2017-11-01,9,8871,22425,32618,123983,260653,510555
300154319401,30-015-43194,RUSTLER BREAKS 12 24 27 204H,2017-12-01,10,8266,18994,31414,132249,279647,541969
300154319401,30-015-43194,RUSTLER BREAKS 12 24 27 204H,2018-01-01,11,7102,12774,26742,139351,292421,568711
300154319401,30-015-43194,RUSTLER BREAKS 12 24 27 204H,2018-02-01,12,5466,11983,25105,144817,304404,593816
300154319401,30-015-43194,RUSTLER BREAKS 12 24 27 204H,2018-03-01,13,6540,19406,26574,151357,323810,620390
300154319401,30-015-43194,RUSTLER BREAKS 12 24 27 204H,2018-04-01,14,6051,21886,21484,157408,345696,641874
300154319401,30-015-43194,RUSTLER BREAKS 12 24 27 204H,2018-05-01,15,5368,21724,23370,162776,367420,665244
300154319401,30-015-43194,RUSTLER BREAKS 12 24 27 204H,2018-06-01,16,0,0,0,162776,367420,665244
300154319401,30-015-43194,RUSTLER BREAKS 12 24 27 204H,2018-07-01,17,261,544,11683,163037,367964,676927
300154319401,30-015-43194,RUSTLER BREAKS 12 24 27 204H,2018-08-01,18,7946,13621,25938,170983,381585,702865
300154319401,30-015-43194,RUSTLER BREAKS 12 24 27 204H,2018-09-01,19,7024,14646,24593,178007,396231,727458
300154319401,30-015-43194,RUSTLER BREAKS 12 24 27 204H,2018-10-01,20,4440,9526,21461,182447,405757,748919
300154319401,30-015-43194,RUSTLER BREAKS 12 24 27 204H,2018-11-01,21,5874,6004,30367,188321,411761,779286
300154319401,30-015-43194,RUSTLER BREAKS 12 24 27 204H,2018-12-01,22,5822,8546,24145,194143,420307,803431
300154319401,30-015-43194,RUSTLER BREAKS 12 24 27 204H,2019-01-01,23,4002,6832,8730,198145,427139,812161
300154319401,30-015-43194,RUSTLER BREAKS 12 24 27 204H,2019-02-01,24,3682,7291,7052,201827,434430,819213
300154319401,30-015-43194,RUSTLER BREAKS 12 24 27 204H,2019-03-01,25,2779,5398,6417,204606,439828,825630
300154319401,30-015-43194,RUSTLER BREAKS 12 24 27 204H,2019-04-01,26,2732,6465,16782,207338,446293,842412
300154319401,30-015-43194,RUSTLER BREAKS 12 24 27 204H,2019-05-01,27,2846,10580,21472,210184,456873,863884
300154319401,30-015-43194,RUSTLER BREAKS 12 24 27 204H,2019-06-01,28,2200,7860,16684,212384,464733,880568
300154319401,30-015-43194,RUSTLER BREAKS 12 24 27 204H,2019-07-01,29,2433,7975,15477,214817,472708,896045
300154319401,30-015-43194,RUSTLER BREAKS 12 24 27 204H,2019-08-01,30,2554,10303,16193,217371,483011,912238
300154319401,30-015-43194,RUSTLER BREAKS 12 24 27 204H,2019-09-01,31,2395,9645,15241,219766,492656,927479
300154319401,30-015-43194,RUSTLER BREAKS 12 24 27 204H,2019-10-01,32,2332,9313,14236,222098,501969,941715
300154319401,30-015-43194,RUSTLER BREAKS 12 24 27 204H,2019-11-01,33,2290,10142,14723,224388,512111,956438
300154319401,30-015-43194,RUSTLER BREAKS 12 24 27 204H,2019-12-01,34,2191,9632,13202,226579,521743,969640
300154319401,30-015-43194,RUSTLER BREAKS 12 24 27 204H,2020-01-01,35,2299,10828,14253,228878,532571,983893
300154319401,30-015-43194,RUSTLER BREAKS 12 24 27 204H,2020-02-01,36,2239,8770,12609,231117,541341,996502
300154319401,30-015-43194,RUSTLER BREAKS 12 24 27 204H,2020-03-01,37,2584,9154,13237,233701,550495,1009739
300154319401,30-015-43194,RUSTLER BREAKS 12 24 27 204H,2020-04-01,38,2545,8515,11037,236246,559010,1020776
300154319401,30-015-43194,RUSTLER BREAKS 12 24 27 204H,2020-05-01,39,60,0,155,236306,559010,1020931
300154319401,30-015-43194,RUSTLER BREAKS 12 24 27 204H,2020-06-01,40,2566,8684,13358,238872,567694,1034289
300154319401,30-015-43194,RUSTLER BREAKS 12 24 27 204H,2020-07-01,41,2393,6952,10472,241265,574646,1044761
300154319401,30-015-43194,RUSTLER BREAKS 12 24 27 204H,2020-08-01,42,3790,8347,10361,245055,582993,1055122
300154319401,30-015-43194,RUSTLER BREAKS 12 24 27 204H,2020-09-01,43,2881,8020,10125,247936,591013,1065247
300154319401,30-015-43194,RUSTLER BREAKS 12 24 27 204H,2020-10-01,44,1982,9690,11795,249918,600703,1077042
300154319401,30-015-43194,RUSTLER BREAKS 12 24 27 204H,2020-11-01,45,1953,8898,9852,251871,609601,1086894
300154319401,30-015-43194,RUSTLER BREAKS 12 24 27 204H,2020-12-01,46,1811,9182,9721,253682,618783,1096615
300154319401,30-015-43194,RUSTLER BREAKS 12 24 27 204H,2021-01-01,47,1753,7775,8720,255435,626558,1105335
300154319401,30-015-43194,RUSTLER BREAKS 12 24 27 204H,2021-02-01,48,1759,6502,5779,257194,633060,1111114
300154319401,30-015-43194,RUSTLER BREAKS 12 24 27 204H,2021-03-01,49,2106,9188,8325,259300,642248,1119439
300154319401,30-015-43194,RUSTLER BREAKS 12 24 27 204H,2021-04-01,50,1933,8859,7629,261233,651107,1127068
300154319401,30-015-43194,RUSTLER BREAKS 12 24 27 204H,2021-05-01,51,1705,9782,8274,262938,660889,1135342
300154319401,30-015-43194,RUSTLER BREAKS 12 24 27 204H,2021-06-01,52,1523,9498,8506,264461,670387,1143848
300154319401,30-015-43194,RUSTLER BREAKS 12 24 27 204H,2021-07-01,53,1544,8801,8235,266005,679188,1152083
300154319401,30-015-43194,RUSTLER BREAKS 12 24 27 204H,2021-08-01,54,1447,7720,7254,267452,686908,1159337
300154319401,30-015-43194,RUSTLER BREAKS 12 24 27 204H,2021-09-01,55,1382,8486,7940,268834,695394,1167277
300154319401,30-015-43194,RUSTLER BREAKS 12 24 27 204H,2021-10-01,56,1305,7568,7270,270139,702962,1174547
300154319401,30-015-43194,RUSTLER BREAKS 12 24 27 204H,2021-11-01,57,1459,6731,7362,271598,709693,1181909
300154319401,30-015-43194,RUSTLER BREAKS 12 24 27 204H,2021-12-01,58,1161,6636,7149,272759,716329,1189058
300154319401,30-015-43194,RUSTLER BREAKS 12 24 27 204H,2022-01-01,59,1211,5805,7330,273970,722134,1196388
300154319401,30-015-43194,RUSTLER BREAKS 12 24 27 204H,2022-02-01,60,1085,4904,6803,275055,727038,1203191
300154319401,30-015-43194,RUSTLER BREAKS 12 24 27 204H,2022-03-01,61,1055,4098,5938,276110,731136,1209129
300154319401,30-015-43194,RUSTLER BREAKS 12 24 27 204H,2022-04-01,62,1171,5047,6499,277281,736183,1215628
300154319401,30-015-43194,RUSTLER BREAKS 12 24 27 204H,2022-05-01,63,1284,6853,8747,278565,743036,1224375
300154319401,30-015-43194,RUSTLER BREAKS 12 24 27 204H,2022-06-01,64,1083,5989,8021,279648,749025,1232396
300154319401,30-015-43194,RUSTLER BREAKS 12 24 27 204H,2022-07-01,65,926,5598,6091,280574,754623,1238487
300154319401,30-015-43194,RUSTLER BREAKS 12 24 27 204H,2022-08-01,66,798,5221,4882,281372,759844,1243369
300154319401,30-015-43194,RUSTLER BREAKS 12 24 27 204H,2022-09-01,67,761,4978,4642,282133,764822,1248011
300154319401,30-015-43194,RUSTLER BREAKS 12 24 27 204H,2022-10-01,68,732,4427,3948,282865,769249,1251959
300154319401,30-015-43194,RUSTLER BREAKS 12 24 27 204H,2022-11-01,69,1199,4680,4877,284064,773929,1256836
300154319401,30-015-43194,RUSTLER BREAKS 12 24 27 204H,2022-12-01,70,922,3585,5077,284986,777514,1261913
300154319401,30-015-43194,RUSTLER BREAKS 12 24 27 204H,2023-01-01,71,769,3838,2733,285755,781352,1264646
300154319401,30-015-43194,RUSTLER BREAKS 12 24 27 204H,2023-02-01,72,284,0,787,286039,781352,1265433
300154319401,30-015-43194,RUSTLER BREAKS 12 24 27 204H,2023-03-01,73,856,853,3026,286895,782205,1268459
300154319401,30-015-43194,RUSTLER BREAKS 12 24 27 204H,2023-04-01,74,1029,3817,4501,287924,786022,1272960
300154319401,30-015-43194,RUSTLER BREAKS 12 24 27 204H,2023-05-01,75,1013,3790,4796,288937,789812,1277756
300154319401,30-015-43194,RUSTLER BREAKS 12 24 27 204H,2023-06-01,76,876,3669,3848,289813,793481,1281604
300154395900,30-015-43959,BLACK RIVER 15 10 STATE COM X 004H,2017-04-01,1,8422,11456,100747,8422,11456,100747
300154395900,30-015-43959,BLACK RIVER 15 10 STATE COM X 004H,2017-05-01,2,8422,11456,100747,16844,22912,201494
300154395900,30-015-43959,BLACK RIVER 15 10 STATE COM X 004H,2017-06-01,3,32240,65314,110918,49084,88226,312412
300154395900,30-015-43959,BLACK RIVER 15 10 STATE COM X 004H,2017-07-01,4,29170,64453,104305,78254,152679,416717
300154395900,30-015-43959,BLACK RIVER 15 10 STATE COM X 004H,2017-08-01,5,27503,59755,75955,105757,212434,492672
300154395900,30-015-43959,BLACK RIVER 15 10 STATE COM X 004H,2017-09-01,6,22070,47582,80636,127827,260016,573308
300154395900,30-015-43959,BLACK RIVER 15 10 STATE COM X 004H,2017-10-01,7,20888,43547,63407,148715,303563,636715
300154395900,30-015-43959,BLACK RIVER 15 10 STATE COM X 004H,2017-11-01,8,19298,42107,67208,168013,345670,703923
300154395900,30-015-43959,BLACK RIVER 15 10 STATE COM X 004H,2017-12-01,9,19942,42761,67517,187955,388431,771440
300154395900,30-015-43959,BLACK RIVER 15 10 STATE COM X 004H,2018-01-01,10,7885,17713,77265,195840,406144,848705
300154395900,30-015-43959,BLACK RIVER 15 10 STATE COM X 004H,2018-02-01,11,914,1280,4268,196754,407424,852973
300154395900,30-015-43959,BLACK RIVER 15 10 STATE COM X 004H,2018-03-01,12,11950,29921,115380,208704,437345,968353
300154395900,30-015-43959,BLACK RIVER 15 10 STATE COM X 004H,2018-04-01,13,10715,22254,93683,219419,459599,1062036
300154395900,30-015-43959,BLACK RIVER 15 10 STATE COM X 004H,2018-05-01,14,13008,25833,88211,232427,485432,1150247
300154395900,30-015-43959,BLACK RIVER 15 10 STATE COM X 004H,2018-06-01,15,15860,32334,63397,248287,517766,1213644
300154395900,30-015-43959,BLACK RIVER 15 10 STATE COM X 004H,2018-07-01,16,13286,28356,57619,261573,546122,1271263
300154395900,30-015-43959,BLACK RIVER 15 10 STATE COM X 004H,2018-08-01,17,15165,34333,42003,276738,580455,1313266
300154395900,30-015-43959,BLACK RIVER 15 10 STATE COM X 004H,2018-09-01,18,7071,14567,24434,283809,595022,1337700
300154395900,30-015-43959,BLACK RIVER 15 10 STATE COM X 004H,2018-10-01,19,2266,2625,45126,286075,597647,1382826
300154395900,30-015-43959,BLACK RIVER 15 10 STATE COM X 004H,2018-11-01,20,1302,2212,12924,287377,599859,1395750
300154395900,30-015-43959,BLACK RIVER 15 10 STATE COM X 004H,2018-12-01,21,8966,22178,48874,296343,622037,1444624
300154395900,30-015-43959,BLACK RIVER 15 10 STATE COM X 004H,2019-01-01,22,13375,33711,60172,309718,655748,1504796
300154395900,30-015-43959,BLACK RIVER 15 10 STATE COM X 004H,2019-02-01,23,8422,21614,41987,318140,677362,1546783
300154395900,30-015-43959,BLACK RIVER 15 10 STATE COM X 004H,2019-03-01,24,6070,14936,26947,324210,692298,1573730
300154395900,30-015-43959,BLACK RIVER 15 10 STATE COM X 004H,2019-04-01,25,5815,15415,24989,330025,707713,1598719
300154395900,30-015-43959,BLACK RIVER 15 10 STATE COM X 004H,2019-05-01,26,9195,38085,66463,339220,745798,1665182
300154395900,30-015-43959,BLACK RIVER 15 10 STATE COM X 004H,2019-06-01,27,8314,37793,73292,347534,783591,1738474
300154395900,30-015-43959,BLACK RIVER 15 10 STATE COM X 004H,2019-07-01,28,7252,34667,61926,354786,818258,1800400
300154395900,30-015-43959,BLACK RIVER 15 10 STATE COM X 004H,2019-08-01,29,7136,40483,46566,361922,858741,1846966
300154395900,30-015-43959,BLACK RIVER 15 10 STATE COM X 004H,2019-09-01,30,6498,37526,47257,368420,896267,1894223
300154395900,30-015-43959,BLACK RIVER 15 10 STATE COM X 004H,2019-10-01,31,5350,28299,36581,373770,924566,1930804
300154395900,30-015-43959,BLACK RIVER 15 10 STATE COM X 004H,2019-11-01,32,4711,25960,30520,378481,950526,1961324
300154395900,30-015-43959,BLACK RIVER 15 10 STATE COM X 004H,2019-12-01,33,1771,3354,7586,380252,953880,1968910
300154395900,30-015-43959,BLACK RIVER 15 10 STATE COM X 004H,2020-01-01,34,3194,9898,16606,383446,963778,1985516
300154395900,30-015-43959,BLACK RIVER 15 10 STATE COM X 004H,2020-02-01,35,3759,11794,15164,387205,975572,2000680
300154395900,30-015-43959,BLACK RIVER 15 10 STATE COM X 004H,2020-03-01,36,5329,33940,30284,392534,1009512,2030964
300154395900,30-015-43959,BLACK RIVER 15 10 STATE COM X 004H,2020-04-01,37,3867,28189,31605,396401,1037701,2062569
300154395900,30-015-43959,BLACK RIVER 15 10 STATE COM X 004H,2020-05-01,38,4671,38956,41311,401072,1076657,2103880
300154395900,30-015-43959,BLACK RIVER 15 10 STATE COM X 004H,2020-06-01,39,3076,20041,21528,404148,1096698,2125408
300154395900,30-015-43959,BLACK RIVER 15 10 STATE COM X 004H,2020-07-01,40,1597,6476,7323,405745,1103174,2132731
300154395900,30-015-43959,BLACK RIVER 15 10 STATE COM X 004H,2020-08-01,41,2359,10716,13126,408104,1113890,2145857
300154395900,30-015-43959,BLACK RIVER 15 10 STATE COM X 004H,2020-09-01,42,3110,13041,25347,411214,1126931,2171204
300154395900,30-015-43959,BLACK RIVER 15 10 STATE COM X 004H,2020-10-01,43,5119,58297,63768,416333,1185228,2234972
300154395900,30-015-43959,BLACK RIVER 15 10 STATE COM X 004H,2020-11-01,44,4310,41845,44851,420643,1227073,2279823
300154395900,30-015-43959,BLACK RIVER 15 10 STATE COM X 004H,2020-12-01,45,3988,35450,36769,424631,1262523,2316592
300154395900,30-015-43959,BLACK RIVER 15 10 STATE COM X 004H,2021-01-01,46,4336,44124,48032,428967,1306647,2364624
300154395900,30-015-43959,BLACK RIVER 15 10 STATE COM X 004H,2021-02-01,47,3474,34123,37333,432441,1340770,2401957
300154395900,30-015-43959,BLACK RIVER 15 10 STATE COM X 004H,2021-03-01,48,4430,46801,50361,436871,1387571,2452318
300154395900,30-015-43959,BLACK RIVER 15 10 STATE COM X 004H,2021-04-01,49,3681,42132,44196,440552,1429703,2496514
300154395900,30-015-43959,BLACK RIVER 15 10 STATE COM X 004H,2021-05-01,50,3255,39106,42079,443807,1468809,2538593
300154395900,30-015-43959,BLACK RIVER 15 10 STATE COM X 004H,2021-06-01,51,3820,40173,46601,447627,1508982,2585194
300154395900,30-015-43959,BLACK RIVER 15 10 STATE COM X 004H,2021-07-01,52,3828,40407,48929,451455,1549389,2634123
300154395900,30-015-43959,BLACK RIVER 15 10 STATE COM X 004H,2021-08-01,53,3627,38052,46236,455082,1587441,2680359
300154395900,30-015-43959,BLACK RIVER 15 10 STATE COM X 004H,2021-09-01,54,3305,36204,40334,458387,1623645,2720693
300154395900,30-015-43959,BLACK RIVER 15 10 STATE COM X 004H,2021-10-01,55,3421,38604,39923,461808,1662249,2760616
300154395900,30-015-43959,BLACK RIVER 15 10 STATE COM X 004H,2021-11-01,56,3441,39148,32900,465249,1701397,2793516
300154395900,30-015-43959,BLACK RIVER 15 10 STATE COM X 004H,2021-12-01,57,3659,38330,34316,468908,1739727,2827832
300154395900,30-015-43959,BLACK RIVER 15 10 STATE COM X 004H,2022-01-01,58,3273,34851,31389,472181,1774578,2859221
300154395900,30-015-43959,BLACK RIVER 15 10 STATE COM X 004H,2022-02-01,59,4438,29578,29420,476619,1804156,2888641
300154395900,30-015-43959,BLACK RIVER 15 10 STATE COM X 004H,2022-03-01,60,3603,35468,39211,480222,1839624,2927852
300154395900,30-015-43959,BLACK RIVER 15 10 STATE COM X 004H,2022-04-01,61,3559,31451,36918,483781,1871075,2964770
300154395900,30-015-43959,BLACK RIVER 15 10 STATE COM X 004H,2022-05-01,62,3104,30993,38135,486885,1902068,3002905
300154395900,30-015-43959,BLACK RIVER 15 10 STATE COM X 004H,2022-06-01,63,2798,28935,35925,489683,1931003,3038830
300154395900,30-015-43959,BLACK RIVER 15 10 STATE COM X 004H,2022-07-01,64,2716,28019,35348,492399,1959022,3074178
300154395900,30-015-43959,BLACK RIVER 15 10 STATE COM X 004H,2022-08-01,65,2569,28660,35857,494968,1987682,3110035
300154395900,30-015-43959,BLACK RIVER 15 10 STATE COM X 004H,2022-09-01,66,2832,29054,35104,497800,2016736,3145139
300154395900,30-015-43959,BLACK RIVER 15 10 STATE COM X 004H,2022-10-01,67,2514,28163,34132,500314,2044899,3179271
300154395900,30-015-43959,BLACK RIVER 15 10 STATE COM X 004H,2022-11-01,68,2624,27117,32222,502938,2072016,3211493
300154395900,30-015-43959,BLACK RIVER 15 10 STATE COM X 004H,2022-12-01,69,2251,25952,29834,505189,2097968,3241327
300154395900,30-015-43959,BLACK RIVER 15 10 STATE COM X 004H,2023-01-01,70,3029,28162,34110,508218,2126130,3275437
300154395900,30-015-43959,BLACK RIVER 15 10 STATE COM X 004H,2023-02-01,71,2192,25132,29754,510410,2151262,3305191
300154395900,30-015-43959,BLACK RIVER 15 10 STATE COM X 004H,2023-03-01,72,2318,26779,32077,512728,2178041,3337268
300154395900,30-015-43959,BLACK RIVER 15 10 STATE COM X 004H,2023-04-01,73,2063,23950,27560,514791,2201991,3364828
300154395900,30-015-43959,BLACK RIVER 15 10 STATE COM X 004H,2023-05-01,74,2264,25233,29655,517055,2227224,3394483
300154395900,30-015-43959,BLACK RIVER 15 10 STATE COM X 004H,2023-06-01,75,1842,22510,24257,518897,2249734,3418740
300154445600,30-015-44456,BLACK RIVER 15 10 STATE COM X 007H,2018-07-01,1,16935,71652,109570,16935,71652,109570
300154445600,30-015-44456,BLACK RIVER 15 10 STATE COM X 007H,2018-08-01,2,16116,127952,96697,33051,199604,206267
300154445600,30-015-44456,BLACK RIVER 15 10 STATE COM X 007H,2018-09-01,3,10284,50955,53838,43335,250559,260105
300154445600,30-015-44456,BLACK RIVER 15 10 STATE COM X 007H,2018-10-01,4,9662,82030,53823,52997,332589,313928
300154445600,30-015-44456,BLACK RIVER 15 10 STATE COM X 007H,2018-11-01,5,6207,56139,33024,59204,388728,346952
300154445600,30-015-44456,BLACK RIVER 15 10 STATE COM X 007H,2018-12-01,6,5763,61781,32366,64967,450509,379318
300154445600,30-015-44456,BLACK RIVER 15 10 STATE COM X 007H,2019-01-01,7,5680,43308,29644,70647,493817,408962
300154445600,30-015-44456,BLACK RIVER 15 10 STATE COM X 007H,2019-02-01,8,5369,29562,33069,76016,523379,442031
300154445600,30-015-44456,BLACK RIVER 15 10 STATE COM X 007H,2019-03-01,9,4878,38522,29596,80894,561901,471627
300154445600,30-015-44456,BLACK RIVER 15 10 STATE COM X 007H,2019-04-01,10,4688,43695,29111,85582,605596,500738
300154445600,30-015-44456,BLACK RIVER 15 10 STATE COM X 007H,2019-05-01,11,4559,41616,27622,90141,647212,528360
300154445600,30-015-44456,BLACK RIVER 15 10 STATE COM X 007H,2019-06-01,12,4134,36210,25607,94275,683422,553967
300154445600,30-015-44456,BLACK RIVER 15 10 STATE COM X 007H,2019-07-01,13,4324,31886,25275,98599,715308,579242
300154445600,30-015-44456,BLACK RIVER 15 10 STATE COM X 007H,2019-08-01,14,4671,29418,22332,103270,744726,601574
300154445600,30-015-44456,BLACK RIVER 15 10 STATE COM X 007H,2019-09-01,15,4378,27668,20044,107648,772394,621618
300154445600,30-015-44456,BLACK RIVER 15 10 STATE COM X 007H,2019-10-01,16,3390,31158,22421,111038,803552,644039
300154445600,30-015-44456,BLACK RIVER 15 10 STATE COM X 007H,2019-11-01,17,3712,24202,19707,114750,827754,663746
300154445600,30-015-44456,BLACK RIVER 15 10 STATE COM X 007H,2019-12-01,18,3804,25611,17890,118554,853365,681636
300154445600,30-015-44456,BLACK RIVER 15 10 STATE COM X 007H,2020-01-01,19,3196,24608,19093,121750,877973,700729
300154445600,30-015-44456,BLACK RIVER 15 10 STATE COM X 007H,2020-02-01,20,2831,22291,14482,124581,900264,715211
300154445600,30-015-44456,BLACK RIVER 15 10 STATE COM X 007H,2020-03-01,21,3064,30384,19062,127645,930648,734273
300154445600,30-015-44456,BLACK RIVER 15 10 STATE COM X 007H,2020-04-01,22,3626,36541,15720,131271,967189,749993
300154445600,30-015-44456,BLACK RIVER 15 10 STATE COM X 007H,2020-05-01,23,2785,27802,17250,134056,994991,767243
300154445600,30-015-44456,BLACK RIVER 15 10 STATE COM X 007H,2020-06-01,24,2622,28149,16242,136678,1023140,783485
300154445600,30-015-44456,BLACK RIVER 15 10 STATE COM X 007H,2020-07-01,25,2281,23245,14736,138959,1046385,798221
300154445600,30-015-44456,BLACK RIVER 15 10 STATE COM X 007H,2020-08-01,26,2729,25023,16802,141688,1071408,815023
300154445600,30-015-44456,BLACK RIVER 15 10 STATE COM X 007H,2020-09-01,27,2263,23646,13927,143951,1095054,828950
300154445600,30-015-44456,BLACK RIVER 15 10 STATE COM X 007H,2020-10-01,28,2757,17628,11356,146708,1112682,840306
300154445600,30-015-44456,BLACK RIVER 15 10 STATE COM X 007H,2020-11-01,29,3840,20390,12715,150548,1133072,853021
300154445600,30-015-44456,BLACK RIVER 15 10 STATE COM X 007H,2020-12-01,30,1843,17648,13042,152391,1150720,866063
300154445600,30-015-44456,BLACK RIVER 15 10 STATE COM X 007H,2021-01-01,31,2194,17036,13683,154585,1167756,879746
300154445600,30-015-44456,BLACK RIVER 15 10 STATE COM X 007H,2021-02-01,32,1025,12971,10139,155610,1180727,889885
300154445600,30-015-44456,BLACK RIVER 15 10 STATE COM X 007H,2021-03-01,33,1985,16524,12530,157595,1197251,902415
300154445600,30-015-44456,BLACK RIVER 15 10 STATE COM X 007H,2021-04-01,34,2102,18009,14067,159697,1215260,916482
300154445600,30-015-44456,BLACK RIVER 15 10 STATE COM X 007H,2021-05-01,35,2139,21220,14270,161836,1236480,930752
300154445600,30-015-44456,BLACK RIVER 15 10 STATE COM X 007H,2021-06-01,36,1926,19048,12837,163762,1255528,943589
300154445600,30-015-44456,BLACK RIVER 15 10 STATE COM X 007H,2021-07-01,37,1991,19725,13400,165753,1275253,956989
300154445600,30-015-44456,BLACK RIVER 15 10 STATE COM X 007H,2021-08-01,38,1934,19294,13392,167687,1294547,970381
300154445600,30-015-44456,BLACK RIVER 15 10 STATE COM X 007H,2021-09-01,39,1531,15258,10432,169218,1309805,980813
300154445600,30-015-44456,BLACK RIVER 15 10 STATE COM X 007H,2021-10-01,40,1519,15202,10393,170737,1325007,991206
300154445600,30-015-44456,BLACK RIVER 15 10 STATE COM X 007H,2021-11-01,41,1600,18921,10920,172337,1343928,1002126
300154445600,30-015-44456,BLACK RIVER 15 10 STATE COM X 007H,2021-12-01,42,1518,17746,9455,173855,1361674,1011581
300154445600,30-015-44456,BLACK RIVER 15 10 STATE COM X 007H,2022-01-01,43,1426,15824,9227,175281,1377498,1020808
300154445600,30-015-44456,BLACK RIVER 15 10 STATE COM X 007H,2022-02-01,44,1278,16431,9047,176559,1393929,1029855
300154445600,30-015-44456,BLACK RIVER 15 10 STATE COM X 007H,2022-03-01,45,1442,18302,11421,178001,1412231,1041276
300154445600,30-015-44456,BLACK RIVER 15 10 STATE COM X 007H,2022-04-01,46,1551,19718,10365,179552,1431949,1051641
300154445600,30-015-44456,BLACK RIVER 15 10 STATE COM X 007H,2022-05-01,47,1454,18910,9822,181006,1450859,1061463
300154445600,30-015-44456,BLACK RIVER 15 10 STATE COM X 007H,2022-06-01,48,1530,18982,10401,182536,1469841,1071864
300154445600,30-015-44456,BLACK RIVER 15 10 STATE COM X 007H,2022-07-01,49,1459,18793,9888,183995,1488634,1081752
300154445600,30-015-44456,BLACK RIVER 15 10 STATE COM X 007H,2022-08-01,50,1486,18812,9789,185481,1507446,1091541
300154445600,30-015-44456,BLACK RIVER 15 10 STATE COM X 007H,2022-09-01,51,1346,17809,9461,186827,1525255,1101002
300154445600,30-015-44456,BLACK RIVER 15 10 STATE COM X 007H,2022-10-01,52,699,14373,7988,187526,1539628,1108990
300154445600,30-015-44456,BLACK RIVER 15 10 STATE COM X 007H,2022-11-01,53,1081,13912,10492,188607,1553540,1119482
300154445600,30-015-44456,BLACK RIVER 15 10 STATE COM X 007H,2022-12-01,54,1299,14643,11527,189906,1568183,1131009
300154445600,30-015-44456,BLACK RIVER 15 10 STATE COM X 007H,2023-01-01,55,1214,15236,11894,191120,1583419,1142903
300154445600,30-015-44456,BLACK RIVER 15 10 STATE COM X 007H,2023-02-01,56,1686,14411,8354,192806,1597830,1151257
300154445600,30-015-44456,BLACK RIVER 15 10 STATE COM X 007H,2023-03-01,57,885,14524,8043,193691,1612354,1159300
300154445600,30-015-44456,BLACK RIVER 15 10 STATE COM X 007H,2023-04-01,58,1159,14718,7957,194850,1627072,1167257
300154445600,30-015-44456,BLACK RIVER 15 10 STATE COM X 007H,2023-05-01,59,1220,15334,9451,196070,1642406,1176708
300154445600,30-015-44456,BLACK RIVER 15 10 STATE COM X 007H,2023-06-01,60,781,11203,5449,196851,1653609,1182157
300154202900,30-015-42029,KUDU FEE 001H,2014-06-01,1,1253,1136,75693,1253,1136,75693
300154202900,30-015-42029,KUDU FEE 001H,2014-07-01,2,8003,8800,55011,9256,9936,130704
300154202900,30-015-42029,KUDU FEE 001H,2014-08-01,3,7126,16403,80004,16382,26339,210708
300154202900,30-015-42029,KUDU FEE 001H,2014-09-01,4,5079,11476,49987,21461,37815,260695
300154202900,30-015-42029,KUDU FEE 001H,2014-10-01,5,4860,12772,74687,26321,50587,335382
300154202900,30-015-42029,KUDU FEE 001H,2014-11-01,6,4555,12161,71481,30876,62748,406863
300154202900,30-015-42029,KUDU FEE 001H,2014-12-01,7,4113,2982,80592,34989,65730,487455
300154202900,30-015-42029,KUDU FEE 001H,2015-01-01,8,1561,39,28287,36550,65769,515742
300154202900,30-015-42029,KUDU FEE 001H,2015-02-01,9,1957,244,28855,38507,66013,544597
300154202900,30-015-42029,KUDU FEE 001H,2015-03-01,10,2262,0,44228,40769,66013,588825
300154202900,30-015-42029,KUDU FEE 001H,2015-04-01,11,3355,2856,64966,44124,68869,653791
300154202900,30-015-42029,KUDU FEE 001H,2015-05-01,12,2230,596,48803,46354,69465,702594
300154202900,30-015-42029,KUDU FEE 001H,2015-06-01,13,2263,0,53975,48617,69465,756569
300154202900,30-015-42029,KUDU FEE 001H,2015-07-01,14,1550,1586,32386,50167,71051,788955
300154202900,30-015-42029,KUDU FEE 001H,2015-08-01,15,0,0,0,50167,71051,788955
300154202900,30-015-42029,KUDU FEE 001H,2015-09-01,16,0,0,0,50167,71051,788955
300154202900,30-015-42029,KUDU FEE 001H,2015-10-01,17,0,0,0,50167,71051,788955
300154202900,30-015-42029,KUDU FEE 001H,2015-11-01,18,0,0,0,50167,71051,788955
300154202900,30-015-42029,KUDU FEE 001H,2015-12-01,19,0,0,0,50167,71051,788955
300154202900,30-015-42029,KUDU FEE 001H,2016-01-01,20,0,0,0,50167,71051,788955
300154202900,30-015-42029,KUDU FEE 001H,2016-02-01,21,0,0,0,50167,71051,788955
300154202900,30-015-42029,KUDU FEE 001H,2016-03-01,22,0,0,0,50167,71051,788955
300154202900,30-015-42029,KUDU FEE 001H,2016-04-01,23,0,0,0,50167,71051,788955
300154202900,30-015-42029,KUDU FEE 001H,2016-05-01,24,94,0,0,50261,71051,788955
300154202900,30-015-42029,KUDU FEE 001H,2016-06-01,25,0,0,0,50261,71051,788955
300154202900,30-015-42029,KUDU FEE 001H,2016-07-01,26,0,0,0,50261,71051,788955
300154202900,30-015-42029,KUDU FEE 001H,2016-08-01,27,0,254,0,50261,71305,788955
300154626800,30-015-46268,WESTLOVING 11 12 W0BA FEDERAL COM 001H,2021-09-01,1,19090,37007,96368,19090,37007,96368
300154626800,30-015-46268,WESTLOVING 11 12 W0BA FEDERAL COM 001H,2021-10-01,2,30544,58556,97227,49634,95563,193595
300154626800,30-015-46268,WESTLOVING 11 12 W0BA FEDERAL COM 001H,2021-11-01,3,21779,46269,68140,71413,141832,261735
300154626800,30-015-46268,WESTLOVING 11 12 W0BA FEDERAL COM 001H,2021-12-01,4,17890,45805,62915,89303,187637,324650
300154626800,30-015-46268,WESTLOVING 11 12 W0BA FEDERAL COM 001H,2022-01-01,5,13926,34482,52797,103229,222119,377447
300154626800,30-015-46268,WESTLOVING 11 12 W0BA FEDERAL COM 001H,2022-02-01,6,10608,22830,43105,113837,244949,420552
300154626800,30-015-46268,WESTLOVING 11 12 W0BA FEDERAL COM 001H,2022-03-01,7,9895,30130,49656,123732,275079,470208
300154626800,30-015-46268,WESTLOVING 11 12 W0BA FEDERAL COM 001H,2022-04-01,8,8933,26261,43132,132665,301340,513340
300154626800,30-015-46268,WESTLOVING 11 12 W0BA FEDERAL COM 001H,2022-05-01,9,8077,22283,37556,140742,323623,550896
300154626800,30-015-46268,WESTLOVING 11 12 W0BA FEDERAL COM 001H,2022-06-01,10,6987,21748,38555,147729,345371,589451
300154626800,30-015-46268,WESTLOVING 11 12 W0BA FEDERAL COM 001H,2022-07-01,11,6757,23174,33495,154486,368545,622946
300154626800,30-015-46268,WESTLOVING 11 12 W0BA FEDERAL COM 001H,2022-08-01,12,6232,18418,31745,160718,386963,654691
300154626800,30-015-46268,WESTLOVING 11 12 W0BA FEDERAL COM 001H,2022-09-01,13,5594,16819,30720,166312,403782,685411
300154626800,30-015-46268,WESTLOVING 11 12 W0BA FEDERAL COM 001H,2022-10-01,14,5868,24882,31440,172180,428664,716851
300154626800,30-015-46268,WESTLOVING 11 12 W0BA FEDERAL COM 001H,2022-11-01,15,5639,23177,24037,177819,451841,740888
300154626800,30-015-46268,WESTLOVING 11 12 W0BA FEDERAL COM 001H,2022-12-01,16,4739,22656,22961,182558,474497,763849
300154626800,30-015-46268,WESTLOVING 11 12 W0BA FEDERAL COM 001H,2023-01-01,17,4389,21096,22430,186947,495593,786279
300154626800,30-015-46268,WESTLOVING 11 12 W0BA FEDERAL COM 001H,2023-02-01,18,4145,14032,20077,191092,509625,806356
300154626800,30-015-46268,WESTLOVING 11 12 W0BA FEDERAL COM 001H,2023-03-01,19,4196,16053,19977,195288,525678,826333
300154626800,30-015-46268,WESTLOVING 11 12 W0BA FEDERAL COM 001H,2023-04-01,20,4148,18111,18885,199436,543789,845218
300154626800,30-015-46268,WESTLOVING 11 12 W0BA FEDERAL COM 001H,2023-05-01,21,3610,13518,19518,203046,557307,864736
300154626800,30-015-46268,WESTLOVING 11 12 W0BA FEDERAL COM 001H,2023-06-01,22,3338,9765,19435,206384,567072,884171
300154626800,30-015-46268,WESTLOVING 11 12 W0BA FEDERAL COM 001H,2023-07-01,23,4203,9988,24132,210587,577060,908303
300150113900,30-015-01139,"ST JOHN MKE 10,917 001",1958-04-01,1,0,9270,0,0,9270,0
300150113900,30-015-01139,"ST JOHN MKE 10,917 001",1958-05-01,2,0,9579,0,0,18849,0
300150113900,30-015-01139,"ST JOHN MKE 10,917 001",1958-06-01,3,0,9152,0,0,28001,0
300150113900,30-015-01139,"ST JOHN MKE 10,917 001",1958-07-01,4,0,6179,0,0,34180,0
300150113900,30-015-01139,"ST JOHN MKE 10,917 001",1958-08-01,5,0,6237,0,0,40417,0
300150113900,30-015-01139,"ST JOHN MKE 10,917 001",1958-09-01,6,0,4158,0,0,44575,0
300150113900,30-015-01139,"ST JOHN MKE 10,917 001",1958-10-01,7,0,6973,0,0,51548,0
300150113900,30-015-01139,"ST JOHN MKE 10,917 001",1958-11-01,8,0,6815,0,0,58363,0
300150113900,30-015-01139,"ST JOHN MKE 10,917 001",1958-12-01,9,0,6971,0,0,65334,0
300150113900,30-015-01139,"ST JOHN MKE 10,917 001",1959-01-01,10,0,6839,0,0,72173,0
300150113900,30-015-01139,"ST JOHN MKE 10,917 001",1959-02-01,11,0,6371,0,0,78544,0
300154501900,30-015-45019,SOUTH LOVING 2 11 W0DE STATE COM 001H,2018-10-01,1,5445,9013,31035,5445,9013,31035
300154501900,30-015-45019,SOUTH LOVING 2 11 W0DE STATE COM 001H,2018-11-01,2,26816,46300,75115,32261,55313,106150
300154501900,30-015-45019,SOUTH LOVING 2 11 W0DE STATE COM 001H,2018-12-01,3,20010,35927,61156,52271,91240,167306
300154501900,30-015-45019,SOUTH LOVING 2 11 W0DE STATE COM 001H,2019-01-01,4,21483,42545,50960,73754,133785,218266
300154501900,30-015-45019,SOUTH LOVING 2 11 W0DE STATE COM 001H,2019-02-01,5,23286,42632,65383,97040,176417,283649
300154501900,30-015-45019,SOUTH LOVING 2 11 W0DE STATE COM 001H,2019-03-01,6,8854,16958,26746,105894,193375,310395
300154501900,30-015-45019,SOUTH LOVING 2 11 W0DE STATE COM 001H,2019-04-01,7,7785,10673,21256,113679,204048,331651
300154501900,30-015-45019,SOUTH LOVING 2 11 W0DE STATE COM 001H,2019-05-01,8,15189,25034,42895,128868,229082,374546
300154501900,30-015-45019,SOUTH LOVING 2 11 W0DE STATE COM 001H,2019-06-01,9,14970,29876,46895,143838,258958,421441
300154501900,30-015-45019,SOUTH LOVING 2 11 W0DE STATE COM 001H,2019-07-01,10,15771,36061,55712,159609,295019,477153
300154501900,30-015-45019,SOUTH LOVING 2 11 W0DE STATE COM 001H,2019-08-01,11,12697,33641,51181,172306,328660,528334
300154501900,30-015-45019,SOUTH LOVING 2 11 W0DE STATE COM 001H,2019-09-01,12,11600,32160,43539,183906,360820,571873
300154501900,30-015-45019,SOUTH LOVING 2 11 W0DE STATE COM 001H,2019-10-01,13,11227,22949,40563,195133,383769,612436
300154501900,30-015-45019,SOUTH LOVING 2 11 W0DE STATE COM 001H,2019-11-01,14,9602,21993,35052,204735,405762,647488
300154501900,30-015-45019,SOUTH LOVING 2 11 W0DE STATE COM 001H,2019-12-01,15,9355,20307,35485,214090,426069,682973
300154501900,30-015-45019,SOUTH LOVING 2 11 W0DE STATE COM 001H,2020-01-01,16,9394,18674,28030,223484,444743,711003
300154501900,30-015-45019,SOUTH LOVING 2 11 W0DE STATE COM 001H,2020-02-01,17,6111,23008,26044,229595,467751,737047
300154501900,30-015-45019,SOUTH LOVING 2 11 W0DE STATE COM 001H,2020-03-01,18,6780,21605,35551,236375,489356,772598
300154501900,30-015-45019,SOUTH LOVING 2 11 W0DE STATE COM 001H,2020-04-01,19,6596,21298,33201,242971,510654,805799
300154501900,30-015-45019,SOUTH LOVING 2 11 W0DE STATE COM 001H,2020-05-01,20,5509,13000,18558,248480,523654,824357
300154501900,30-015-45019,SOUTH LOVING 2 11 W0DE STATE COM 001H,2020-06-01,21,6208,16303,24529,254688,539957,848886
300154501900,30-015-45019,SOUTH LOVING 2 11 W0DE STATE COM 001H,2020-07-01,22,7440,18000,27231,262128,557957,876117
300154501900,30-015-45019,SOUTH LOVING 2 11 W0DE STATE COM 001H,2020-08-01,23,5179,17159,25756,267307,575116,901873
300154501900,30-015-45019,SOUTH LOVING 2 11 W0DE STATE COM 001H,2020-09-01,24,4209,17480,23839,271516,592596,925712
300154501900,30-015-45019,SOUTH LOVING 2 11 W0DE STATE COM 001H,2020-10-01,25,3770,13930,19821,275286,606526,945533
300154501900,30-015-45019,SOUTH LOVING 2 11 W0DE STATE COM 001H,2020-11-01,26,5109,17545,21947,280395,624071,967480
300154501900,30-015-45019,SOUTH LOVING 2 11 W0DE STATE COM 001H,2020-12-01,27,5005,18182,21333,285400,642253,988813
300154501900,30-015-45019,SOUTH LOVING 2 11 W0DE STATE COM 001H,2021-01-01,28,4734,16591,22626,290134,658844,1011439
300154501900,30-015-45019,SOUTH LOVING 2 11 W0DE STATE COM 001H,2021-02-01,29,2717,7172,11905,292851,666016,1023344
300154501900,30-015-45019,SOUTH LOVING 2 11 W0DE STATE COM 001H,2021-03-01,30,5120,13580,21090,297971,679596,1044434
300154501900,30-015-45019,SOUTH LOVING 2 11 W0DE STATE COM 001H,2021-04-01,31,4243,13247,19485,302214,692843,1063919
300154501900,30-015-45019,SOUTH LOVING 2 11 W0DE STATE COM 001H,2021-05-01,32,4519,16987,25528,306733,709830,1089447
300154501900,30-015-45019,SOUTH LOVING 2 11 W0DE STATE COM 001H,2021-06-01,33,3579,12822,17429,310312,722652,1106876
300154501900,30-015-45019,SOUTH LOVING 2 11 W0DE STATE COM 001H,2021-07-01,34,3971,15019,21485,314283,737671,1128361
300154501900,30-015-45019,SOUTH LOVING 2 11 W0DE STATE COM 001H,2021-08-01,35,3622,15066,22059,317905,752737,1150420
300154501900,30-015-45019,SOUTH LOVING 2 11 W0DE STATE COM 001H,2021-09-01,36,3579,15211,21107,321484,767948,1171527
300154501900,30-015-45019,SOUTH LOVING 2 11 W0DE STATE COM 001H,2021-10-01,37,3378,17305,20921,324862,785253,1192448
300154501900,30-015-45019,SOUTH LOVING 2 11 W0DE STATE COM 001H,2021-11-01,38,3014,14644,17266,327876,799897,1209714
300154501900,30-015-45019,SOUTH LOVING 2 11 W0DE STATE COM 001H,2021-12-01,39,3143,13817,16638,331019,813714,1226352
300154501900,30-015-45019,SOUTH LOVING 2 11 W0DE STATE COM 001H,2022-01-01,40,3428,13567,17046,334447,827281,1243398
300154501900,30-015-45019,SOUTH LOVING 2 11 W0DE STATE COM 001H,2022-02-01,41,2464,10044,11704,336911,837325,1255102
300154501900,30-015-45019,SOUTH LOVING 2 11 W0DE STATE COM 001H,2022-03-01,42,3713,14632,19652,340624,851957,1274754
300154501900,30-015-45019,SOUTH LOVING 2 11 W0DE STATE COM 001H,2022-04-01,43,3052,13442,17460,343676,865399,1292214
300154501900,30-015-45019,SOUTH LOVING 2 11 W0DE STATE COM 001H,2022-05-01,44,3182,15889,20368,346858,881288,1312582
300154501900,30-015-45019,SOUTH LOVING 2 11 W0DE STATE COM 001H,2022-06-01,45,2929,16344,19823,349787,897632,1332405
300154501900,30-015-45019,SOUTH LOVING 2 11 W0DE STATE COM 001H,2022-07-01,46,2786,17115,19825,352573,914747,1352230
300154501900,30-015-45019,SOUTH LOVING 2 11 W0DE STATE COM 001H,2022-08-01,47,2804,15037,18225,355377,929784,1370455
300154501900,30-015-45019,SOUTH LOVING 2 11 W0DE STATE COM 001H,2022-09-01,48,2283,14703,16415,357660,944487,1386870
300154501900,30-015-45019,SOUTH LOVING 2 11 W0DE STATE COM 001H,2022-10-01,49,2573,13340,19505,360233,957827,1406375
300154501900,30-015-45019,SOUTH LOVING 2 11 W0DE STATE COM 001H,2022-11-01,50,2434,23047,18399,362667,980874,1424774
300154501900,30-015-45019,SOUTH LOVING 2 11 W0DE STATE COM 001H,2022-12-01,51,2130,14673,17037,364797,995547,1441811
300154501900,30-015-45019,SOUTH LOVING 2 11 W0DE STATE COM 001H,2023-01-01,52,2516,14433,17969,367313,1009980,1459780
300154501900,30-015-45019,SOUTH LOVING 2 11 W0DE STATE COM 001H,2023-02-01,53,2041,13023,14771,369354,1023003,1474551
300154501900,30-015-45019,SOUTH LOVING 2 11 W0DE STATE COM 001H,2023-03-01,54,2314,14820,17292,371668,1037823,1491843
300154501900,30-015-45019,SOUTH LOVING 2 11 W0DE STATE COM 001H,2023-04-01,55,2303,13754,16385,373971,1051577,1508228
300154501900,30-015-45019,SOUTH LOVING 2 11 W0DE STATE COM 001H,2023-05-01,56,1964,10622,13702,375935,1062199,1521930
300154501900,30-015-45019,SOUTH LOVING 2 11 W0DE STATE COM 001H,2023-06-01,57,1478,9883,10158,377413,1072082,1532088
300154501900,30-015-45019,SOUTH LOVING 2 11 W0DE STATE COM 001H,2023-07-01,58,2017,13155,13691,379430,1085237,1545779
300154404201,30-015-44042,MAD RIVER 13 STATE COM 004H,2017-04-01,1,956,1462,7553,956,1462,7553
300154404201,30-015-44042,MAD RIVER 13 STATE COM 004H,2017-05-01,2,16469,33782,49283,17425,35244,56836
300154404201,30-015-44042,MAD RIVER 13 STATE COM 004H,2017-06-01,3,26778,50614,58900,44203,85858,115736
300154404201,30-015-44042,MAD RIVER 13 STATE COM 004H,2017-07-01,4,22200,42222,44202,66403,128080,159938
300154404201,30-015-44042,MAD RIVER 13 STATE COM 004H,2017-08-01,5,16546,30012,32031,82949,158092,191969
300154404201,30-015-44042,MAD RIVER 13 STATE COM 004H,2017-09-01,6,17456,30672,35650,100405,188764,227619
300154404201,30-015-44042,MAD RIVER 13 STATE COM 004H,2017-10-01,7,13663,24411,28263,114068,213175,255882
300154404201,30-015-44042,MAD RIVER 13 STATE COM 004H,2017-11-01,8,14067,29328,33841,128135,242503,289723
300154404201,30-015-44042,MAD RIVER 13 STATE COM 004H,2017-12-01,9,12616,28588,26801,140751,271091,316524
300154404201,30-015-44042,MAD RIVER 13 STATE COM 004H,2018-01-01,10,7258,15738,25054,148009,286829,341578
300154404201,30-015-44042,MAD RIVER 13 STATE COM 004H,2018-02-01,11,9621,16129,28623,157630,302958,370201
300154404201,30-015-44042,MAD RIVER 13 STATE COM 004H,2018-03-01,12,9546,33994,35998,167176,336952,406199
300154404201,30-015-44042,MAD RIVER 13 STATE COM 004H,2018-04-01,13,10053,37091,38728,177229,374043,444927
300154404201,30-015-44042,MAD RIVER 13 STATE COM 004H,2018-05-01,14,8223,30673,39269,185452,404716,484196
300154404201,30-015-44042,MAD RIVER 13 STATE COM 004H,2018-06-01,15,4851,18288,31739,190303,423004,515935
300154404201,30-015-44042,MAD RIVER 13 STATE COM 004H,2018-07-01,16,6386,9728,34104,196689,432732,550039
300154404201,30-015-44042,MAD RIVER 13 STATE COM 004H,2018-08-01,17,7113,12760,22973,203802,445492,573012
300154404201,30-015-44042,MAD RIVER 13 STATE COM 004H,2018-09-01,18,5380,10545,17757,209182,456037,590769
300154404201,30-015-44042,MAD RIVER 13 STATE COM 004H,2018-10-01,19,4044,10728,19978,213226,466765,610747
300154404201,30-015-44042,MAD RIVER 13 STATE COM 004H,2018-11-01,20,5177,10701,21115,218403,477466,631862
300154404201,30-015-44042,MAD RIVER 13 STATE COM 004H,2018-12-01,21,4221,19919,21221,222624,497385,653083
300154404201,30-015-44042,MAD RIVER 13 STATE COM 004H,2019-01-01,22,3951,19438,23191,226575,516823,676274
300154404201,30-015-44042,MAD RIVER 13 STATE COM 004H,2019-02-01,23,3282,14667,18005,229857,531490,694279
300154404201,30-015-44042,MAD RIVER 13 STATE COM 004H,2019-03-01,24,3496,15429,19038,233353,546919,713317
300154404201,30-015-44042,MAD RIVER 13 STATE COM 004H,2019-04-01,25,3154,16857,19149,236507,563776,732466
300154404201,30-015-44042,MAD RIVER 13 STATE COM 004H,2019-05-01,26,3116,17071,19350,239623,580847,751816
300154404201,30-015-44042,MAD RIVER 13 STATE COM 004H,2019-06-01,27,2914,14970,17467,242537,595817,769283
300154404201,30-015-44042,MAD RIVER 13 STATE COM 004H,2019-07-01,28,2862,16843,19906,245399,612660,789189
300154404201,30-015-44042,MAD RIVER 13 STATE COM 004H,2019-08-01,29,2595,13910,16985,247994,626570,806174
300154404201,30-015-44042,MAD RIVER 13 STATE COM 004H,2019-09-01,30,2904,18864,21255,250898,645434,827429
300154404201,30-015-44042,MAD RIVER 13 STATE COM 004H,2019-10-01,31,2764,19833,23669,253662,665267,851098
300154404201,30-015-44042,MAD RIVER 13 STATE COM 004H,2019-11-01,32,2652,16815,16314,256314,682082,867412
300154404201,30-015-44042,MAD RIVER 13 STATE COM 004H,2019-12-01,33,2630,16500,17376,258944,698582,884788
300154404201,30-015-44042,MAD RIVER 13 STATE COM 004H,2020-01-01,34,2283,10756,16385,261227,709338,901173
300154404201,30-015-44042,MAD RIVER 13 STATE COM 004H,2020-02-01,35,1997,12542,14686,263224,721880,915859
300154404201,30-015-44042,MAD RIVER 13 STATE COM 004H,2020-03-01,36,2443,17543,16458,265667,739423,932317
300154404201,30-015-44042,MAD RIVER 13 STATE COM 004H,2020-04-01,37,1751,9826,10220,267418,749249,942537
300154404201,30-015-44042,MAD RIVER 13 STATE COM 004H,2020-05-01,38,0,612,0,267418,749861,942537
300154404201,30-015-44042,MAD RIVER 13 STATE COM 004H,2020-06-01,39,3202,26481,16912,270620,776342,959449
300154404201,30-015-44042,MAD RIVER 13 STATE COM 004H,2020-07-01,40,2332,16344,14545,272952,792686,973994
300154404201,30-015-44042,MAD RIVER 13 STATE COM 004H,2020-08-01,41,2439,17044,16299,275391,809730,990293
300154404201,30-015-44042,MAD RIVER 13 STATE COM 004H,2020-09-01,42,2057,16351,14329,277448,826081,1004622
300154404201,30-015-44042,MAD RIVER 13 STATE COM 004H,2020-10-01,43,1952,17654,14366,279400,843735,1018988
300154404201,30-015-44042,MAD RIVER 13 STATE COM 004H,2020-11-01,44,1730,14249,12600,281130,857984,1031588
300154404201,30-015-44042,MAD RIVER 13 STATE COM 004H,2020-12-01,45,1979,17068,13659,283109,875052,1045247
300154404201,30-015-44042,MAD RIVER 13 STATE COM 004H,2021-01-01,46,2000,14700,10370,285109,889752,1055617
300154404201,30-015-44042,MAD RIVER 13 STATE COM 004H,2021-02-01,47,1511,12649,9311,286620,902401,1064928
300154404201,30-015-44042,MAD RIVER 13 STATE COM 004H,2021-03-01,48,1823,11269,9888,288443,913670,1074816
300154404201,30-015-44042,MAD RIVER 13 STATE COM 004H,2021-04-01,49,1771,6757,11685,290214,920427,1086501
300154404201,30-015-44042,MAD RIVER 13 STATE COM 004H,2021-05-01,50,1810,5876,11938,292024,926303,1098439
300154404201,30-015-44042,MAD RIVER 13 STATE COM 004H,2021-06-01,51,1720,5974,13707,293744,932277,1112146
300154404201,30-015-44042,MAD RIVER 13 STATE COM 004H,2021-07-01,52,1608,5198,10828,295352,937475,1122974
300154404201,30-015-44042,MAD RIVER 13 STATE COM 004H,2021-08-01,53,1685,4554,10654,297037,942029,1133628
300154404201,30-015-44042,MAD RIVER 13 STATE COM 004H,2021-09-01,54,1691,4139,11609,298728,946168,1145237
300154404201,30-015-44042,MAD RIVER 13 STATE COM 004H,2021-10-01,55,1632,5898,11700,300360,952066,1156937
300154404201,30-015-44042,MAD RIVER 13 STATE COM 004H,2021-11-01,56,1349,4247,9690,301709,956313,1166627
300154404201,30-015-44042,MAD RIVER 13 STATE COM 004H,2021-12-01,57,1418,6487,9833,303127,962800,1176460
300154404201,30-015-44042,MAD RIVER 13 STATE COM 004H,2022-01-01,58,1206,6909,6994,304333,969709,1183454
300154404201,30-015-44042,MAD RIVER 13 STATE COM 004H,2022-02-01,59,1314,13816,8769,305647,983525,1192223
300154404201,30-015-44042,MAD RIVER 13 STATE COM 004H,2022-03-01,60,1252,8870,8987,306899,992395,1201210
300154404201,30-015-44042,MAD RIVER 13 STATE COM 004H,2022-04-01,61,1185,10226,10016,308084,1002621,1211226
300154404201,30-015-44042,MAD RIVER 13 STATE COM 004H,2022-05-01,62,1298,9435,11247,309382,1012056,1222473
300154404201,30-015-44042,MAD RIVER 13 STATE COM 004H,2022-06-01,63,1229,6757,8817,310611,1018813,1231290
300154404201,30-015-44042,MAD RIVER 13 STATE COM 004H,2022-07-01,64,1362,8840,10358,311973,1027653,1241648
300154404201,30-015-44042,MAD RIVER 13 STATE COM 004H,2022-08-01,65,1118,8093,9441,313091,1035746,1251089
300154404201,30-015-44042,MAD RIVER 13 STATE COM 004H,2022-09-01,66,1060,5543,6556,314151,1041289,1257645
300154404201,30-015-44042,MAD RIVER 13 STATE COM 004H,2022-10-01,67,1019,2502,10154,315170,1043791,1267799
300154404201,30-015-44042,MAD RIVER 13 STATE COM 004H,2022-11-01,68,1347,11213,5310,316517,1055004,1273109
300154404201,30-015-44042,MAD RIVER 13 STATE COM 004H,2022-12-01,69,1532,9340,8383,318049,1064344,1281492
300154404201,30-015-44042,MAD RIVER 13 STATE COM 004H,2023-01-01,70,1553,7938,7482,319602,1072282,1288974
300154404201,30-015-44042,MAD RIVER 13 STATE COM 004H,2023-02-01,71,1230,7121,6037,320832,1079403,1295011
300154404201,30-015-44042,MAD RIVER 13 STATE COM 004H,2023-03-01,72,1321,7547,6869,322153,1086950,1301880
300154404201,30-015-44042,MAD RIVER 13 STATE COM 004H,2023-04-01,73,568,3910,1896,322721,1090860,1303776
300154404201,30-015-44042,MAD RIVER 13 STATE COM 004H,2023-05-01,74,1345,5916,4376,324066,1096776,1308152
300154404201,30-015-44042,MAD RIVER 13 STATE COM 004H,2023-06-01,75,1549,5966,3870,325615,1102742,1312022
300150111700,30-015-01117,STATE 001,1958-03-01,1,45,0,0,45,0,0
300150111700,30-015-01117,STATE 001,1958-04-01,2,40,0,0,85,0,0
300150111700,30-015-01117,STATE 001,1958-05-01,3,62,0,0,147,0,0
300150111700,30-015-01117,STATE 001,1958-06-01,4,35,0,0,182,0,0
300150111700,30-015-01117,STATE 001,1958-07-01,5,23,0,0,205,0,0
300150111700,30-015-01117,STATE 001,1958-08-01,6,7,0,0,212,0,0
300150111700,30-015-01117,STATE 001,1958-09-01,7,15,0,0,227,0,0
300150111700,30-015-01117,STATE 001,1958-10-01,8,10,0,0,237,0,0
300150111700,30-015-01117,STATE 001,1958-11-01,9,3,0,0,240,0,0
300150111700,30-015-01117,STATE 001,1958-12-01,10,3,0,0,243,0,0
300150111700,30-015-01117,STATE 001,1959-01-01,11,6,0,190,249,0,190
300150111700,30-015-01117,STATE 001,1959-02-01,12,8,0,257,257,0,447
300150111700,30-015-01117,STATE 001,1959-03-01,13,5,0,202,262,0,649
300150111700,30-015-01117,STATE 001,1959-04-01,14,5,0,149,267,0,798
300150111700,30-015-01117,STATE 001,1959-05-01,15,5,0,150,272,0,948
300150111700,30-015-01117,STATE 001,1959-06-01,16,3,0,145,275,0,1093
300150111700,30-015-01117,STATE 001,1959-07-01,17,4,0,284,279,0,1377
300150111700,30-015-01117,STATE 001,1959-08-01,18,2,0,139,281,0,1516
300153308400,30-015-33084,LOVING 1 STATE 004,2004-09-01,1,0,17647,0,0,17647,0
300153308400,30-015-33084,LOVING 1 STATE 004,2004-10-01,2,0,11223,0,0,28870,0
300153308400,30-015-33084,LOVING 1 STATE 004,2004-11-01,3,0,65,0,0,28935,0
300153308400,30-015-33084,LOVING 1 STATE 004,2004-12-01,4,0,330,0,0,29265,0
300153308400,30-015-33084,LOVING 1 STATE 004,2005-01-01,5,0,324,0,0,29589,0
300153308400,30-015-33084,LOVING 1 STATE 004,2005-02-01,6,0,3910,0,0,33499,0
300153308400,30-015-33084,LOVING 1 STATE 004,2005-03-01,7,0,3797,0,0,37296,0
300153308400,30-015-33084,LOVING 1 STATE 004,2005-04-01,8,0,2705,0,0,40001,0
300153308400,30-015-33084,LOVING 1 STATE 004,2005-05-01,9,0,1142,0,0,41143,0
300153308400,30-015-33084,LOVING 1 STATE 004,2005-06-01,10,0,1142,0,0,42285,0
300153308400,30-015-33084,LOVING 1 STATE 004,2005-07-01,11,0,985,0,0,43270,0
300153308400,30-015-33084,LOVING 1 STATE 004,2005-08-01,12,0,22498,0,0,65768,0
300153308400,30-015-33084,LOVING 1 STATE 004,2005-09-01,13,0,6614,0,0,72382,0
300153308400,30-015-33084,LOVING 1 STATE 004,2005-10-01,14,0,6078,18,0,78460,18
300153308400,30-015-33084,LOVING 1 STATE 004,2005-11-01,15,0,3499,0,0,81959,18
300153308400,30-015-33084,LOVING 1 STATE 004,2005-12-01,16,0,1099,0,0,83058,18
300153308400,30-015-33084,LOVING 1 STATE 004,2006-01-01,17,0,2809,102,0,85867,120
300153308400,30-015-33084,LOVING 1 STATE 004,2006-02-01,18,0,5636,3,0,91503,123
300153308400,30-015-33084,LOVING 1 STATE 004,2006-03-01,19,0,4303,0,0,95806,123
300153308400,30-015-33084,LOVING 1 STATE 004,2006-04-01,20,0,2982,0,0,98788,123
300153308400,30-015-33084,LOVING 1 STATE 004,2006-05-01,21,0,2262,0,0,101050,123
300153308400,30-015-33084,LOVING 1 STATE 004,2006-06-01,22,0,1744,0,0,102794,123
300153308400,30-015-33084,LOVING 1 STATE 004,2006-07-01,23,0,1215,34,0,104009,157
300153308400,30-015-33084,LOVING 1 STATE 004,2006-08-01,24,0,1139,12,0,105148,169
300153308400,30-015-33084,LOVING 1 STATE 004,2006-09-01,25,0,2972,4,0,108120,173
300153308400,30-015-33084,LOVING 1 STATE 004,2006-10-01,26,0,1626,0,0,109746,173
300153308400,30-015-33084,LOVING 1 STATE 004,2006-11-01,27,0,2192,0,0,111938,173
300153308400,30-015-33084,LOVING 1 STATE 004,2006-12-01,28,0,1738,0,0,113676,173
300153308400,30-015-33084,LOVING 1 STATE 004,2007-01-01,29,0,1621,16,0,115297,189
300153308400,30-015-33084,LOVING 1 STATE 004,2007-02-01,30,0,1624,30,0,116921,219
300153308400,30-015-33084,LOVING 1 STATE 004,2007-03-01,31,0,1732,0,0,118653,219
300153308400,30-015-33084,LOVING 1 STATE 004,2007-04-01,32,0,1549,0,0,120202,219
300153308400,30-015-33084,LOVING 1 STATE 004,2007-05-01,33,0,1526,0,0,121728,219
300153308400,30-015-33084,LOVING 1 STATE 004,2007-06-01,34,0,816,0,0,122544,219
300153308400,30-015-33084,LOVING 1 STATE 004,2007-07-01,35,0,1216,3,0,123760,222
300153308400,30-015-33084,LOVING 1 STATE 004,2007-08-01,36,0,1327,60,0,125087,282
300153308400,30-015-33084,LOVING 1 STATE 004,2007-09-01,37,0,1536,30,0,126623,312
300153308400,30-015-33084,LOVING 1 STATE 004,2007-10-01,38,0,1173,47,0,127796,359
300153308400,30-015-33084,LOVING 1 STATE 004,2007-11-01,39,0,1137,58,0,128933,417
300153308400,30-015-33084,LOVING 1 STATE 004,2007-12-01,40,0,1144,20,0,130077,437
300153308400,30-015-33084,LOVING 1 STATE 004,2008-01-01,41,0,863,2,0,130940,439
300153308400,30-015-33084,LOVING 1 STATE 004,2008-02-01,42,0,666,0,0,131606,439
300153308400,30-015-33084,LOVING 1 STATE 004,2008-03-01,43,0,685,0,0,132291,439
300153308400,30-015-33084,LOVING 1 STATE 004,2008-04-01,44,0,650,0,0,132941,439
300153308400,30-015-33084,LOVING 1 STATE 004,2008-05-01,45,0,764,0,0,133705,439
300153308400,30-015-33084,LOVING 1 STATE 004,2008-06-01,46,0,678,0,0,134383,439
300153308400,30-015-33084,LOVING 1 STATE 004,2008-07-01,47,0,695,0,0,135078,439
300153308400,30-015-33084,LOVING 1 STATE 004,2008-08-01,48,0,607,0,0,135685,439
300153308400,30-015-33084,LOVING 1 STATE 004,2008-09-01,49,0,1822,35,0,137507,474
300153308400,30-015-33084,LOVING 1 STATE 004,2008-10-01,50,0,1332,2,0,138839,476
300153308400,30-015-33084,LOVING 1 STATE 004,2008-11-01,51,0,1076,0,0,139915,476
300153308400,30-015-33084,LOVING 1 STATE 004,2008-12-01,52,0,960,6,0,140875,482
300153308400,30-015-33084,LOVING 1 STATE 004,2009-01-01,53,0,956,2,0,141831,484
300153308400,30-015-33084,LOVING 1 STATE 004,2009-02-01,54,0,883,0,0,142714,484
300153308400,30-015-33084,LOVING 1 STATE 004,2009-03-01,55,0,999,2,0,143713,486
300153308400,30-015-33084,LOVING 1 STATE 004,2009-04-01,56,0,845,4,0,144558,490
300153308400,30-015-33084,LOVING 1 STATE 004,2009-05-01,57,0,834,0,0,145392,490
300153308400,30-015-33084,LOVING 1 STATE 004,2009-06-01,58,0,720,0,0,146112,490
300153308400,30-015-33084,LOVING 1 STATE 004,2009-07-01,59,0,788,2,0,146900,492
300153308400,30-015-33084,LOVING 1 STATE 004,2009-08-01,60,0,983,4,0,147883,496
300153308400,30-015-33084,LOVING 1 STATE 004,2009-09-01,61,0,721,2,0,148604,498
300153308400,30-015-33084,LOVING 1 STATE 004,2009-10-01,62,0,655,4,0,149259,502
300153308400,30-015-33084,LOVING 1 STATE 004,2009-11-01,63,0,620,12,0,149879,514
300153308400,30-015-33084,LOVING 1 STATE 004,2009-12-01,64,0,824,8,0,150703,522
300153308400,30-015-33084,LOVING 1 STATE 004,2010-01-01,65,0,707,2,0,151410,524
300153308400,30-015-33084,LOVING 1 STATE 004,2010-02-01,66,0,572,0,0,151982,524
300153308400,30-015-33084,LOVING 1 STATE 004,2010-03-01,67,0,650,2,0,152632,526
300153308400,30-015-33084,LOVING 1 STATE 004,2010-04-01,68,0,642,0,0,153274,526
300153308400,30-015-33084,LOVING 1 STATE 004,2010-05-01,69,0,586,0,0,153860,526
300153308400,30-015-33084,LOVING 1 STATE 004,2010-06-01,70,0,546,0,0,154406,526
300153308400,30-015-33084,LOVING 1 STATE 004,2010-07-01,71,0,587,0,0,154993,526
300153308400,30-015-33084,LOVING 1 STATE 004,2010-08-01,72,0,532,0,0,155525,526
300153308400,30-015-33084,LOVING 1 STATE 004,2010-09-01,73,0,429,0,0,155954,526
300153308400,30-015-33084,LOVING 1 STATE 004,2010-10-01,74,0,391,0,0,156345,526
300153308400,30-015-33084,LOVING 1 STATE 004,2010-11-01,75,0,387,0,0,156732,526
300153308400,30-015-33084,LOVING 1 STATE 004,2010-12-01,76,0,382,0,0,157114,526
300153308400,30-015-33084,LOVING 1 STATE 004,2011-01-01,77,0,289,0,0,157403,526
300153308400,30-015-33084,LOVING 1 STATE 004,2011-02-01,78,0,351,0,0,157754,526
300153308400,30-015-33084,LOVING 1 STATE 004,2011-03-01,79,0,75,0,0,157829,526
300153308400,30-015-33084,LOVING 1 STATE 004,2011-04-01,80,0,43,0,0,157872,526
300153308400,30-015-33084,LOVING 1 STATE 004,2011-05-01,81,0,46,0,0,157918,526
300153308400,30-015-33084,LOVING 1 STATE 004,2011-06-01,82,0,128,0,0,158046,526
300153308400,30-015-33084,LOVING 1 STATE 004,2011-07-01,83,0,237,0,0,158283,526
300153308400,30-015-33084,LOVING 1 STATE 004,2011-08-01,84,0,221,0,0,158504,526
300153308400,30-015-33084,LOVING 1 STATE 004,2011-09-01,85,0,104,0,0,158608,526
300153308400,30-015-33084,LOVING 1 STATE 004,2011-10-01,86,0,162,0,0,158770,526
300153308400,30-015-33084,LOVING 1 STATE 004,2011-11-01,87,0,153,0,0,158923,526
300153308400,30-015-33084,LOVING 1 STATE 004,2011-12-01,88,0,94,0,0,159017,526
300153308400,30-015-33084,LOVING 1 STATE 004,2012-01-01,89,0,126,0,0,159143,526
300153308400,30-015-33084,LOVING 1 STATE 004,2012-02-01,90,0,36,0,0,159179,526
300153308400,30-015-33084,LOVING 1 STATE 004,2012-03-01,91,0,86,0,0,159265,526
300153308400,30-015-33084,LOVING 1 STATE 004,2012-04-01,92,0,140,0,0,159405,526
300153308400,30-015-33084,LOVING 1 STATE 004,2012-05-01,93,0,193,0,0,159598,526
300153308400,30-015-33084,LOVING 1 STATE 004,2012-06-01,94,0,213,0,0,159811,526
300153308400,30-015-33084,LOVING 1 STATE 004,2012-07-01,95,0,285,0,0,160096,526
300153308400,30-015-33084,LOVING 1 STATE 004,2012-08-01,96,0,268,0,0,160364,526
300153308400,30-015-33084,LOVING 1 STATE 004,2012-09-01,97,0,21,0,0,160385,526
300153308400,30-015-33084,LOVING 1 STATE 004,2012-10-01,98,0,0,0,0,160385,526
300153308400,30-015-33084,LOVING 1 STATE 004,2012-11-01,99,0,122,0,0,160507,526
300153308400,30-015-33084,LOVING 1 STATE 004,2012-12-01,100,0,131,0,0,160638,526
300153308400,30-015-33084,LOVING 1 STATE 004,2013-01-01,101,0,609,0,0,161247,526
300153308400,30-015-33084,LOVING 1 STATE 004,2013-02-01,102,0,881,0,0,162128,526
300153308400,30-015-33084,LOVING 1 STATE 004,2013-03-01,103,0,404,0,0,162532,526
300153308400,30-015-33084,LOVING 1 STATE 004,2013-04-01,104,0,345,0,0,162877,526
300153308400,30-015-33084,LOVING 1 STATE 004,2013-05-01,105,0,278,0,0,163155,526
300153308400,30-015-33084,LOVING 1 STATE 004,2013-06-01,106,0,145,0,0,163300,526
300153308400,30-015-33084,LOVING 1 STATE 004,2013-07-01,107,0,376,0,0,163676,526
300153308400,30-015-33084,LOVING 1 STATE 004,2013-08-01,108,0,330,0,0,164006,526
300153308400,30-015-33084,LOVING 1 STATE 004,2013-09-01,109,0,358,0,0,164364,526
300153308400,30-015-33084,LOVING 1 STATE 004,2013-10-01,110,0,268,0,0,164632,526
300153308400,30-015-33084,LOVING 1 STATE 004,2013-11-01,111,0,248,0,0,164880,526
300153308400,30-015-33084,LOVING 1 STATE 004,2013-12-01,112,0,339,0,0,165219,526
300153308400,30-015-33084,LOVING 1 STATE 004,2014-01-01,113,0,406,0,0,165625,526
300153308400,30-015-33084,LOVING 1 STATE 004,2014-02-01,114,0,290,0,0,165915,526
300153308400,30-015-33084,LOVING 1 STATE 004,2014-03-01,115,0,339,0,0,166254,526
300153308400,30-015-33084,LOVING 1 STATE 004,2014-04-01,116,0,317,0,0,166571,526
300153308400,30-015-33084,LOVING 1 STATE 004,2014-05-01,117,0,310,0,0,166881,526
300153308400,30-015-33084,LOVING 1 STATE 004,2014-06-01,118,0,281,0,0,167162,526
300153308400,30-015-33084,LOVING 1 STATE 004,2014-07-01,119,0,298,0,0,167460,526
300153308400,30-015-33084,LOVING 1 STATE 004,2014-08-01,120,0,101,0,0,167561,526
300153308400,30-015-33084,LOVING 1 STATE 004,2014-09-01,121,0,0,0,0,167561,526
300153308400,30-015-33084,LOVING 1 STATE 004,2014-10-01,122,0,0,0,0,167561,526
300153308400,30-015-33084,LOVING 1 STATE 004,2014-11-01,123,0,239,0,0,167800,526
300153308400,30-015-33084,LOVING 1 STATE 004,2014-12-01,124,0,235,0,0,168035,526
300153308400,30-015-33084,LOVING 1 STATE 004,2015-01-01,125,0,17,0,0,168052,526
300153308400,30-015-33084,LOVING 1 STATE 004,2015-02-01,126,0,0,0,0,168052,526
300153308400,30-015-33084,LOVING 1 STATE 004,2015-03-01,127,0,112,0,0,168164,526
300153308400,30-015-33084,LOVING 1 STATE 004,2015-04-01,128,0,341,0,0,168505,526
300153308400,30-015-33084,LOVING 1 STATE 004,2015-05-01,129,0,398,0,0,168903,526
300153308400,30-015-33084,LOVING 1 STATE 004,2015-06-01,130,0,232,0,0,169135,526
300153308400,30-015-33084,LOVING 1 STATE 004,2015-07-01,131,0,179,0,0,169314,526
300153308400,30-015-33084,LOVING 1 STATE 004,2015-08-01,132,0,154,0,0,169468,526
300153308400,30-015-33084,LOVING 1 STATE 004,2015-09-01,133,0,448,0,0,169916,526
300153308400,30-015-33084,LOVING 1 STATE 004,2015-10-01,134,0,337,0,0,170253,526
300153308400,30-015-33084,LOVING 1 STATE 004,2015-11-01,135,0,270,0,0,170523,526
300153308400,30-015-33084,LOVING 1 STATE 004,2015-12-01,136,0,35,0,0,170558,526
300153308400,30-015-33084,LOVING 1 STATE 004,2016-01-01,137,15,0,0,15,170558,526
300153308400,30-015-33084,LOVING 1 STATE 004,2016-02-01,138,8,73,0,23,170631,526
300153308400,30-015-33084,LOVING 1 STATE 004,2016-03-01,139,0,383,0,23,171014,526
300153308400,30-015-33084,LOVING 1 STATE 004,2016-04-01,140,0,412,0,23,171426,526
300153308400,30-015-33084,LOVING 1 STATE 004,2016-05-01,141,0,339,0,23,171765,526
300153308400,30-015-33084,LOVING 1 STATE 004,2016-06-01,142,0,0,0,23,171765,526
300153308400,30-015-33084,LOVING 1 STATE 004,2016-07-01,143,0,1,0,23,171766,526
300153308400,30-015-33084,LOVING 1 STATE 004,2016-08-01,144,0,430,0,23,172196,526
300153308400,30-015-33084,LOVING 1 STATE 004,2016-09-01,145,0,179,0,23,172375,526
300153308400,30-015-33084,LOVING 1 STATE 004,2016-10-01,146,0,69,0,23,172444,526
300153308400,30-015-33084,LOVING 1 STATE 004,2016-11-01,147,0,22,0,23,172466,526
300153308400,30-015-33084,LOVING 1 STATE 004,2016-12-01,148,0,107,0,23,172573,526
300153308400,30-015-33084,LOVING 1 STATE 004,2017-01-01,149,0,24,0,23,172597,526
300153308400,30-015-33084,LOVING 1 STATE 004,2017-02-01,150,0,50,0,23,172647,526
300153308400,30-015-33084,LOVING 1 STATE 004,2017-03-01,151,0,247,0,23,172894,526
300153308400,30-015-33084,LOVING 1 STATE 004,2017-04-01,152,0,114,0,23,173008,526
300153308400,30-015-33084,LOVING 1 STATE 004,2017-05-01,153,0,166,0,23,173174,526
300153308400,30-015-33084,LOVING 1 STATE 004,2017-06-01,154,0,192,0,23,173366,526
300153308400,30-015-33084,LOVING 1 STATE 004,2017-07-01,155,0,205,0,23,173571,526
300153308400,30-015-33084,LOVING 1 STATE 004,2017-08-01,156,0,122,0,23,173693,526
300153308400,30-015-33084,LOVING 1 STATE 004,2017-09-01,157,0,123,0,23,173816,526
300153308400,30-015-33084,LOVING 1 STATE 004,2017-10-01,158,0,133,0,23,173949,526
300153308400,30-015-33084,LOVING 1 STATE 004,2017-11-01,159,0,162,0,23,174111,526
300153308400,30-015-33084,LOVING 1 STATE 004,2017-12-01,160,0,112,0,23,174223,526
300153308400,30-015-33084,LOVING 1 STATE 004,2018-01-01,161,0,0,0,23,174223,526
300153308400,30-015-33084,LOVING 1 STATE 004,2018-02-01,162,0,110,0,23,174333,526
300153308400,30-015-33084,LOVING 1 STATE 004,2018-03-01,163,0,399,0,23,174732,526
300153308400,30-015-33084,LOVING 1 STATE 004,2018-04-01,164,0,27,0,23,174759,526
300153308400,30-015-33084,LOVING 1 STATE 004,2018-05-01,165,0,26,0,23,174785,526
300153308400,30-015-33084,LOVING 1 STATE 004,2018-06-01,166,0,0,0,23,174785,526
300153308400,30-015-33084,LOVING 1 STATE 004,2018-07-01,167,0,282,0,23,175067,526
300153308400,30-015-33084,LOVING 1 STATE 004,2018-08-01,168,0,235,0,23,175302,526
300153308400,30-015-33084,LOVING 1 STATE 004,2018-09-01,169,0,231,0,23,175533,526
300153308400,30-015-33084,LOVING 1 STATE 004,2018-10-01,170,0,223,0,23,175756,526
300153308400,30-015-33084,LOVING 1 STATE 004,2018-11-01,171,0,146,0,23,175902,526
300153308400,30-015-33084,LOVING 1 STATE 004,2018-12-01,172,0,27,0,23,175929,526
300153610801,30-015-36108,HABANERO 17 FEDERAL COM 001H,2012-04-01,1,1557,21478,1737,1557,21478,1737
300153610801,30-015-36108,HABANERO 17 FEDERAL COM 001H,2012-05-01,2,1075,22570,1774,2632,44048,3511
300153610801,30-015-36108,HABANERO 17 FEDERAL COM 001H,2012-06-01,3,1394,28207,3469,4026,72255,6980
300153610801,30-015-36108,HABANERO 17 FEDERAL COM 001H,2012-07-01,4,1319,26306,3620,5345,98561,10600
300153610801,30-015-36108,HABANERO 17 FEDERAL COM 001H,2012-08-01,5,1024,19477,2155,6369,118038,12755
300153610801,30-015-36108,HABANERO 17 FEDERAL COM 001H,2012-09-01,6,1242,21424,2842,7611,139462,15597
300153610801,30-015-36108,HABANERO 17 FEDERAL COM 001H,2012-10-01,7,547,16931,541,8158,156393,16138
300153610801,30-015-36108,HABANERO 17 FEDERAL COM 001H,2012-11-01,8,1043,10215,635,9201,166608,16773
300153610801,30-015-36108,HABANERO 17 FEDERAL COM 001H,2012-12-01,9,1141,15134,1621,10342,181742,18394
300153610801,30-015-36108,HABANERO 17 FEDERAL COM 001H,2013-01-01,10,934,14064,1351,11276,195806,19745
300153610801,30-015-36108,HABANERO 17 FEDERAL COM 001H,2013-02-01,11,1217,13283,1991,12493,209089,21736
300153610801,30-015-36108,HABANERO 17 FEDERAL COM 001H,2013-03-01,12,1145,17293,2314,13638,226382,24050
300153610801,30-015-36108,HABANERO 17 FEDERAL COM 001H,2013-04-01,13,1197,18555,2233,14835,244937,26283
300153610801,30-015-36108,HABANERO 17 FEDERAL COM 001H,2013-05-01,14,894,12092,1316,15729,257029,27599
300153610801,30-015-36108,HABANERO 17 FEDERAL COM 001H,2013-06-01,15,918,14680,1640,16647,271709,29239
300153610801,30-015-36108,HABANERO 17 FEDERAL COM 001H,2013-07-01,16,987,14230,1644,17634,285939,30883
300153610801,30-015-36108,HABANERO 17 FEDERAL COM 001H,2013-08-01,17,767,12386,1073,18401,298325,31956
300153610801,30-015-36108,HABANERO 17 FEDERAL COM 001H,2013-09-01,18,873,13679,1532,19274,312004,33488
300153610801,30-015-36108,HABANERO 17 FEDERAL COM 001H,2013-10-01,19,963,15221,1544,20237,327225,35032
300153610801,30-015-36108,HABANERO 17 FEDERAL COM 001H,2013-11-01,20,784,13461,1373,21021,340686,36405
300153610801,30-015-36108,HABANERO 17 FEDERAL COM 001H,2013-12-01,21,754,11238,1370,21775,351924,37775
300153610801,30-015-36108,HABANERO 17 FEDERAL COM 001H,2014-01-01,22,803,9312,1330,22578,361236,39105
300153610801,30-015-36108,HABANERO 17 FEDERAL COM 001H,2014-02-01,23,765,9935,1339,23343,371171,40444
300153610801,30-015-36108,HABANERO 17 FEDERAL COM 001H,2014-03-01,24,887,13842,1526,24230,385013,41970
300153610801,30-015-36108,HABANERO 17 FEDERAL COM 001H,2014-04-01,25,830,13298,1339,25060,398311,43309
300153610801,30-015-36108,HABANERO 17 FEDERAL COM 001H,2014-05-01,26,725,13257,1418,25785,411568,44727
300153610801,30-015-36108,HABANERO 17 FEDERAL COM 001H,2014-06-01,27,686,11176,1119,26471,422744,45846
300153610801,30-015-36108,HABANERO 17 FEDERAL COM 001H,2014-07-01,28,726,12967,1383,27197,435711,47229
300153610801,30-015-36108,HABANERO 17 FEDERAL COM 001H,2014-08-01,29,699,13054,1457,27896,448765,48686
300153610801,30-015-36108,HABANERO 17 FEDERAL COM 001H,2014-09-01,30,532,11349,973,28428,460114,49659
300153610801,30-015-36108,HABANERO 17 FEDERAL COM 001H,2014-10-01,31,666,10549,1124,29094,470663,50783
300153610801,30-015-36108,HABANERO 17 FEDERAL COM 001H,2014-11-01,32,626,10615,970,29720,481278,51753
300153610801,30-015-36108,HABANERO 17 FEDERAL COM 001H,2014-12-01,33,623,8333,988,30343,489611,52741
300153610801,30-015-36108,HABANERO 17 FEDERAL COM 001H,2015-01-01,34,567,7513,648,30910,497124,53389
300153610801,30-015-36108,HABANERO 17 FEDERAL COM 001H,2015-02-01,35,474,6153,568,31384,503277,53957
300153610801,30-015-36108,HABANERO 17 FEDERAL COM 001H,2015-03-01,36,693,8131,951,32077,511408,54908
300153610801,30-015-36108,HABANERO 17 FEDERAL COM 001H,2015-04-01,37,697,8669,904,32774,520077,55812
300153610801,30-015-36108,HABANERO 17 FEDERAL COM 001H,2015-05-01,38,573,10031,1151,33347,530108,56963
300153610801,30-015-36108,HABANERO 17 FEDERAL COM 001H,2015-06-01,39,610,9582,937,33957,539690,57900
300153610801,30-015-36108,HABANERO 17 FEDERAL COM 001H,2015-07-01,40,437,7372,725,34394,547062,58625
300153610801,30-015-36108,HABANERO 17 FEDERAL COM 001H,2015-08-01,41,471,6546,665,34865,553608,59290
300153610801,30-015-36108,HABANERO 17 FEDERAL COM 001H,2015-09-01,42,559,10386,1053,35424,563994,60343
300153610801,30-015-36108,HABANERO 17 FEDERAL COM 001H,2015-10-01,43,566,8034,809,35990,572028,61152
300153610801,30-015-36108,HABANERO 17 FEDERAL COM 001H,2015-11-01,44,276,4445,479,36266,576473,61631
300153610801,30-015-36108,HABANERO 17 FEDERAL COM 001H,2015-12-01,45,512,7204,730,36778,583677,62361
300153610801,30-015-36108,HABANERO 17 FEDERAL COM 001H,2016-01-01,46,337,6106,572,37115,589783,62933
300153610801,30-015-36108,HABANERO 17 FEDERAL COM 001H,2016-02-01,47,447,4848,435,37562,594631,63368
300153610801,30-015-36108,HABANERO 17 FEDERAL COM 001H,2016-03-01,48,463,6653,590,38025,601284,63958
300153610801,30-015-36108,HABANERO 17 FEDERAL COM 001H,2016-04-01,49,454,5859,657,38479,607143,64615
300153610801,30-015-36108,HABANERO 17 FEDERAL COM 001H,2016-05-01,50,385,5719,839,38864,612862,65454
300153610801,30-015-36108,HABANERO 17 FEDERAL COM 001H,2016-06-01,51,453,5514,608,39317,618376,66062
300153610801,30-015-36108,HABANERO 17 FEDERAL COM 001H,2016-07-01,52,108,2444,90,39425,620820,66152
300153610801,30-015-36108,HABANERO 17 FEDERAL COM 001H,2016-08-01,53,454,4405,548,39879,625225,66700
300153610801,30-015-36108,HABANERO 17 FEDERAL COM 001H,2016-09-01,54,848,9474,1330,40727,634699,68030
300153610801,30-015-36108,HABANERO 17 FEDERAL COM 001H,2016-10-01,55,334,4877,405,41061,639576,68435
300153610801,30-015-36108,HABANERO 17 FEDERAL COM 001H,2016-11-01,56,269,3286,331,41330,642862,68766
300153610801,30-015-36108,HABANERO 17 FEDERAL COM 001H,2016-12-01,57,589,7168,529,41919,650030,69295
300153610801,30-015-36108,HABANERO 17 FEDERAL COM 001H,2017-01-01,58,433,5249,565,42352,655279,69860
300153610801,30-015-36108,HABANERO 17 FEDERAL COM 001H,2017-02-01,59,482,6006,695,42834,661285,70555
300153610801,30-015-36108,HABANERO 17 FEDERAL COM 001H,2017-03-01,60,441,5419,501,43275,666704,71056
300153610801,30-015-36108,HABANERO 17 FEDERAL COM 001H,2017-04-01,61,753,8308,1390,44028,675012,72446
300153610801,30-015-36108,HABANERO 17 FEDERAL COM 001H,2017-05-01,62,382,4618,647,44410,679630,73093
300153610801,30-015-36108,HABANERO 17 FEDERAL COM 001H,2017-06-01,63,484,6263,624,44894,685893,73717
300153610801,30-015-36108,HABANERO 17 FEDERAL COM 001H,2017-07-01,64,201,3975,473,45095,689868,74190
300153610801,30-015-36108,HABANERO 17 FEDERAL COM 001H,2017-08-01,65,3,50,34,45098,689918,74224
300153610801,30-015-36108,HABANERO 17 FEDERAL COM 001H,2017-09-01,66,253,2989,0,45351,692907,74224
300153610801,30-015-36108,HABANERO 17 FEDERAL COM 001H,2017-10-01,67,266,2067,331,45617,694974,74555
300153610801,30-015-36108,HABANERO 17 FEDERAL COM 001H,2017-11-01,68,326,5684,277,45943,700658,74832
300153610801,30-015-36108,HABANERO 17 FEDERAL COM 001H,2017-12-01,69,0,205,0,45943,700863,74832
300153610801,30-015-36108,HABANERO 17 FEDERAL COM 001H,2018-01-01,70,48,1035,0,45991,701898,74832
300153610801,30-015-36108,HABANERO 17 FEDERAL COM 001H,2018-02-01,71,335,2021,11,46326,703919,74843
300153610801,30-015-36108,HABANERO 17 FEDERAL COM 001H,2018-03-01,72,126,1853,0,46452,705772,74843
300153610801,30-015-36108,HABANERO 17 FEDERAL COM 001H,2018-04-01,73,72,1246,126,46524,707018,74969
300153610801,30-015-36108,HABANERO 17 FEDERAL COM 001H,2018-05-01,74,67,274,20,46591,707292,74989
300153610801,30-015-36108,HABANERO 17 FEDERAL COM 001H,2018-06-01,75,6,251,6,46597,707543,74995
300153610801,30-015-36108,HABANERO 17 FEDERAL COM 001H,2018-07-01,76,0,2059,71,46597,709602,75066
300153610801,30-015-36108,HABANERO 17 FEDERAL COM 001H,2018-08-01,77,66,2427,0,46663,712029,75066
300153610801,30-015-36108,HABANERO 17 FEDERAL COM 001H,2018-09-01,78,0,0,480,46663,712029,75546
300153610801,30-015-36108,HABANERO 17 FEDERAL COM 001H,2018-10-01,79,0,29,0,46663,712058,75546
300153610801,30-015-36108,HABANERO 17 FEDERAL COM 001H,2018-11-01,80,0,23,0,46663,712081,75546
300153610801,30-015-36108,HABANERO 17 FEDERAL COM 001H,2018-12-01,81,0,4,0,46663,712085,75546
300153610801,30-015-36108,HABANERO 17 FEDERAL COM 001H,2019-01-01,82,359,2859,151,47022,714944,75697
300153610801,30-015-36108,HABANERO 17 FEDERAL COM 001H,2019-02-01,83,160,1136,0,47182,716080,75697
300153610801,30-015-36108,HABANERO 17 FEDERAL COM 001H,2019-03-01,84,0,31,0,47182,716111,75697
300153610801,30-015-36108,HABANERO 17 FEDERAL COM 001H,2019-04-01,85,0,101,13,47182,716212,75710
300153610801,30-015-36108,HABANERO 17 FEDERAL COM 001H,2019-05-01,86,8,198,7,47190,716410,75717
300153610801,30-015-36108,HABANERO 17 FEDERAL COM 001H,2019-06-01,87,9,30,7,47199,716440,75724
300153610801,30-015-36108,HABANERO 17 FEDERAL COM 001H,2019-07-01,88,14,11,6,47213,716451,75730
300153610801,30-015-36108,HABANERO 17 FEDERAL COM 001H,2019-08-01,89,31,16,1,47244,716467,75731
300153610801,30-015-36108,HABANERO 17 FEDERAL COM 001H,2019-09-01,90,136,1379,0,47380,717846,75731
300153610801,30-015-36108,HABANERO 17 FEDERAL COM 001H,2019-10-01,91,0,3,0,47380,717849,75731
300153610801,30-015-36108,HABANERO 17 FEDERAL COM 001H,2019-11-01,92,201,228,242,47581,718077,75973
300153610801,30-015-36108,HABANERO 17 FEDERAL COM 001H,2019-12-01,93,189,5601,0,47770,723678,75973
300153610801,30-015-36108,HABANERO 17 FEDERAL COM 001H,2020-01-01,94,132,1999,97,47902,725677,76070
300153610801,30-015-36108,HABANERO 17 FEDERAL COM 001H,2020-02-01,95,114,2932,0,48016,728609,76070
300153610801,30-015-36108,HABANERO 17 FEDERAL COM 001H,2020-03-01,96,192,2773,164,48208,731382,76234
300153610801,30-015-36108,HABANERO 17 FEDERAL COM 001H,2020-04-01,97,284,5305,43,48492,736687,76277
300153610801,30-015-36108,HABANERO 17 FEDERAL COM 001H,2020-05-01,98,146,2087,43,48638,738774,76320
300153610801,30-015-36108,HABANERO 17 FEDERAL COM 001H,2020-06-01,99,0,0,0,48638,738774,76320
300153610801,30-015-36108,HABANERO 17 FEDERAL COM 001H,2020-07-01,100,95,5321,0,48733,744095,76320
300153610801,30-015-36108,HABANERO 17 FEDERAL COM 001H,2020-08-01,101,279,3109,1,49012,747204,76321
300153610801,30-015-36108,HABANERO 17 FEDERAL COM 001H,2020-09-01,102,191,5984,16,49203,753188,76337
300153610801,30-015-36108,HABANERO 17 FEDERAL COM 001H,2020-10-01,103,130,1526,105,49333,754714,76442
300153610801,30-015-36108,HABANERO 17 FEDERAL COM 001H,2020-11-01,104,314,6213,0,49647,760927,76442
300153610801,30-015-36108,HABANERO 17 FEDERAL COM 001H,2020-12-01,105,174,3732,123,49821,764659,76565
300153610801,30-015-36108,HABANERO 17 FEDERAL COM 001H,2021-01-01,106,3,8,0,49824,764667,76565
300153610801,30-015-36108,HABANERO 17 FEDERAL COM 001H,2021-02-01,107,179,2003,20,50003,766670,76585
300153610801,30-015-36108,HABANERO 17 FEDERAL COM 001H,2021-03-01,108,172,2911,174,50175,769581,76759
300153610801,30-015-36108,HABANERO 17 FEDERAL COM 001H,2021-04-01,109,130,3239,259,50305,772820,77018
300153610801,30-015-36108,HABANERO 17 FEDERAL COM 001H,2021-05-01,110,210,4094,285,50515,776914,77303
300153610801,30-015-36108,HABANERO 17 FEDERAL COM 001H,2021-06-01,111,81,1745,136,50596,778659,77439
300153610801,30-015-36108,HABANERO 17 FEDERAL COM 001H,2021-07-01,112,166,2540,0,50762,781199,77439
300153610801,30-015-36108,HABANERO 17 FEDERAL COM 001H,2021-08-01,113,116,1440,18,50878,782639,77457
300153610801,30-015-36108,HABANERO 17 FEDERAL COM 001H,2021-09-01,114,108,1919,0,50986,784558,77457
300153610801,30-015-36108,HABANERO 17 FEDERAL COM 001H,2021-10-01,115,1,889,39,50987,785447,77496
300153610801,30-015-36108,HABANERO 17 FEDERAL COM 001H,2021-11-01,116,140,1947,0,51127,787394,77496
300153610801,30-015-36108,HABANERO 17 FEDERAL COM 001H,2021-12-01,117,154,2238,0,51281,789632,77496
300153610801,30-015-36108,HABANERO 17 FEDERAL COM 001H,2022-01-01,118,19,1779,78,51300,791411,77574
300153610801,30-015-36108,HABANERO 17 FEDERAL COM 001H,2022-02-01,119,14,0,1,51314,791411,77575
300153610801,30-015-36108,HABANERO 17 FEDERAL COM 001H,2022-03-01,120,21,6,0,51335,791417,77575
300153610801,30-015-36108,HABANERO 17 FEDERAL COM 001H,2022-04-01,121,13,5,0,51348,791422,77575
300153610801,30-015-36108,HABANERO 17 FEDERAL COM 001H,2022-05-01,122,5,1,0,51353,791423,77575
300153610801,30-015-36108,HABANERO 17 FEDERAL COM 001H,2022-06-01,123,0,396,3,51353,791819,77578
300153610801,30-015-36108,HABANERO 17 FEDERAL COM 001H,2022-07-01,124,81,938,29,51434,792757,77607
300153610801,30-015-36108,HABANERO 17 FEDERAL COM 001H,2022-08-01,125,7,0,0,51441,792757,77607
300153610801,30-015-36108,HABANERO 17 FEDERAL COM 001H,2022-09-01,126,11,1,0,51452,792758,77607
300153610801,30-015-36108,HABANERO 17 FEDERAL COM 001H,2022-10-01,127,0,6,0,51452,792764,77607
300153610801,30-015-36108,HABANERO 17 FEDERAL COM 001H,2022-11-01,128,14,252,9,51466,793016,77616
300153610801,30-015-36108,HABANERO 17 FEDERAL COM 001H,2022-12-01,129,12,391,13,51478,793407,77629
300153610801,30-015-36108,HABANERO 17 FEDERAL COM 001H,2023-01-01,130,196,2128,85,51674,795535,77714
300153610801,30-015-36108,HABANERO 17 FEDERAL COM 001H,2023-02-01,131,294,6972,349,51968,802507,78063
300153610801,30-015-36108,HABANERO 17 FEDERAL COM 001H,2023-03-01,132,59,1655,23,52027,804162,78086
300153610801,30-015-36108,HABANERO 17 FEDERAL COM 001H,2023-04-01,133,29,418,0,52056,804580,78086
300153610801,30-015-36108,HABANERO 17 FEDERAL COM 001H,2023-05-01,134,53,733,8,52109,805313,78094
300153610801,30-015-36108,HABANERO 17 FEDERAL COM 001H,2023-06-01,135,143,1752,57,52252,807065,78151
300153610801,30-015-36108,HABANERO 17 FEDERAL COM 001H,2023-07-01,136,41,1114,117,52293,808179,78268
300154448400,30-015-44484,EL PRESIDENTE STATE 24 27 2 TB 006H,2018-07-01,1,17471,36274,763,17471,36274,763
300154448400,30-015-44484,EL PRESIDENTE STATE 24 27 2 TB 006H,2018-08-01,2,11950,21966,46460,29421,58240,47223
300154448400,30-015-44484,EL PRESIDENTE STATE 24 27 2 TB 006H,2018-09-01,3,5670,20146,33732,35091,78386,80955
300154448400,30-015-44484,EL PRESIDENTE STATE 24 27 2 TB 006H,2018-10-01,4,5406,10421,34144,40497,88807,115099
300154448400,30-015-44484,EL PRESIDENTE STATE 24 27 2 TB 006H,2018-11-01,5,3468,7294,11566,43965,96101,126665
300154448400,30-015-44484,EL PRESIDENTE STATE 24 27 2 TB 006H,2018-12-01,6,4110,8588,18308,48075,104689,144973
300154448400,30-015-44484,EL PRESIDENTE STATE 24 27 2 TB 006H,2019-01-01,7,3716,2790,15402,51791,107479,160375
300154448400,30-015-44484,EL PRESIDENTE STATE 24 27 2 TB 006H,2019-02-01,8,1561,1996,11111,53352,109475,171486
300154448400,30-015-44484,EL PRESIDENTE STATE 24 27 2 TB 006H,2019-03-01,9,2778,6869,19962,56130,116344,191448
300154448400,30-015-44484,EL PRESIDENTE STATE 24 27 2 TB 006H,2019-04-01,10,2964,8889,19990,59094,125233,211438
300154448400,30-015-44484,EL PRESIDENTE STATE 24 27 2 TB 006H,2019-05-01,11,3338,7338,17729,62432,132571,229167
300154448400,30-015-44484,EL PRESIDENTE STATE 24 27 2 TB 006H,2019-06-01,12,2290,7661,15903,64722,140232,245070
300154448400,30-015-44484,EL PRESIDENTE STATE 24 27 2 TB 006H,2019-07-01,13,1618,4030,9897,66340,144262,254967
300154448400,30-015-44484,EL PRESIDENTE STATE 24 27 2 TB 006H,2019-08-01,14,2048,6947,12207,68388,151209,267174
300154448400,30-015-44484,EL PRESIDENTE STATE 24 27 2 TB 006H,2019-09-01,15,1036,2034,3928,69424,153243,271102
300154448400,30-015-44484,EL PRESIDENTE STATE 24 27 2 TB 006H,2019-10-01,16,1613,3159,7731,71037,156402,278833
300154448400,30-015-44484,EL PRESIDENTE STATE 24 27 2 TB 006H,2019-11-01,17,1588,3224,6858,72625,159626,285691
300154448400,30-015-44484,EL PRESIDENTE STATE 24 27 2 TB 006H,2019-12-01,18,2102,4114,7714,74727,163740,293405
300154448400,30-015-44484,EL PRESIDENTE STATE 24 27 2 TB 006H,2020-01-01,19,1833,4849,9727,76560,168589,303132
300154448400,30-015-44484,EL PRESIDENTE STATE 24 27 2 TB 006H,2020-02-01,20,1646,4413,8571,78206,173002,311703
300154448400,30-015-44484,EL PRESIDENTE STATE 24 27 2 TB 006H,2020-03-01,21,1736,5914,10594,79942,178916,322297
300154448400,30-015-44484,EL PRESIDENTE STATE 24 27 2 TB 006H,2020-04-01,22,1755,6815,11215,81697,185731,333512
300154448400,30-015-44484,EL PRESIDENTE STATE 24 27 2 TB 006H,2020-05-01,23,1812,4970,8844,83509,190701,342356
300154448400,30-015-44484,EL PRESIDENTE STATE 24 27 2 TB 006H,2020-06-01,24,1516,2818,7179,85025,193519,349535
300154448400,30-015-44484,EL PRESIDENTE STATE 24 27 2 TB 006H,2020-07-01,25,1562,3371,7567,86587,196890,357102
300154448400,30-015-44484,EL PRESIDENTE STATE 24 27 2 TB 006H,2020-08-01,26,1210,2970,6478,87797,199860,363580
300154448400,30-015-44484,EL PRESIDENTE STATE 24 27 2 TB 006H,2020-09-01,27,1969,4813,7753,89766,204673,371333
300154448400,30-015-44484,EL PRESIDENTE STATE 24 27 2 TB 006H,2020-10-01,28,1680,6129,9714,91446,210802,381047
300154448400,30-015-44484,EL PRESIDENTE STATE 24 27 2 TB 006H,2020-11-01,29,99,235,479,91545,211037,381526
300154448400,30-015-44484,EL PRESIDENTE STATE 24 27 2 TB 006H,2020-12-01,30,658,2640,4505,92203,213677,386031
300154448400,30-015-44484,EL PRESIDENTE STATE 24 27 2 TB 006H,2021-01-01,31,794,1877,5122,92997,215554,391153
300154448400,30-015-44484,EL PRESIDENTE STATE 24 27 2 TB 006H,2021-02-01,32,463,2187,5176,93460,217741,396329
300154448400,30-015-44484,EL PRESIDENTE STATE 24 27 2 TB 006H,2021-03-01,33,1000,3439,7000,94460,221180,403329
300154448400,30-015-44484,EL PRESIDENTE STATE 24 27 2 TB 006H,2021-04-01,34,907,3690,7840,95367,224870,411169
300154448400,30-015-44484,EL PRESIDENTE STATE 24 27 2 TB 006H,2021-05-01,35,581,1838,3476,95948,226708,414645
300154448400,30-015-44484,EL PRESIDENTE STATE 24 27 2 TB 006H,2021-06-01,36,606,2126,0,96554,228834,414645
300154448400,30-015-44484,EL PRESIDENTE STATE 24 27 2 TB 006H,2021-07-01,37,593,2948,3369,97147,231782,418014
300154448400,30-015-44484,EL PRESIDENTE STATE 24 27 2 TB 006H,2021-08-01,38,762,3021,8248,97909,234803,426262
300154448400,30-015-44484,EL PRESIDENTE STATE 24 27 2 TB 006H,2021-09-01,39,3611,6739,7418,101520,241542,433680
300154448400,30-015-44484,EL PRESIDENTE STATE 24 27 2 TB 006H,2021-10-01,40,1062,3066,8161,102582,244608,441841
300154448400,30-015-44484,EL PRESIDENTE STATE 24 27 2 TB 006H,2021-11-01,41,881,2634,6173,103463,247242,448014
300154448400,30-015-44484,EL PRESIDENTE STATE 24 27 2 TB 006H,2021-12-01,42,647,2342,5199,104110,249584,453213
300154448400,30-015-44484,EL PRESIDENTE STATE 24 27 2 TB 006H,2022-01-01,43,49,153,1,104159,249737,453214
300154448400,30-015-44484,EL PRESIDENTE STATE 24 27 2 TB 006H,2022-02-01,44,381,1636,708,104540,251373,453922
300154448400,30-015-44484,EL PRESIDENTE STATE 24 27 2 TB 006H,2022-03-01,45,152,1564,1078,104692,252937,455000
300154448400,30-015-44484,EL PRESIDENTE STATE 24 27 2 TB 006H,2022-04-01,46,71,170,51,104763,253107,455051
300154448400,30-015-44484,EL PRESIDENTE STATE 24 27 2 TB 006H,2022-05-01,47,10,180,0,104773,253287,455051
300154448400,30-015-44484,EL PRESIDENTE STATE 24 27 2 TB 006H,2022-06-01,48,8,143,0,104781,253430,455051
300154448400,30-015-44484,EL PRESIDENTE STATE 24 27 2 TB 006H,2022-07-01,49,5,119,0,104786,253549,455051
300154448400,30-015-44484,EL PRESIDENTE STATE 24 27 2 TB 006H,2022-08-01,50,6,130,0,104792,253679,455051
300154448400,30-015-44484,EL PRESIDENTE STATE 24 27 2 TB 006H,2022-09-01,51,5,81,0,104797,253760,455051
300154448400,30-015-44484,EL PRESIDENTE STATE 24 27 2 TB 006H,2022-10-01,52,513,990,4104,105310,254750,459155
300154448400,30-015-44484,EL PRESIDENTE STATE 24 27 2 TB 006H,2022-11-01,53,583,1296,5378,105893,256046,464533
300154448400,30-015-44484,EL PRESIDENTE STATE 24 27 2 TB 006H,2022-12-01,54,529,1803,6174,106422,257849,470707
300154448400,30-015-44484,EL PRESIDENTE STATE 24 27 2 TB 006H,2023-01-01,55,572,1791,5328,106994,259640,476035
300154448400,30-015-44484,EL PRESIDENTE STATE 24 27 2 TB 006H,2023-02-01,56,688,2536,5005,107682,262176,481040
300154448400,30-015-44484,EL PRESIDENTE STATE 24 27 2 TB 006H,2023-03-01,57,715,2860,5941,108397,265036,486981
300154448400,30-015-44484,EL PRESIDENTE STATE 24 27 2 TB 006H,2023-04-01,58,533,2336,5665,108930,267372,492646
300154448400,30-015-44484,EL PRESIDENTE STATE 24 27 2 TB 006H,2023-05-01,59,456,2172,4839,109386,269544,497485
300154448400,30-015-44484,EL PRESIDENTE STATE 24 27 2 TB 006H,2023-06-01,60,474,2428,5698,109860,271972,503183
300152417600,30-015-24176,STATE MS GAS COM 001,1984-03-01,1,44,43769,940,44,43769,940
300152417600,30-015-24176,STATE MS GAS COM 001,1984-04-01,2,28,97974,1960,72,141743,2900
300152417600,30-015-24176,STATE MS GAS COM 001,1984-05-01,3,24,5188,1800,96,146931,4700
300152417600,30-015-24176,STATE MS GAS COM 001,1984-06-01,4,15,90917,396,111,237848,5096
300152417600,30-015-24176,STATE MS GAS COM 001,1984-07-01,5,0,372,81,111,238220,5177
300152417600,30-015-24176,STATE MS GAS COM 001,1984-08-01,6,5,0,61,116,238220,5238
300152417600,30-015-24176,STATE MS GAS COM 001,1984-09-01,7,0,19319,96,116,257539,5334
300152417600,30-015-24176,STATE MS GAS COM 001,1984-10-01,8,32,40451,66,148,297990,5400
300152417600,30-015-24176,STATE MS GAS COM 001,1984-11-01,9,1,22950,78,149,320940,5478
300152417600,30-015-24176,STATE MS GAS COM 001,1984-12-01,10,14,45364,64,163,366304,5542
300152417600,30-015-24176,STATE MS GAS COM 001,1985-01-01,11,2,36459,58,165,402763,5600
300152417600,30-015-24176,STATE MS GAS COM 001,1985-02-01,12,16,37146,61,181,439909,5661
300152417600,30-015-24176,STATE MS GAS COM 001,1985-03-01,13,9,30630,44,190,470539,5705
300152417600,30-015-24176,STATE MS GAS COM 001,1985-04-01,14,5,22460,30,195,492999,5735
300152417600,30-015-24176,STATE MS GAS COM 001,1985-05-01,15,66,31254,60,261,524253,5795
300152417600,30-015-24176,STATE MS GAS COM 001,1985-06-01,16,16,45960,0,277,570213,5795
300152417600,30-015-24176,STATE MS GAS COM 001,1985-07-01,17,0,40253,30,277,610466,5825
300152417600,30-015-24176,STATE MS GAS COM 001,1985-08-01,18,0,38694,14,277,649160,5839
300152417600,30-015-24176,STATE MS GAS COM 001,1985-09-01,19,0,17247,17,277,666407,5856
300152417600,30-015-24176,STATE MS GAS COM 001,1985-10-01,20,0,18405,0,277,684812,5856
300152417600,30-015-24176,STATE MS GAS COM 001,1985-11-01,21,0,17795,42,277,702607,5898
300152417600,30-015-24176,STATE MS GAS COM 001,1985-12-01,22,0,27832,0,277,730439,5898
300152417600,30-015-24176,STATE MS GAS COM 001,1986-01-01,23,10,20397,186,287,750836,6084
300152417600,30-015-24176,STATE MS GAS COM 001,1986-02-01,24,16,35576,55,303,786412,6139
300152417600,30-015-24176,STATE MS GAS COM 001,1986-03-01,25,0,28732,44,303,815144,6183
300152417600,30-015-24176,STATE MS GAS COM 001,1986-04-01,26,10,14009,47,313,829153,6230
300152417600,30-015-24176,STATE MS GAS COM 001,1986-05-01,27,9,35645,53,322,864798,6283
300152417600,30-015-24176,STATE MS GAS COM 001,1986-06-01,28,4,37940,45,326,902738,6328
300152417600,30-015-24176,STATE MS GAS COM 001,1986-07-01,29,37,38248,3,363,940986,6331
300152417600,30-015-24176,STATE MS GAS COM 001,1986-08-01,30,0,35296,0,363,976282,6331
300152417600,30-015-24176,STATE MS GAS COM 001,1986-09-01,31,0,26140,30,363,1002422,6361
300152417600,30-015-24176,STATE MS GAS COM 001,1986-10-01,32,0,34502,139,363,1036924,6500
300152417600,30-015-24176,STATE MS GAS COM 001,1986-11-01,33,0,30599,42,363,1067523,6542
300152417600,30-015-24176,STATE MS GAS COM 001,1986-12-01,34,0,30336,11,363,1097859,6553
300152417600,30-015-24176,STATE MS GAS COM 001,1987-01-01,35,0,24341,36,363,1122200,6589
300152417600,30-015-24176,STATE MS GAS COM 001,1987-02-01,36,0,24918,17,363,1147118,6606
300152417600,30-015-24176,STATE MS GAS COM 001,1987-03-01,37,0,28483,23,363,1175601,6629
300152417600,30-015-24176,STATE MS GAS COM 001,1987-04-01,38,12,27487,102,375,1203088,6731
300152417600,30-015-24176,STATE MS GAS COM 001,1987-05-01,39,0,27293,63,375,1230381,6794
300152417600,30-015-24176,STATE MS GAS COM 001,1987-06-01,40,0,26042,26,375,1256423,6820
300152417600,30-015-24176,STATE MS GAS COM 001,1987-07-01,41,0,465,93,375,1256888,6913
300152417600,30-015-24176,STATE MS GAS COM 001,1987-08-01,42,0,7215,9,375,1264103,6922
300152417600,30-015-24176,STATE MS GAS COM 001,1987-09-01,43,0,0,0,375,1264103,6922
300152417600,30-015-24176,STATE MS GAS COM 001,1987-10-01,44,0,0,0,375,1264103,6922
300152417600,30-015-24176,STATE MS GAS COM 001,1987-11-01,45,0,0,0,375,1264103,6922
300152417600,30-015-24176,STATE MS GAS COM 001,1987-12-01,46,0,86,0,375,1264189,6922
300152417600,30-015-24176,STATE MS GAS COM 001,1988-01-01,47,0,0,0,375,1264189,6922
300152417600,30-015-24176,STATE MS GAS COM 001,1988-02-01,48,0,1104,0,375,1265293,6922
300152417600,30-015-24176,STATE MS GAS COM 001,1988-03-01,49,0,26,0,375,1265319,6922
300152417600,30-015-24176,STATE MS GAS COM 001,1988-04-01,50,22,331,36,397,1265650,6958
300152417600,30-015-24176,STATE MS GAS COM 001,1988-05-01,51,0,34,1,397,1265684,6959
300152417600,30-015-24176,STATE MS GAS COM 001,1988-06-01,52,0,0,0,397,1265684,6959
300152417600,30-015-24176,STATE MS GAS COM 001,1988-07-01,53,0,0,0,397,1265684,6959
300152417600,30-015-24176,STATE MS GAS COM 001,1988-08-01,54,0,470,0,397,1266154,6959
300152417600,30-015-24176,STATE MS GAS COM 001,1988-09-01,55,0,59,0,397,1266213,6959
300152417600,30-015-24176,STATE MS GAS COM 001,1988-10-01,56,0,31,0,397,1266244,6959
300152417600,30-015-24176,STATE MS GAS COM 001,1988-11-01,57,0,307,0,397,1266551,6959
300152417600,30-015-24176,STATE MS GAS COM 001,1988-12-01,58,0,66,0,397,1266617,6959
300152417600,30-015-24176,STATE MS GAS COM 001,1989-01-01,59,0,21,0,397,1266638,6959
300152417600,30-015-24176,STATE MS GAS COM 001,1989-02-01,60,0,21,0,397,1266659,6959
300152417600,30-015-24176,STATE MS GAS COM 001,1989-03-01,61,0,44,0,397,1266703,6959
300152417600,30-015-24176,STATE MS GAS COM 001,1989-04-01,62,0,31,0,397,1266734,6959
300152417600,30-015-24176,STATE MS GAS COM 001,1989-05-01,63,0,0,0,397,1266734,6959
300152417600,30-015-24176,STATE MS GAS COM 001,1989-06-01,64,5,36,0,402,1266770,6959
300152417600,30-015-24176,STATE MS GAS COM 001,1989-07-01,65,0,12,0,402,1266782,6959
300152417600,30-015-24176,STATE MS GAS COM 001,1989-08-01,66,0,0,0,402,1266782,6959
300152417600,30-015-24176,STATE MS GAS COM 001,1989-09-01,67,0,4205,0,402,1270987,6959
300154396000,30-015-43960,BLACK RIVER 15 10 STATE COM 003H,2018-05-01,1,155,0,0,155,0,0
300154396000,30-015-43960,BLACK RIVER 15 10 STATE COM 003H,2018-06-01,2,22722,55598,127272,22877,55598,127272
300154396000,30-015-43960,BLACK RIVER 15 10 STATE COM 003H,2018-07-01,3,12572,18448,94600,35449,74046,221872
300154396000,30-015-43960,BLACK RIVER 15 10 STATE COM 003H,2018-08-01,4,30798,58793,101073,66247,132839,322945
300154396000,30-015-43960,BLACK RIVER 15 10 STATE COM 003H,2018-09-01,5,7279,8947,21923,73526,141786,344868
300154396000,30-015-43960,BLACK RIVER 15 10 STATE COM 003H,2018-10-01,6,17448,38841,60147,90974,180627,405015
300154396000,30-015-43960,BLACK RIVER 15 10 STATE COM 003H,2018-11-01,7,17868,49047,68656,108842,229674,473671
300154396000,30-015-43960,BLACK RIVER 15 10 STATE COM 003H,2018-12-01,8,15688,42784,53385,124530,272458,527056
300154396000,30-015-43960,BLACK RIVER 15 10 STATE COM 003H,2019-01-01,9,14202,26458,47506,138732,298916,574562
300154396000,30-015-43960,BLACK RIVER 15 10 STATE COM 003H,2019-02-01,10,12198,17738,53360,150930,316654,627922
300154396000,30-015-43960,BLACK RIVER 15 10 STATE COM 003H,2019-03-01,11,12136,29757,48496,163066,346411,676418
300154396000,30-015-43960,BLACK RIVER 15 10 STATE COM 003H,2019-04-01,12,11078,35251,47731,174144,381662,724149
300154396000,30-015-43960,BLACK RIVER 15 10 STATE COM 003H,2019-05-01,13,9212,30423,41032,183356,412085,765181
300154396000,30-015-43960,BLACK RIVER 15 10 STATE COM 003H,2019-06-01,14,10114,33050,46217,193470,445135,811398
300154396000,30-015-43960,BLACK RIVER 15 10 STATE COM 003H,2019-07-01,15,9678,33282,47597,203148,478417,858995
300154396000,30-015-43960,BLACK RIVER 15 10 STATE COM 003H,2019-08-01,16,7617,30461,42749,210765,508878,901744
300154396000,30-015-43960,BLACK RIVER 15 10 STATE COM 003H,2019-09-01,17,4964,17534,26508,215729,526412,928252
300154396000,30-015-43960,BLACK RIVER 15 10 STATE COM 003H,2019-10-01,18,6228,14117,25006,221957,540529,953258
300154396000,30-015-43960,BLACK RIVER 15 10 STATE COM 003H,2019-11-01,19,6702,10770,25241,228659,551299,978499
300154396000,30-015-43960,BLACK RIVER 15 10 STATE COM 003H,2019-12-01,20,5281,21053,31705,233940,572352,1010204
300154396000,30-015-43960,BLACK RIVER 15 10 STATE COM 003H,2020-01-01,21,5190,20332,29262,239130,592684,1039466
300154396000,30-015-43960,BLACK RIVER 15 10 STATE COM 003H,2020-02-01,22,4314,11590,15571,243444,604274,1055037
300154396000,30-015-43960,BLACK RIVER 15 10 STATE COM 003H,2020-03-01,23,6288,19463,31229,249732,623737,1086266
300154396000,30-015-43960,BLACK RIVER 15 10 STATE COM 003H,2020-04-01,24,4531,23360,30023,254263,647097,1116289
300154396000,30-015-43960,BLACK RIVER 15 10 STATE COM 003H,2020-05-01,25,5101,22037,27632,259364,669134,1143921
300154396000,30-015-43960,BLACK RIVER 15 10 STATE COM 003H,2020-06-01,26,4938,28996,30866,264302,698130,1174787
300154396000,30-015-43960,BLACK RIVER 15 10 STATE COM 003H,2020-07-01,27,3805,14726,18685,268107,712856,1193472
300154396000,30-015-43960,BLACK RIVER 15 10 STATE COM 003H,2020-08-01,28,4871,21445,27388,272978,734301,1220860
300154396000,30-015-43960,BLACK RIVER 15 10 STATE COM 003H,2020-09-01,29,4252,23373,26641,277230,757674,1247501
300154396000,30-015-43960,BLACK RIVER 15 10 STATE COM 003H,2020-10-01,30,3314,15313,22991,280544,772987,1270492
300154396000,30-015-43960,BLACK RIVER 15 10 STATE COM 003H,2020-11-01,31,2517,12748,20808,283061,785735,1291300
300154396000,30-015-43960,BLACK RIVER 15 10 STATE COM 003H,2020-12-01,32,3563,11747,19706,286624,797482,1311006
300154396000,30-015-43960,BLACK RIVER 15 10 STATE COM 003H,2021-01-01,33,3825,12467,20903,290449,809949,1331909
300154396000,30-015-43960,BLACK RIVER 15 10 STATE COM 003H,2021-02-01,34,3632,12829,15510,294081,822778,1347419
300154396000,30-015-43960,BLACK RIVER 15 10 STATE COM 003H,2021-03-01,35,4042,18728,26163,298123,841506,1373582
300154396000,30-015-43960,BLACK RIVER 15 10 STATE COM 003H,2021-04-01,36,3282,13631,19768,301405,855137,1393350
300154396000,30-015-43960,BLACK RIVER 15 10 STATE COM 003H,2021-05-01,37,3667,18699,25041,305072,873836,1418391
300154396000,30-015-43960,BLACK RIVER 15 10 STATE COM 003H,2021-06-01,38,3349,17887,23539,308421,891723,1441930
300154396000,30-015-43960,BLACK RIVER 15 10 STATE COM 003H,2021-07-01,39,3178,17094,21581,311599,908817,1463511
300154396000,30-015-43960,BLACK RIVER 15 10 STATE COM 003H,2021-08-01,40,3252,15061,19931,314851,923878,1483442
300154396000,30-015-43960,BLACK RIVER 15 10 STATE COM 003H,2021-09-01,41,2750,12322,16594,317601,936200,1500036
300154396000,30-015-43960,BLACK RIVER 15 10 STATE COM 003H,2021-10-01,42,3051,14565,20031,320652,950765,1520067
300154396000,30-015-43960,BLACK RIVER 15 10 STATE COM 003H,2021-11-01,43,3071,21103,20251,323723,971868,1540318
300154396000,30-015-43960,BLACK RIVER 15 10 STATE COM 003H,2021-12-01,44,2131,11851,10175,325854,983719,1550493
300154396000,30-015-43960,BLACK RIVER 15 10 STATE COM 003H,2022-01-01,45,2414,14256,11994,328268,997975,1562487
300154396000,30-015-43960,BLACK RIVER 15 10 STATE COM 003H,2022-02-01,46,2716,14309,14154,330984,1012284,1576641
300154396000,30-015-43960,BLACK RIVER 15 10 STATE COM 003H,2022-03-01,47,3132,13700,15980,334116,1025984,1592621
300154396000,30-015-43960,BLACK RIVER 15 10 STATE COM 003H,2022-04-01,48,2425,14015,13367,336541,1039999,1605988
300154396000,30-015-43960,BLACK RIVER 15 10 STATE COM 003H,2022-05-01,49,2416,13798,15883,338957,1053797,1621871
300154396000,30-015-43960,BLACK RIVER 15 10 STATE COM 003H,2022-06-01,50,2758,15935,16799,341715,1069732,1638670
300154396000,30-015-43960,BLACK RIVER 15 10 STATE COM 003H,2022-07-01,51,2691,19284,19228,344406,1089016,1657898
300154396000,30-015-43960,BLACK RIVER 15 10 STATE COM 003H,2022-08-01,52,2492,19480,18483,346898,1108496,1676381
300154396000,30-015-43960,BLACK RIVER 15 10 STATE COM 003H,2022-09-01,53,2153,15715,14835,349051,1124211,1691216
300154396000,30-015-43960,BLACK RIVER 15 10 STATE COM 003H,2022-10-01,54,2231,14154,16037,351282,1138365,1707253
300154396000,30-015-43960,BLACK RIVER 15 10 STATE COM 003H,2022-11-01,55,1248,6834,9971,352530,1145199,1717224
300154396000,30-015-43960,BLACK RIVER 15 10 STATE COM 003H,2022-12-01,56,1655,5882,8102,354185,1151081,1725326
300154396000,30-015-43960,BLACK RIVER 15 10 STATE COM 003H,2023-01-01,57,2831,10392,14365,357016,1161473,1739691
300154396000,30-015-43960,BLACK RIVER 15 10 STATE COM 003H,2023-02-01,58,190,183,353,357206,1161656,1740044
300154396000,30-015-43960,BLACK RIVER 15 10 STATE COM 003H,2023-03-01,59,327,3443,2413,357533,1165099,1742457
300154396000,30-015-43960,BLACK RIVER 15 10 STATE COM 003H,2023-04-01,60,968,3428,2551,358501,1168527,1745008
300154396000,30-015-43960,BLACK RIVER 15 10 STATE COM 003H,2023-05-01,61,3547,11261,16290,362048,1179788,1761298
300154396000,30-015-43960,BLACK RIVER 15 10 STATE COM 003H,2023-06-01,62,2262,8185,12248,364310,1187973,1773546
300154864600,30-015-48646,PERDOMO 25 STATE COM 701H,2023-06-01,1,11828,25537,73852,11828,25537,73852
300154864600,30-015-48646,PERDOMO 25 STATE COM 701H,2023-07-01,2,16623,32064,98464,28451,57601,172316
300152417600,30-015-24176,STATE MS GAS COM 001,1989-10-01,1,0,2812,0,402,1273799,6959
300152417600,30-015-24176,STATE MS GAS COM 001,1989-11-01,2,0,1656,0,402,1275455,6959
300152417600,30-015-24176,STATE MS GAS COM 001,1989-12-01,3,0,1892,0,402,1277347,6959
300152417600,30-015-24176,STATE MS GAS COM 001,1990-01-01,4,5,1273,0,407,1278620,6959
300152417600,30-015-24176,STATE MS GAS COM 001,1990-02-01,5,0,997,0,407,1279617,6959
300152417600,30-015-24176,STATE MS GAS COM 001,1990-03-01,6,0,0,0,407,1279617,6959
300152417600,30-015-24176,STATE MS GAS COM 001,1990-04-01,7,0,403,0,407,1280020,6959
300152417600,30-015-24176,STATE MS GAS COM 001,1990-05-01,8,0,835,0,407,1280855,6959
300152417600,30-015-24176,STATE MS GAS COM 001,1990-06-01,9,0,1426,0,407,1282281,6959
300152417600,30-015-24176,STATE MS GAS COM 001,1990-07-01,10,0,504,0,407,1282785,6959
300152417600,30-015-24176,STATE MS GAS COM 001,1990-08-01,11,0,3,0,407,1282788,6959
300152417600,30-015-24176,STATE MS GAS COM 001,1990-09-01,12,0,61,0,407,1282849,6959
300152417600,30-015-24176,STATE MS GAS COM 001,1990-10-01,13,17,68,0,424,1282917,6959
300152417600,30-015-24176,STATE MS GAS COM 001,1990-11-01,14,0,0,0,424,1282917,6959
300152417600,30-015-24176,STATE MS GAS COM 001,1990-12-01,15,0,38,0,424,1282955,6959
300152417600,30-015-24176,STATE MS GAS COM 001,1991-01-01,16,0,0,0,424,1282955,6959
300152417600,30-015-24176,STATE MS GAS COM 001,1991-02-01,17,0,0,0,424,1282955,6959
300152417600,30-015-24176,STATE MS GAS COM 001,1991-03-01,18,0,0,0,424,1282955,6959
300152417600,30-015-24176,STATE MS GAS COM 001,1991-04-01,19,0,0,0,424,1282955,6959
300152417600,30-015-24176,STATE MS GAS COM 001,1991-05-01,20,0,0,0,424,1282955,6959
300152417600,30-015-24176,STATE MS GAS COM 001,1991-06-01,21,34,0,0,458,1282955,6959
300152417600,30-015-24176,STATE MS GAS COM 001,1991-07-01,22,0,0,0,458,1282955,6959
300152417600,30-015-24176,STATE MS GAS COM 001,1991-08-01,23,0,0,0,458,1282955,6959
300152417600,30-015-24176,STATE MS GAS COM 001,1991-09-01,24,0,0,0,458,1282955,6959
300152417600,30-015-24176,STATE MS GAS COM 001,1991-10-01,25,0,0,0,458,1282955,6959
300152417600,30-015-24176,STATE MS GAS COM 001,1991-11-01,26,0,0,0,458,1282955,6959
300152417600,30-015-24176,STATE MS GAS COM 001,1991-12-01,27,0,90,0,458,1283045,6959
300152417600,30-015-24176,STATE MS GAS COM 001,1992-01-01,28,0,58,0,458,1283103,6959
300152417600,30-015-24176,STATE MS GAS COM 001,1992-02-01,29,0,110,0,458,1283213,6959
300152417600,30-015-24176,STATE MS GAS COM 001,1992-03-01,30,0,102,0,458,1283315,6959
300152417600,30-015-24176,STATE MS GAS COM 001,1992-04-01,31,0,45,0,458,1283360,6959
300152417600,30-015-24176,STATE MS GAS COM 001,1992-05-01,32,0,50,0,458,1283410,6959
300152417600,30-015-24176,STATE MS GAS COM 001,1992-06-01,33,0,94,0,458,1283504,6959
300152417600,30-015-24176,STATE MS GAS COM 001,1992-07-01,34,0,48,0,458,1283552,6959
300152417600,30-015-24176,STATE MS GAS COM 001,1992-08-01,35,0,85,0,458,1283637,6959
300152417600,30-015-24176,STATE MS GAS COM 001,1992-09-01,36,0,172,0,458,1283809,6959
300152417600,30-015-24176,STATE MS GAS COM 001,1992-10-01,37,0,1009,0,458,1284818,6959
300152417600,30-015-24176,STATE MS GAS COM 001,1992-11-01,38,0,630,0,458,1285448,6959
300152417600,30-015-24176,STATE MS GAS COM 001,1992-12-01,39,0,910,0,458,1286358,6959
300152417600,30-015-24176,STATE MS GAS COM 001,1993-01-01,40,0,879,0,458,1287237,6959
300152417600,30-015-24176,STATE MS GAS COM 001,1993-02-01,41,0,963,0,458,1288200,6959
300152417600,30-015-24176,STATE MS GAS COM 001,1993-03-01,42,0,0,0,458,1288200,6959
300152417600,30-015-24176,STATE MS GAS COM 001,1993-04-01,43,111,762,0,569,1288962,6959
300152417600,30-015-24176,STATE MS GAS COM 001,1993-05-01,44,0,665,0,569,1289627,6959
300152417600,30-015-24176,STATE MS GAS COM 001,1993-06-01,45,0,145,22,569,1289772,6981
300152417600,30-015-24176,STATE MS GAS COM 001,1993-07-01,46,0,888,0,569,1290660,6981
300152417600,30-015-24176,STATE MS GAS COM 001,1993-08-01,47,0,493,0,569,1291153,6981
300152417600,30-015-24176,STATE MS GAS COM 001,1993-09-01,48,3,523,0,572,1291676,6981
300152417600,30-015-24176,STATE MS GAS COM 001,1993-10-01,49,0,0,0,572,1291676,6981
300152417600,30-015-24176,STATE MS GAS COM 001,1993-11-01,50,11,500,0,583,1292176,6981
300152417600,30-015-24176,STATE MS GAS COM 001,1993-12-01,51,0,628,0,583,1292804,6981
300152417600,30-015-24176,STATE MS GAS COM 001,1994-01-01,52,3,430,0,586,1293234,6981
300152417600,30-015-24176,STATE MS GAS COM 001,1994-02-01,53,8,448,0,594,1293682,6981
300152417600,30-015-24176,STATE MS GAS COM 001,1994-03-01,54,0,554,0,594,1294236,6981
300152417600,30-015-24176,STATE MS GAS COM 001,1994-04-01,55,0,340,0,594,1294576,6981
300152417600,30-015-24176,STATE MS GAS COM 001,1994-05-01,56,6,373,3,600,1294949,6984
300152417600,30-015-24176,STATE MS GAS COM 001,1994-06-01,57,5,256,3,605,1295205,6987
300152417600,30-015-24176,STATE MS GAS COM 001,1994-07-01,58,0,385,0,605,1295590,6987
300152417600,30-015-24176,STATE MS GAS COM 001,1994-08-01,59,3,474,0,608,1296064,6987
300152417600,30-015-24176,STATE MS GAS COM 001,1994-09-01,60,6,309,0,614,1296373,6987
300152417600,30-015-24176,STATE MS GAS COM 001,1994-10-01,61,0,262,0,614,1296635,6987
300152417600,30-015-24176,STATE MS GAS COM 001,1994-11-01,62,3,178,0,617,1296813,6987
300152417600,30-015-24176,STATE MS GAS COM 001,1994-12-01,63,0,73,0,617,1296886,6987
300152417600,30-015-24176,STATE MS GAS COM 001,1995-01-01,64,2,177,5,619,1297063,6992
300152417600,30-015-24176,STATE MS GAS COM 001,1995-02-01,65,0,374,0,619,1297437,6992
300152417600,30-015-24176,STATE MS GAS COM 001,1995-03-01,66,0,366,0,619,1297803,6992
300152417600,30-015-24176,STATE MS GAS COM 001,1995-04-01,67,0,238,0,619,1298041,6992
300152417600,30-015-24176,STATE MS GAS COM 001,1995-05-01,68,0,133,0,619,1298174,6992
300152417600,30-015-24176,STATE MS GAS COM 001,1995-06-01,69,0,62,0,619,1298236,6992
300152417600,30-015-24176,STATE MS GAS COM 001,1995-07-01,70,0,31,0,619,1298267,6992
300152417600,30-015-24176,STATE MS GAS COM 001,1995-08-01,71,0,29,0,619,1298296,6992
300152417600,30-015-24176,STATE MS GAS COM 001,1995-09-01,72,0,58,0,619,1298354,6992
300152417600,30-015-24176,STATE MS GAS COM 001,1995-10-01,73,0,0,0,619,1298354,6992
300152417600,30-015-24176,STATE MS GAS COM 001,1995-11-01,74,0,0,0,619,1298354,6992
300152417600,30-015-24176,STATE MS GAS COM 001,1995-12-01,75,0,0,0,619,1298354,6992
300152417600,30-015-24176,STATE MS GAS COM 001,1996-01-01,76,0,0,0,619,1298354,6992
300152417600,30-015-24176,STATE MS GAS COM 001,1996-02-01,77,0,0,0,619,1298354,6992
300152417600,30-015-24176,STATE MS GAS COM 001,1996-03-01,78,0,0,0,619,1298354,6992
300152417600,30-015-24176,STATE MS GAS COM 001,1996-04-01,79,0,152,2,619,1298506,6994
300152417600,30-015-24176,STATE MS GAS COM 001,1996-05-01,80,3,0,14,622,1298506,7008
300152417600,30-015-24176,STATE MS GAS COM 001,1996-06-01,81,0,188,0,622,1298694,7008
300152417600,30-015-24176,STATE MS GAS COM 001,1996-07-01,82,0,350,0,622,1299044,7008
300152417600,30-015-24176,STATE MS GAS COM 001,1996-08-01,83,0,398,0,622,1299442,7008
300152417600,30-015-24176,STATE MS GAS COM 001,1996-09-01,84,0,322,0,622,1299764,7008
300152417600,30-015-24176,STATE MS GAS COM 001,1996-10-01,85,0,255,0,622,1300019,7008
300152417600,30-015-24176,STATE MS GAS COM 001,1996-11-01,86,0,258,0,622,1300277,7008
300152417600,30-015-24176,STATE MS GAS COM 001,1996-12-01,87,0,284,0,622,1300561,7008
300152417600,30-015-24176,STATE MS GAS COM 001,1997-01-01,88,19,2654,398,641,1303215,7406
300152417600,30-015-24176,STATE MS GAS COM 001,1997-02-01,89,0,3618,36,641,1306833,7442
300152417600,30-015-24176,STATE MS GAS COM 001,1997-03-01,90,160,3643,7,801,1310476,7449
300152417600,30-015-24176,STATE MS GAS COM 001,1997-04-01,91,103,3173,0,904,1313649,7449
300152417600,30-015-24176,STATE MS GAS COM 001,1997-05-01,92,84,2824,0,988,1316473,7449
300152417600,30-015-24176,STATE MS GAS COM 001,1997-06-01,93,44,2284,0,1032,1318757,7449
300152417600,30-015-24176,STATE MS GAS COM 001,1997-07-01,94,11,1824,0,1043,1320581,7449
300152417600,30-015-24176,STATE MS GAS COM 001,1997-08-01,95,9,1329,68,1052,1321910,7517
300152417600,30-015-24176,STATE MS GAS COM 001,1997-09-01,96,5,1197,28,1057,1323107,7545
300152417600,30-015-24176,STATE MS GAS COM 001,1997-10-01,97,0,965,60,1057,1324072,7605
300152417600,30-015-24176,STATE MS GAS COM 001,1997-11-01,98,14,1323,6,1071,1325395,7611
300152417600,30-015-24176,STATE MS GAS COM 001,1997-12-01,99,0,1203,0,1071,1326598,7611
300152417600,30-015-24176,STATE MS GAS COM 001,1998-01-01,100,42,953,39,1113,1327551,7650
300152417600,30-015-24176,STATE MS GAS COM 001,1998-02-01,101,0,1578,5,1113,1329129,7655
300152417600,30-015-24176,STATE MS GAS COM 001,1998-03-01,102,25,1236,2,1138,1330365,7657
300152417600,30-015-24176,STATE MS GAS COM 001,1998-04-01,103,24,963,0,1162,1331328,7657
300152417600,30-015-24176,STATE MS GAS COM 001,1998-05-01,104,0,512,0,1162,1331840,7657
300152417600,30-015-24176,STATE MS GAS COM 001,1998-06-01,105,7,508,55,1169,1332348,7712
300152417600,30-015-24176,STATE MS GAS COM 001,1998-07-01,106,0,807,0,1169,1333155,7712
300152417600,30-015-24176,STATE MS GAS COM 001,1998-08-01,107,0,651,10,1169,1333806,7722
300152417600,30-015-24176,STATE MS GAS COM 001,1998-09-01,108,11,918,11,1180,1334724,7733
300152417600,30-015-24176,STATE MS GAS COM 001,1998-10-01,109,44,846,45,1224,1335570,7778
300152417600,30-015-24176,STATE MS GAS COM 001,1998-11-01,110,0,779,23,1224,1336349,7801
300152417600,30-015-24176,STATE MS GAS COM 001,1998-12-01,111,8,600,0,1232,1336949,7801
300152417600,30-015-24176,STATE MS GAS COM 001,1999-01-01,112,14,926,25,1246,1337875,7826
300152417600,30-015-24176,STATE MS GAS COM 001,1999-02-01,113,17,854,6,1263,1338729,7832
300152417600,30-015-24176,STATE MS GAS COM 001,1999-03-01,114,0,611,0,1263,1339340,7832
300152417600,30-015-24176,STATE MS GAS COM 001,1999-04-01,115,0,696,0,1263,1340036,7832
300152417600,30-015-24176,STATE MS GAS COM 001,1999-05-01,116,11,726,28,1274,1340762,7860
300152417600,30-015-24176,STATE MS GAS COM 001,1999-06-01,117,11,345,33,1285,1341107,7893
300152417600,30-015-24176,STATE MS GAS COM 001,1999-07-01,118,0,590,28,1285,1341697,7921
300152417600,30-015-24176,STATE MS GAS COM 001,1999-08-01,119,11,802,33,1296,1342499,7954
300152417600,30-015-24176,STATE MS GAS COM 001,1999-09-01,120,6,610,33,1302,1343109,7987
300152417600,30-015-24176,STATE MS GAS COM 001,1999-10-01,121,11,512,10,1313,1343621,7997
300152417600,30-015-24176,STATE MS GAS COM 001,1999-11-01,122,14,575,3,1327,1344196,8000
300152417600,30-015-24176,STATE MS GAS COM 001,1999-12-01,123,3,212,0,1330,1344408,8000
300152417600,30-015-24176,STATE MS GAS COM 001,2000-01-01,124,0,339,2,1330,1344747,8002
300152417600,30-015-24176,STATE MS GAS COM 001,2000-02-01,125,8,691,31,1338,1345438,8033
300152417600,30-015-24176,STATE MS GAS COM 001,2000-03-01,126,14,546,38,1352,1345984,8071
300152417600,30-015-24176,STATE MS GAS COM 001,2000-04-01,127,3,726,47,1355,1346710,8118
300152417600,30-015-24176,STATE MS GAS COM 001,2000-05-01,128,0,500,0,1355,1347210,8118
300152417600,30-015-24176,STATE MS GAS COM 001,2000-06-01,129,0,530,0,1355,1347740,8118
300152417600,30-015-24176,STATE MS GAS COM 001,2000-07-01,130,0,674,0,1355,1348414,8118
300152417600,30-015-24176,STATE MS GAS COM 001,2000-08-01,131,0,280,0,1355,1348694,8118
300152417600,30-015-24176,STATE MS GAS COM 001,2000-09-01,132,0,3,0,1355,1348697,8118
300152417600,30-015-24176,STATE MS GAS COM 001,2000-10-01,133,33,767,66,1388,1349464,8184
300152417600,30-015-24176,STATE MS GAS COM 001,2000-11-01,134,0,475,0,1388,1349939,8184
300152417600,30-015-24176,STATE MS GAS COM 001,2000-12-01,135,0,94,0,1388,1350033,8184
300152417600,30-015-24176,STATE MS GAS COM 001,2001-01-01,136,34,56,0,1422,1350089,8184
300152417600,30-015-24176,STATE MS GAS COM 001,2001-02-01,137,28,56,1,1450,1350145,8185
300152417600,30-015-24176,STATE MS GAS COM 001,2001-03-01,138,0,295,0,1450,1350440,8185
300152417600,30-015-24176,STATE MS GAS COM 001,2001-04-01,139,0,134,0,1450,1350574,8185
300152417600,30-015-24176,STATE MS GAS COM 001,2001-05-01,140,0,34,0,1450,1350608,8185
300152417600,30-015-24176,STATE MS GAS COM 001,2001-06-01,141,0,49,0,1450,1350657,8185
300152417600,30-015-24176,STATE MS GAS COM 001,2001-07-01,142,0,435,0,1450,1351092,8185
300152417600,30-015-24176,STATE MS GAS COM 001,2001-08-01,143,0,448,16,1450,1351540,8201
300152417600,30-015-24176,STATE MS GAS COM 001,2001-09-01,144,0,453,0,1450,1351993,8201
300152417600,30-015-24176,STATE MS GAS COM 001,2001-10-01,145,62,348,14,1512,1352341,8215
300152417600,30-015-24176,STATE MS GAS COM 001,2001-11-01,146,13,389,19,1525,1352730,8234
300152417600,30-015-24176,STATE MS GAS COM 001,2001-12-01,147,3,543,3,1528,1353273,8237
300152417600,30-015-24176,STATE MS GAS COM 001,2002-01-01,148,0,471,0,1528,1353744,8237
300152417600,30-015-24176,STATE MS GAS COM 001,2002-02-01,149,5,493,23,1533,1354237,8260
300152417600,30-015-24176,STATE MS GAS COM 001,2002-03-01,150,11,420,0,1544,1354657,8260
300152417600,30-015-24176,STATE MS GAS COM 001,2002-04-01,151,0,554,0,1544,1355211,8260
300152417600,30-015-24176,STATE MS GAS COM 001,2002-05-01,152,0,605,0,1544,1355816,8260
300152417600,30-015-24176,STATE MS GAS COM 001,2002-06-01,153,8,259,0,1552,1356075,8260
300152417600,30-015-24176,STATE MS GAS COM 001,2002-07-01,154,0,471,0,1552,1356546,8260
300152417600,30-015-24176,STATE MS GAS COM 001,2002-08-01,155,0,417,0,1552,1356963,8260
300152417600,30-015-24176,STATE MS GAS COM 001,2002-09-01,156,0,475,0,1552,1357438,8260
300152417600,30-015-24176,STATE MS GAS COM 001,2002-10-01,1,30,536,28,1582,1357974,8288
300152417600,30-015-24176,STATE MS GAS COM 001,2002-11-01,2,0,467,3,1582,1358441,8291
300152417600,30-015-24176,STATE MS GAS COM 001,2002-12-01,3,0,232,0,1582,1358673,8291
300152417600,30-015-24176,STATE MS GAS COM 001,2003-01-01,4,8,547,0,1590,1359220,8291
300152417600,30-015-24176,STATE MS GAS COM 001,2003-02-01,5,32,480,0,1622,1359700,8291
300152417600,30-015-24176,STATE MS GAS COM 001,2003-03-01,6,0,623,0,1622,1360323,8291
300152417600,30-015-24176,STATE MS GAS COM 001,2003-04-01,7,0,61,0,1622,1360384,8291
300152417600,30-015-24176,STATE MS GAS COM 001,2003-05-01,8,0,149,0,1622,1360533,8291
300152417600,30-015-24176,STATE MS GAS COM 001,2003-06-01,9,0,591,0,1622,1361124,8291
300152417600,30-015-24176,STATE MS GAS COM 001,2003-07-01,10,0,487,0,1622,1361611,8291
300152417600,30-015-24176,STATE MS GAS COM 001,2003-08-01,11,0,423,0,1622,1362034,8291
300152417600,30-015-24176,STATE MS GAS COM 001,2003-09-01,12,0,325,0,1622,1362359,8291
300152417600,30-015-24176,STATE MS GAS COM 001,2003-10-01,13,0,399,0,1622,1362758,8291
300152417600,30-015-24176,STATE MS GAS COM 001,2003-11-01,14,0,442,0,1622,1363200,8291
300152417600,30-015-24176,STATE MS GAS COM 001,2003-12-01,15,19,382,64,1641,1363582,8355
300152417600,30-015-24176,STATE MS GAS COM 001,2004-01-01,16,0,403,30,1641,1363985,8385
300152417600,30-015-24176,STATE MS GAS COM 001,2004-02-01,17,8,449,0,1649,1364434,8385
300152417600,30-015-24176,STATE MS GAS COM 001,2004-03-01,18,8,764,7,1657,1365198,8392
300152417600,30-015-24176,STATE MS GAS COM 001,2004-04-01,19,20,580,18,1677,1365778,8410
300152417600,30-015-24176,STATE MS GAS COM 001,2004-05-01,20,5,602,6,1682,1366380,8416
300152417600,30-015-24176,STATE MS GAS COM 001,2004-06-01,21,0,447,7,1682,1366827,8423
300152417600,30-015-24176,STATE MS GAS COM 001,2004-07-01,22,0,479,13,1682,1367306,8436
300152417600,30-015-24176,STATE MS GAS COM 001,2004-08-01,23,0,444,9,1682,1367750,8445
300152417600,30-015-24176,STATE MS GAS COM 001,2004-09-01,24,0,460,0,1682,1368210,8445
300152417600,30-015-24176,STATE MS GAS COM 001,2004-10-01,25,11,468,0,1693,1368678,8445
300152417600,30-015-24176,STATE MS GAS COM 001,2004-11-01,26,6,1012,19,1699,1369690,8464
300152417600,30-015-24176,STATE MS GAS COM 001,2004-12-01,27,0,963,9,1699,1370653,8473
300152417600,30-015-24176,STATE MS GAS COM 001,2005-01-01,28,0,446,0,1699,1371099,8473
300152417600,30-015-24176,STATE MS GAS COM 001,2005-02-01,29,0,501,0,1699,1371600,8473
300152417600,30-015-24176,STATE MS GAS COM 001,2005-03-01,30,0,455,0,1699,1372055,8473
300152417600,30-015-24176,STATE MS GAS COM 001,2005-04-01,31,0,417,5,1699,1372472,8478
300152417600,30-015-24176,STATE MS GAS COM 001,2005-05-01,32,0,317,0,1699,1372789,8478
300152417600,30-015-24176,STATE MS GAS COM 001,2005-06-01,33,60,400,0,1759,1373189,8478
300152417600,30-015-24176,STATE MS GAS COM 001,2005-07-01,34,22,337,21,1781,1373526,8499
300152417600,30-015-24176,STATE MS GAS COM 001,2005-08-01,35,22,410,16,1803,1373936,8515
300152417600,30-015-24176,STATE MS GAS COM 001,2005-09-01,36,6,450,9,1809,1374386,8524
300152417600,30-015-24176,STATE MS GAS COM 001,2005-10-01,37,0,474,0,1809,1374860,8524
300152417600,30-015-24176,STATE MS GAS COM 001,2005-11-01,38,0,479,2,1809,1375339,8526
300152417600,30-015-24176,STATE MS GAS COM 001,2005-12-01,39,0,374,27,1809,1375713,8553
300152417600,30-015-24176,STATE MS GAS COM 001,2006-01-01,40,0,488,62,1809,1376201,8615
300152417600,30-015-24176,STATE MS GAS COM 001,2006-02-01,41,0,351,16,1809,1376552,8631
300152417600,30-015-24176,STATE MS GAS COM 001,2006-03-01,42,0,383,0,1809,1376935,8631
300152417600,30-015-24176,STATE MS GAS COM 001,2006-04-01,43,0,414,3,1809,1377349,8634
300152417600,30-015-24176,STATE MS GAS COM 001,2006-05-01,44,0,387,0,1809,1377736,8634
300152417600,30-015-24176,STATE MS GAS COM 001,2006-06-01,45,0,322,0,1809,1378058,8634
300152417600,30-015-24176,STATE MS GAS COM 001,2006-07-01,46,0,228,25,1809,1378286,8659
300152417600,30-015-24176,STATE MS GAS COM 001,2006-08-01,47,0,288,0,1809,1378574,8659
300152417600,30-015-24176,STATE MS GAS COM 001,2006-09-01,48,0,299,0,1809,1378873,8659
300152417600,30-015-24176,STATE MS GAS COM 001,2006-10-01,49,0,230,0,1809,1379103,8659
300152417600,30-015-24176,STATE MS GAS COM 001,2006-11-01,50,0,385,10,1809,1379488,8669
300152417600,30-015-24176,STATE MS GAS COM 001,2006-12-01,51,0,454,0,1809,1379942,8669
300152417600,30-015-24176,STATE MS GAS COM 001,2007-01-01,52,0,541,0,1809,1380483,8669
300152417600,30-015-24176,STATE MS GAS COM 001,2007-02-01,53,0,342,4,1809,1380825,8673
300152417600,30-015-24176,STATE MS GAS COM 001,2007-03-01,54,0,300,0,1809,1381125,8673
300152417600,30-015-24176,STATE MS GAS COM 001,2007-04-01,55,0,578,9,1809,1381703,8682
300152417600,30-015-24176,STATE MS GAS COM 001,2007-05-01,56,0,380,0,1809,1382083,8682
300152417600,30-015-24176,STATE MS GAS COM 001,2007-06-01,57,0,316,0,1809,1382399,8682
300152417600,30-015-24176,STATE MS GAS COM 001,2007-07-01,58,0,378,0,1809,1382777,8682
300152417600,30-015-24176,STATE MS GAS COM 001,2007-08-01,59,0,335,0,1809,1383112,8682
300152417600,30-015-24176,STATE MS GAS COM 001,2007-09-01,60,0,1103,169,1809,1384215,8851
300152417600,30-015-24176,STATE MS GAS COM 001,2007-10-01,61,0,3653,190,1809,1387868,9041
300152417600,30-015-24176,STATE MS GAS COM 001,2007-11-01,62,0,4348,169,1809,1392216,9210
300152417600,30-015-24176,STATE MS GAS COM 001,2007-12-01,63,0,4682,173,1809,1396898,9383
300152417600,30-015-24176,STATE MS GAS COM 001,2008-01-01,64,0,4642,286,1809,1401540,9669
300152417600,30-015-24176,STATE MS GAS COM 001,2008-02-01,65,8,2718,335,1817,1404258,10004
300152417600,30-015-24176,STATE MS GAS COM 001,2008-03-01,66,44,4026,313,1861,1408284,10317
300152417600,30-015-24176,STATE MS GAS COM 001,2008-04-01,67,30,3774,311,1891,1412058,10628
300152417600,30-015-24176,STATE MS GAS COM 001,2008-05-01,68,0,3719,312,1891,1415777,10940
300152417600,30-015-24176,STATE MS GAS COM 001,2008-06-01,69,88,3275,314,1979,1419052,11254
300152417600,30-015-24176,STATE MS GAS COM 001,2008-07-01,70,63,3377,328,2042,1422429,11582
300152417600,30-015-24176,STATE MS GAS COM 001,2008-08-01,71,75,3209,202,2117,1425638,11784
300152417600,30-015-24176,STATE MS GAS COM 001,2008-09-01,72,52,3068,173,2169,1428706,11957
300152417600,30-015-24176,STATE MS GAS COM 001,2008-10-01,73,110,2948,112,2279,1431654,12069
300152417600,30-015-24176,STATE MS GAS COM 001,2008-11-01,74,74,3128,363,2353,1434782,12432
300152417600,30-015-24176,STATE MS GAS COM 001,2008-12-01,75,51,2959,195,2404,1437741,12627
300152417600,30-015-24176,STATE MS GAS COM 001,2009-01-01,76,74,2942,139,2478,1440683,12766
300152417600,30-015-24176,STATE MS GAS COM 001,2009-02-01,77,73,1941,156,2551,1442624,12922
300152417600,30-015-24176,STATE MS GAS COM 001,2009-03-01,78,72,2977,85,2623,1445601,13007
300152417600,30-015-24176,STATE MS GAS COM 001,2009-04-01,79,110,2858,177,2733,1448459,13184
300152417600,30-015-24176,STATE MS GAS COM 001,2009-05-01,80,31,1484,101,2764,1449943,13285
300152417600,30-015-24176,STATE MS GAS COM 001,2009-06-01,81,49,1059,148,2813,1451002,13433
300152417600,30-015-24176,STATE MS GAS COM 001,2009-07-01,82,83,1432,168,2896,1452434,13601
300152417600,30-015-24176,STATE MS GAS COM 001,2009-08-01,83,28,1151,126,2924,1453585,13727
300152417600,30-015-24176,STATE MS GAS COM 001,2009-09-01,84,77,1193,157,3001,1454778,13884
300152417600,30-015-24176,STATE MS GAS COM 001,2009-10-01,85,69,1094,61,3070,1455872,13945
300152417600,30-015-24176,STATE MS GAS COM 001,2009-11-01,86,57,1074,159,3127,1456946,14104
300152417600,30-015-24176,STATE MS GAS COM 001,2009-12-01,87,55,1553,163,3182,1458499,14267
300152417600,30-015-24176,STATE MS GAS COM 001,2010-01-01,88,44,481,0,3226,1458980,14267
300152417600,30-015-24176,STATE MS GAS COM 001,2010-02-01,89,66,1965,584,3292,1460945,14851
300152417600,30-015-24176,STATE MS GAS COM 001,2010-03-01,90,74,1465,203,3366,1462410,15054
300152417600,30-015-24176,STATE MS GAS COM 001,2010-04-01,91,61,2236,140,3427,1464646,15194
300152417600,30-015-24176,STATE MS GAS COM 001,2010-05-01,92,58,1720,645,3485,1466366,15839
300152417600,30-015-24176,STATE MS GAS COM 001,2010-06-01,93,63,1924,265,3548,1468290,16104
300152417600,30-015-24176,STATE MS GAS COM 001,2010-07-01,94,69,2086,196,3617,1470376,16300
300152417600,30-015-24176,STATE MS GAS COM 001,2010-08-01,95,19,1934,131,3636,1472310,16431
300152417600,30-015-24176,STATE MS GAS COM 001,2010-09-01,96,14,1448,97,3650,1473758,16528
300152417600,30-015-24176,STATE MS GAS COM 001,2010-10-01,97,27,1291,86,3677,1475049,16614
300152417600,30-015-24176,STATE MS GAS COM 001,2010-11-01,98,80,1247,104,3757,1476296,16718
300152417600,30-015-24176,STATE MS GAS COM 001,2010-12-01,99,33,1229,67,3790,1477525,16785
300152417600,30-015-24176,STATE MS GAS COM 001,2011-01-01,100,19,894,45,3809,1478419,16830
300152417600,30-015-24176,STATE MS GAS COM 001,2011-02-01,101,107,889,95,3916,1479308,16925
300152417600,30-015-24176,STATE MS GAS COM 001,2011-03-01,102,47,1252,105,3963,1480560,17030
300152417600,30-015-24176,STATE MS GAS COM 001,2011-04-01,103,0,830,93,3963,1481390,17123
300152417600,30-015-24176,STATE MS GAS COM 001,2011-05-01,104,22,323,23,3985,1481713,17146
300152417600,30-015-24176,STATE MS GAS COM 001,2011-06-01,105,0,839,0,3985,1482552,17146
300152417600,30-015-24176,STATE MS GAS COM 001,2011-07-01,106,124,263,53,4109,1482815,17199
300152417600,30-015-24176,STATE MS GAS COM 001,2011-08-01,107,98,787,23,4207,1483602,17222
300152417600,30-015-24176,STATE MS GAS COM 001,2011-09-01,108,11,1297,272,4218,1484899,17494
300152417600,30-015-24176,STATE MS GAS COM 001,2011-10-01,109,44,940,85,4262,1485839,17579
300152417600,30-015-24176,STATE MS GAS COM 001,2011-11-01,110,30,1094,114,4292,1486933,17693
300152417600,30-015-24176,STATE MS GAS COM 001,2011-12-01,111,89,1471,32,4381,1488404,17725
300152417600,30-015-24176,STATE MS GAS COM 001,2012-01-01,112,0,756,9,4381,1489160,17734
300152417600,30-015-24176,STATE MS GAS COM 001,2012-02-01,113,50,993,160,4431,1490153,17894
300152417600,30-015-24176,STATE MS GAS COM 001,2012-03-01,114,38,712,50,4469,1490865,17944
300152417600,30-015-24176,STATE MS GAS COM 001,2012-04-01,115,26,789,56,4495,1491654,18000
300152417600,30-015-24176,STATE MS GAS COM 001,2012-05-01,116,47,901,91,4542,1492555,18091
300152417600,30-015-24176,STATE MS GAS COM 001,2012-06-01,117,38,850,115,4580,1493405,18206
300152417600,30-015-24176,STATE MS GAS COM 001,2012-07-01,118,0,474,1,4580,1493879,18207
300152417600,30-015-24176,STATE MS GAS COM 001,2012-08-01,119,78,646,68,4658,1494525,18275
300152417600,30-015-24176,STATE MS GAS COM 001,2012-09-01,120,0,669,61,4658,1495194,18336
300152417600,30-015-24176,STATE MS GAS COM 001,2012-10-01,121,1,756,167,4659,1495950,18503
300152417600,30-015-24176,STATE MS GAS COM 001,2012-11-01,122,116,925,67,4775,1496875,18570
300152417600,30-015-24176,STATE MS GAS COM 001,2012-12-01,123,2,587,43,4777,1497462,18613
300152417600,30-015-24176,STATE MS GAS COM 001,2013-01-01,124,0,539,131,4777,1498001,18744
300152417600,30-015-24176,STATE MS GAS COM 001,2013-02-01,125,0,653,155,4777,1498654,18899
300152417600,30-015-24176,STATE MS GAS COM 001,2013-03-01,126,61,1055,211,4838,1499709,19110
300152417600,30-015-24176,STATE MS GAS COM 001,2013-04-01,127,11,822,56,4849,1500531,19166
300152417600,30-015-24176,STATE MS GAS COM 001,2013-05-01,128,46,708,88,4895,1501239,19254
300152417600,30-015-24176,STATE MS GAS COM 001,2013-06-01,129,0,361,0,4895,1501600,19254
300152417600,30-015-24176,STATE MS GAS COM 001,2013-07-01,130,161,1227,0,5056,1502827,19254
300152417600,30-015-24176,STATE MS GAS COM 001,2013-08-01,131,0,867,193,5056,1503694,19447
300152417600,30-015-24176,STATE MS GAS COM 001,2013-09-01,132,0,729,163,5056,1504423,19610
300152417600,30-015-24176,STATE MS GAS COM 001,2013-10-01,133,102,673,117,5158,1505096,19727
300152417600,30-015-24176,STATE MS GAS COM 001,2013-11-01,134,45,400,107,5203,1505496,19834
300152417600,30-015-24176,STATE MS GAS COM 001,2013-12-01,135,0,351,72,5203,1505847,19906
300152417600,30-015-24176,STATE MS GAS COM 001,2014-01-01,136,19,415,60,5222,1506262,19966
300152417600,30-015-24176,STATE MS GAS COM 001,2014-02-01,137,80,568,126,5302,1506830,20092
300152417600,30-015-24176,STATE MS GAS COM 001,2014-03-01,138,34,239,79,5336,1507069,20171
300152417600,30-015-24176,STATE MS GAS COM 001,2014-04-01,139,0,94,28,5336,1507163,20199
300152417600,30-015-24176,STATE MS GAS COM 001,2014-05-01,140,171,667,321,5507,1507830,20520
300152417600,30-015-24176,STATE MS GAS COM 001,2014-06-01,141,0,650,0,5507,1508480,20520
300152417600,30-015-24176,STATE MS GAS COM 001,2014-07-01,142,0,415,0,5507,1508895,20520
300152417600,30-015-24176,STATE MS GAS COM 001,2014-08-01,143,0,325,2,5507,1509220,20522
300152417600,30-015-24176,STATE MS GAS COM 001,2014-09-01,144,3,57,0,5510,1509277,20522
300152417600,30-015-24176,STATE MS GAS COM 001,2014-10-01,145,0,312,0,5510,1509589,20522
300152417600,30-015-24176,STATE MS GAS COM 001,2014-11-01,146,143,278,401,5653,1509867,20923
300152417600,30-015-24176,STATE MS GAS COM 001,2014-12-01,147,99,1715,489,5752,1511582,21412
300152417600,30-015-24176,STATE MS GAS COM 001,2015-01-01,148,20,693,91,5772,1512275,21503
300152417600,30-015-24176,STATE MS GAS COM 001,2015-02-01,149,63,1539,313,5835,1513814,21816
300152417600,30-015-24176,STATE MS GAS COM 001,2015-03-01,150,53,1698,186,5888,1515512,22002
300152417600,30-015-24176,STATE MS GAS COM 001,2015-04-01,151,0,618,150,5888,1516130,22152
300152417600,30-015-24176,STATE MS GAS COM 001,2015-05-01,152,20,1072,276,5908,1517202,22428
300152417600,30-015-24176,STATE MS GAS COM 001,2015-06-01,153,13,864,134,5921,1518066,22562
300152417600,30-015-24176,STATE MS GAS COM 001,2015-07-01,154,0,326,0,5921,1518392,22562
300152417600,30-015-24176,STATE MS GAS COM 001,2015-08-01,155,0,301,0,5921,1518693,22562
300152417600,30-015-24176,STATE MS GAS COM 001,2015-09-01,156,0,130,0,5921,1518823,22562
300152417600,30-015-24176,STATE MS GAS COM 001,2015-10-01,157,0,99,0,5921,1518922,22562
300152417600,30-015-24176,STATE MS GAS COM 001,2015-11-01,158,0,50,0,5921,1518972,22562
300152417600,30-015-24176,STATE MS GAS COM 001,2015-12-01,159,0,833,0,5921,1519805,22562
300152417600,30-015-24176,STATE MS GAS COM 001,2016-01-01,160,0,174,0,5921,1519979,22562
300152417600,30-015-24176,STATE MS GAS COM 001,2016-02-01,161,0,105,0,5921,1520084,22562
300152417600,30-015-24176,STATE MS GAS COM 001,2016-03-01,162,0,310,0,5921,1520394,22562
300152417600,30-015-24176,STATE MS GAS COM 001,2016-04-01,163,169,574,3,6090,1520968,22565
300152417600,30-015-24176,STATE MS GAS COM 001,2016-05-01,164,0,248,0,6090,1521216,22565
300152417600,30-015-24176,STATE MS GAS COM 001,2016-06-01,165,0,131,0,6090,1521347,22565
300152417600,30-015-24176,STATE MS GAS COM 001,2016-07-01,166,0,376,0,6090,1521723,22565
300152417600,30-015-24176,STATE MS GAS COM 001,2016-08-01,167,0,323,0,6090,1522046,22565
300152417600,30-015-24176,STATE MS GAS COM 001,2016-09-01,168,0,458,0,6090,1522504,22565
300152417600,30-015-24176,STATE MS GAS COM 001,2016-10-01,169,0,289,0,6090,1522793,22565
300152417600,30-015-24176,STATE MS GAS COM 001,2016-11-01,170,73,457,0,6163,1523250,22565
300152417600,30-015-24176,STATE MS GAS COM 001,2016-12-01,171,0,361,0,6163,1523611,22565
300152417600,30-015-24176,STATE MS GAS COM 001,2017-01-01,172,0,261,0,6163,1523872,22565
300152417600,30-015-24176,STATE MS GAS COM 001,2017-02-01,173,0,387,0,6163,1524259,22565
300152417600,30-015-24176,STATE MS GAS COM 001,2017-03-01,174,54,392,2,6217,1524651,22567
300152417600,30-015-24176,STATE MS GAS COM 001,2017-04-01,175,0,256,0,6217,1524907,22567
300152417600,30-015-24176,STATE MS GAS COM 001,2017-05-01,176,46,722,0,6263,1525629,22567
300152417600,30-015-24176,STATE MS GAS COM 001,2017-06-01,177,30,1290,0,6293,1526919,22567
300152417600,30-015-24176,STATE MS GAS COM 001,2017-07-01,178,1,1432,0,6294,1528351,22567
300152417600,30-015-24176,STATE MS GAS COM 001,2017-08-01,179,27,1742,0,6321,1530093,22567
300152417600,30-015-24176,STATE MS GAS COM 001,2017-09-01,180,0,1359,0,6321,1531452,22567
300152417600,30-015-24176,STATE MS GAS COM 001,2017-10-01,181,6,1444,0,6327,1532896,22567
300152417600,30-015-24176,STATE MS GAS COM 001,2017-11-01,182,3,1285,0,6330,1534181,22567
300152417600,30-015-24176,STATE MS GAS COM 001,2017-12-01,183,49,1672,1,6379,1535853,22568
300152417600,30-015-24176,STATE MS GAS COM 001,2018-01-01,184,29,1282,0,6408,1537135,22568
300152417600,30-015-24176,STATE MS GAS COM 001,2018-02-01,185,26,1024,0,6434,1538159,22568
300152417600,30-015-24176,STATE MS GAS COM 001,2018-03-01,186,6,834,0,6440,1538993,22568
300152417600,30-015-24176,STATE MS GAS COM 001,2018-04-01,187,0,855,0,6440,1539848,22568
300152417600,30-015-24176,STATE MS GAS COM 001,2018-05-01,188,30,937,0,6470,1540785,22568
300152417600,30-015-24176,STATE MS GAS COM 001,2018-06-01,189,17,908,0,6487,1541693,22568
300152417600,30-015-24176,STATE MS GAS COM 001,2018-07-01,190,12,771,0,6499,1542464,22568
300152417600,30-015-24176,STATE MS GAS COM 001,2018-08-01,191,1,793,0,6500,1543257,22568
300152417600,30-015-24176,STATE MS GAS COM 001,2018-09-01,192,20,580,0,6520,1543837,22568
300152417600,30-015-24176,STATE MS GAS COM 001,2018-10-01,193,0,809,0,6520,1544646,22568
300152417600,30-015-24176,STATE MS GAS COM 001,2018-11-01,194,2,615,0,6522,1545261,22568
300152417600,30-015-24176,STATE MS GAS COM 001,2018-12-01,195,6,721,0,6528,1545982,22568
300152417600,30-015-24176,STATE MS GAS COM 001,2019-01-01,196,33,419,0,6561,1546401,22568
300152417600,30-015-24176,STATE MS GAS COM 001,2019-02-01,197,0,255,0,6561,1546656,22568
300152417600,30-015-24176,STATE MS GAS COM 001,2019-03-01,198,0,229,0,6561,1546885,22568
300152417600,30-015-24176,STATE MS GAS COM 001,2019-04-01,199,0,10,0,6561,1546895,22568
300152417600,30-015-24176,STATE MS GAS COM 001,2019-05-01,200,0,92,0,6561,1546987,22568
300152417600,30-015-24176,STATE MS GAS COM 001,2019-06-01,201,0,99,0,6561,1547086,22568
300152417600,30-015-24176,STATE MS GAS COM 001,2019-07-01,202,0,10,0,6561,1547096,22568
300152417600,30-015-24176,STATE MS GAS COM 001,2019-08-01,203,0,61,0,6561,1547157,22568
300152417600,30-015-24176,STATE MS GAS COM 001,2019-09-01,204,0,327,0,6561,1547484,22568
300152417600,30-015-24176,STATE MS GAS COM 001,2019-10-01,205,0,119,0,6561,1547603,22568
300152417600,30-015-24176,STATE MS GAS COM 001,2019-11-01,206,0,193,0,6561,1547796,22568
300152417600,30-015-24176,STATE MS GAS COM 001,2019-12-01,207,0,109,0,6561,1547905,22568
300152417600,30-015-24176,STATE MS GAS COM 001,2020-01-01,208,0,66,0,6561,1547971,22568
300152417600,30-015-24176,STATE MS GAS COM 001,2020-02-01,209,26,365,0,6587,1548336,22568
300152417600,30-015-24176,STATE MS GAS COM 001,2020-03-01,210,6,43,0,6593,1548379,22568
300152417600,30-015-24176,STATE MS GAS COM 001,2020-04-01,211,0,9,0,6593,1548388,22568
300152417600,30-015-24176,STATE MS GAS COM 001,2020-05-01,212,0,94,0,6593,1548482,22568
300152417600,30-015-24176,STATE MS GAS COM 001,2020-06-01,213,0,19,0,6593,1548501,22568
300152417600,30-015-24176,STATE MS GAS COM 001,2020-07-01,214,0,27,0,6593,1548528,22568
300152417600,30-015-24176,STATE MS GAS COM 001,2020-08-01,215,0,8,0,6593,1548536,22568
300152417600,30-015-24176,STATE MS GAS COM 001,2020-09-01,216,0,10,0,6593,1548546,22568
300152417600,30-015-24176,STATE MS GAS COM 001,2020-10-01,217,0,11,0,6593,1548557,22568
300152417600,30-015-24176,STATE MS GAS COM 001,2020-11-01,218,0,11,0,6593,1548568,22568
300152417600,30-015-24176,STATE MS GAS COM 001,2020-12-01,219,0,22,0,6593,1548590,22568
300152417600,30-015-24176,STATE MS GAS COM 001,2021-01-01,220,11,18,0,6604,1548608,22568
300152417600,30-015-24176,STATE MS GAS COM 001,2021-02-01,221,0,9,0,6604,1548617,22568
300152417600,30-015-24176,STATE MS GAS COM 001,2021-03-01,222,27,107,0,6631,1548724,22568
300152417600,30-015-24176,STATE MS GAS COM 001,2021-04-01,223,0,64,0,6631,1548788,22568
300152417600,30-015-24176,STATE MS GAS COM 001,2021-05-01,224,0,44,0,6631,1548832,22568
300152417600,30-015-24176,STATE MS GAS COM 001,2021-06-01,225,3,80,0,6634,1548912,22568
300152417600,30-015-24176,STATE MS GAS COM 001,2021-07-01,226,0,51,0,6634,1548963,22568
300152417600,30-015-24176,STATE MS GAS COM 001,2021-08-01,227,5,29,0,6639,1548992,22568
300152417600,30-015-24176,STATE MS GAS COM 001,2021-09-01,228,3,72,0,6642,1549064,22568
300152417600,30-015-24176,STATE MS GAS COM 001,2021-10-01,229,8,54,0,6650,1549118,22568
300152417600,30-015-24176,STATE MS GAS COM 001,2021-11-01,230,0,43,0,6650,1549161,22568
300152417600,30-015-24176,STATE MS GAS COM 001,2021-12-01,231,0,4,0,6650,1549165,22568
300152417600,30-015-24176,STATE MS GAS COM 001,2022-01-01,232,0,98,0,6650,1549263,22568
300152417600,30-015-24176,STATE MS GAS COM 001,2022-02-01,233,7,40,0,6657,1549303,22568
300152417600,30-015-24176,STATE MS GAS COM 001,2022-03-01,234,3,52,0,6660,1549355,22568
300152417600,30-015-24176,STATE MS GAS COM 001,2022-04-01,235,1,51,0,6661,1549406,22568
300152417600,30-015-24176,STATE MS GAS COM 001,2022-05-01,236,0,12,0,6661,1549418,22568
300152417600,30-015-24176,STATE MS GAS COM 001,2022-06-01,237,0,0,0,6661,1549418,22568
300152417600,30-015-24176,STATE MS GAS COM 001,2022-07-01,238,0,17,0,6661,1549435,22568
300152508700,30-015-25087,TARGET 23 STATE 001,1985-10-01,1,0,4089,0,0,4089,0
300152508700,30-015-25087,TARGET 23 STATE 001,1985-11-01,2,0,54664,66,0,58753,66
300152508700,30-015-25087,TARGET 23 STATE 001,1985-12-01,3,0,52702,51,0,111455,117
300152508700,30-015-25087,TARGET 23 STATE 001,1986-01-01,4,0,44468,42,0,155923,159
300152508700,30-015-25087,TARGET 23 STATE 001,1986-02-01,5,0,32859,30,0,188782,189
300152508700,30-015-25087,TARGET 23 STATE 001,1986-03-01,6,0,8727,10,0,197509,199
300152508700,30-015-25087,TARGET 23 STATE 001,1986-04-01,7,0,0,0,0,197509,199
300152508700,30-015-25087,TARGET 23 STATE 001,1986-05-01,8,0,33434,38,0,230943,237
300152508700,30-015-25087,TARGET 23 STATE 001,1986-06-01,9,0,28635,39,0,259578,276
300152508700,30-015-25087,TARGET 23 STATE 001,1986-07-01,10,0,21760,24,0,281338,300
300152508700,30-015-25087,TARGET 23 STATE 001,1986-08-01,11,0,17381,18,0,298719,318
300152508700,30-015-25087,TARGET 23 STATE 001,1986-09-01,12,0,14799,23,0,313518,341
300152508700,30-015-25087,TARGET 23 STATE 001,1986-10-01,13,0,13371,16,0,326889,357
300152508700,30-015-25087,TARGET 23 STATE 001,1986-11-01,14,0,12938,18,0,339827,375
300152508700,30-015-25087,TARGET 23 STATE 001,1986-12-01,15,0,13413,27,0,353240,402
300152508700,30-015-25087,TARGET 23 STATE 001,1987-01-01,16,0,13489,25,0,366729,427
300152508700,30-015-25087,TARGET 23 STATE 001,1987-02-01,17,0,8215,25,0,374944,452
300152508700,30-015-25087,TARGET 23 STATE 001,1987-03-01,18,0,10750,9,0,385694,461
300152508700,30-015-25087,TARGET 23 STATE 001,1987-04-01,19,0,8354,0,0,394048,461
300152508700,30-015-25087,TARGET 23 STATE 001,1987-05-01,20,0,9256,0,0,403304,461
300152508700,30-015-25087,TARGET 23 STATE 001,1987-06-01,21,0,9566,0,0,412870,461
300152508700,30-015-25087,TARGET 23 STATE 001,1987-07-01,22,0,8527,6,0,421397,467
300152508700,30-015-25087,TARGET 23 STATE 001,1987-08-01,23,0,8536,0,0,429933,467
300152508700,30-015-25087,TARGET 23 STATE 001,1987-09-01,24,0,7429,0,0,437362,467
300152508700,30-015-25087,TARGET 23 STATE 001,1987-10-01,25,0,6634,1,0,443996,468
300152508700,30-015-25087,TARGET 23 STATE 001,1987-11-01,26,0,7190,0,0,451186,468
300152508700,30-015-25087,TARGET 23 STATE 001,1987-12-01,27,0,7645,0,0,458831,468
300152508700,30-015-25087,TARGET 23 STATE 001,1988-01-01,28,0,8239,4,0,467070,472
300152508700,30-015-25087,TARGET 23 STATE 001,1988-02-01,29,0,6582,0,0,473652,472
300152508700,30-015-25087,TARGET 23 STATE 001,1988-03-01,30,0,7789,15,0,481441,487
300152508700,30-015-25087,TARGET 23 STATE 001,1988-04-01,31,0,6992,12,0,488433,499
300152508700,30-015-25087,TARGET 23 STATE 001,1988-05-01,32,0,6899,0,0,495332,499
300152508700,30-015-25087,TARGET 23 STATE 001,1988-06-01,33,0,6048,0,0,501380,499
300152508700,30-015-25087,TARGET 23 STATE 001,1988-07-01,34,0,5457,0,0,506837,499
300152508700,30-015-25087,TARGET 23 STATE 001,1988-08-01,35,0,4787,0,0,511624,499
300152508700,30-015-25087,TARGET 23 STATE 001,1988-09-01,36,0,5652,0,0,517276,499
300152508700,30-015-25087,TARGET 23 STATE 001,1988-10-01,37,0,6327,0,0,523603,499
300152508700,30-015-25087,TARGET 23 STATE 001,1988-11-01,38,0,6222,0,0,529825,499
300152508700,30-015-25087,TARGET 23 STATE 001,1988-12-01,39,0,5963,0,0,535788,499
300152508700,30-015-25087,TARGET 23 STATE 001,1989-01-01,40,0,5651,0,0,541439,499
300152508700,30-015-25087,TARGET 23 STATE 001,1989-02-01,41,0,4390,0,0,545829,499
300152508700,30-015-25087,TARGET 23 STATE 001,1989-03-01,42,39,3624,0,39,549453,499
300152508700,30-015-25087,TARGET 23 STATE 001,1989-04-01,43,0,2769,15,39,552222,514
300152508700,30-015-25087,TARGET 23 STATE 001,1989-05-01,44,0,4211,0,39,556433,514
300152508700,30-015-25087,TARGET 23 STATE 001,1989-06-01,45,0,3407,3,39,559840,517
300152508700,30-015-25087,TARGET 23 STATE 001,1989-07-01,46,0,3122,0,39,562962,517
300152508700,30-015-25087,TARGET 23 STATE 001,1989-08-01,47,0,3841,0,39,566803,517
300152508700,30-015-25087,TARGET 23 STATE 001,1989-09-01,48,0,3265,0,39,570068,517
300152508700,30-015-25087,TARGET 23 STATE 001,1989-10-01,49,0,4301,3,39,574369,520
300152508700,30-015-25087,TARGET 23 STATE 001,1989-11-01,50,0,4643,0,39,579012,520
300152508700,30-015-25087,TARGET 23 STATE 001,1989-12-01,51,0,5121,0,39,584133,520
300152508700,30-015-25087,TARGET 23 STATE 001,1990-01-01,52,0,4305,0,39,588438,520
300152508700,30-015-25087,TARGET 23 STATE 001,1990-02-01,53,0,3240,0,39,591678,520
300152508700,30-015-25087,TARGET 23 STATE 001,1990-03-01,54,0,3898,0,39,595576,520
300152508700,30-015-25087,TARGET 23 STATE 001,1990-04-01,55,0,2936,0,39,598512,520
300152508700,30-015-25087,TARGET 23 STATE 001,1990-05-01,56,0,3239,0,39,601751,520
300152508700,30-015-25087,TARGET 23 STATE 001,1990-06-01,57,0,3200,0,39,604951,520
300152508700,30-015-25087,TARGET 23 STATE 001,1990-07-01,58,0,2746,0,39,607697,520
300152508700,30-015-25087,TARGET 23 STATE 001,1990-08-01,59,0,2492,0,39,610189,520
300152508700,30-015-25087,TARGET 23 STATE 001,1990-09-01,60,0,2086,0,39,612275,520
300152508700,30-015-25087,TARGET 23 STATE 001,1990-10-01,61,0,2568,0,39,614843,520
300152508700,30-015-25087,TARGET 23 STATE 001,1990-11-01,62,0,2671,0,39,617514,520
300152508700,30-015-25087,TARGET 23 STATE 001,1990-12-01,63,0,2553,0,39,620067,520
300152508700,30-015-25087,TARGET 23 STATE 001,1991-01-01,64,0,2094,0,39,622161,520
300152508700,30-015-25087,TARGET 23 STATE 001,1991-02-01,65,0,1926,0,39,624087,520
300152508700,30-015-25087,TARGET 23 STATE 001,1991-03-01,66,0,2121,0,39,626208,520
300152508700,30-015-25087,TARGET 23 STATE 001,1991-04-01,67,0,2058,0,39,628266,520
300152508700,30-015-25087,TARGET 23 STATE 001,1991-05-01,68,0,1622,0,39,629888,520
300152508700,30-015-25087,TARGET 23 STATE 001,1991-06-01,69,0,2818,0,39,632706,520
300152508700,30-015-25087,TARGET 23 STATE 001,1991-07-01,70,0,2412,0,39,635118,520
300152508700,30-015-25087,TARGET 23 STATE 001,1991-08-01,71,0,2273,0,39,637391,520
300152508700,30-015-25087,TARGET 23 STATE 001,1991-09-01,72,0,1953,0,39,639344,520
300152508700,30-015-25087,TARGET 23 STATE 001,1991-10-01,73,0,2586,0,39,641930,520
300152508700,30-015-25087,TARGET 23 STATE 001,1991-11-01,74,0,2481,0,39,644411,520
300152508700,30-015-25087,TARGET 23 STATE 001,1991-12-01,75,0,1559,0,39,645970,520
300152508700,30-015-25087,TARGET 23 STATE 001,1992-01-01,76,0,1549,0,39,647519,520
300152508700,30-015-25087,TARGET 23 STATE 001,1992-02-01,77,0,2045,0,39,649564,520
300152508700,30-015-25087,TARGET 23 STATE 001,1992-03-01,78,0,2314,4,39,651878,524
300152508700,30-015-25087,TARGET 23 STATE 001,1992-04-01,79,0,2742,0,39,654620,524
300152508700,30-015-25087,TARGET 23 STATE 001,1992-05-01,80,0,2626,2,39,657246,526
300152508700,30-015-25087,TARGET 23 STATE 001,1992-06-01,81,0,2199,2,39,659445,528
300152508700,30-015-25087,TARGET 23 STATE 001,1992-07-01,82,0,2481,1,39,661926,529
300152508700,30-015-25087,TARGET 23 STATE 001,1992-08-01,83,0,2534,0,39,664460,529
300152508700,30-015-25087,TARGET 23 STATE 001,1992-09-01,84,0,2044,0,39,666504,529
300152508700,30-015-25087,TARGET 23 STATE 001,1992-10-01,85,0,1900,0,39,668404,529
300152508700,30-015-25087,TARGET 23 STATE 001,1992-11-01,86,0,1752,0,39,670156,529
300152508700,30-015-25087,TARGET 23 STATE 001,1992-12-01,87,0,1748,0,39,671904,529
300152508700,30-015-25087,TARGET 23 STATE 001,1993-01-01,88,0,1762,0,39,673666,529
300152508700,30-015-25087,TARGET 23 STATE 001,1993-02-01,89,0,2105,0,39,675771,529
300152508700,30-015-25087,TARGET 23 STATE 001,1993-03-01,90,0,2412,0,39,678183,529
300152508700,30-015-25087,TARGET 23 STATE 001,1993-04-01,91,0,2117,0,39,680300,529
300152508700,30-015-25087,TARGET 23 STATE 001,1993-05-01,92,0,1830,42,39,682130,571
300152508700,30-015-25087,TARGET 23 STATE 001,1993-06-01,93,0,1705,0,39,683835,571
300152508700,30-015-25087,TARGET 23 STATE 001,1993-07-01,94,0,1259,0,39,685094,571
300152508700,30-015-25087,TARGET 23 STATE 001,1993-08-01,95,0,1271,0,39,686365,571
300152508700,30-015-25087,TARGET 23 STATE 001,1993-09-01,96,0,1128,0,39,687493,571
300152508700,30-015-25087,TARGET 23 STATE 001,1993-10-01,97,0,1297,0,39,688790,571
300152508700,30-015-25087,TARGET 23 STATE 001,1993-11-01,98,0,1379,0,39,690169,571
300152508700,30-015-25087,TARGET 23 STATE 001,1993-12-01,99,0,1474,0,39,691643,571
300152508700,30-015-25087,TARGET 23 STATE 001,1994-01-01,100,0,2182,0,39,693825,571
300152508700,30-015-25087,TARGET 23 STATE 001,1994-02-01,101,0,1185,2,39,695010,573
300152508700,30-015-25087,TARGET 23 STATE 001,1994-03-01,102,0,914,0,39,695924,573
300152508700,30-015-25087,TARGET 23 STATE 001,1994-04-01,1,0,39974,14,39,735898,587
300152508700,30-015-25087,TARGET 23 STATE 001,1994-05-01,2,0,45522,0,39,781420,587
300152508700,30-015-25087,TARGET 23 STATE 001,1994-06-01,3,0,10593,0,39,792013,587
300152508700,30-015-25087,TARGET 23 STATE 001,1994-07-01,4,0,6886,0,39,798899,587
300152508700,30-015-25087,TARGET 23 STATE 001,1994-08-01,5,0,5137,0,39,804036,587
300152508700,30-015-25087,TARGET 23 STATE 001,1994-09-01,6,0,4000,0,39,808036,587
300152508700,30-015-25087,TARGET 23 STATE 001,1994-10-01,7,0,3319,0,39,811355,587
300152508700,30-015-25087,TARGET 23 STATE 001,1994-11-01,8,0,1679,0,39,813034,587
300152508700,30-015-25087,TARGET 23 STATE 001,1994-12-01,9,0,2492,0,39,815526,587
300152508700,30-015-25087,TARGET 23 STATE 001,1995-01-01,10,0,333,0,39,815859,587
300152508700,30-015-25087,TARGET 23 STATE 001,1995-02-01,11,0,1951,2,39,817810,589
300152508700,30-015-25087,TARGET 23 STATE 001,1995-03-01,12,0,0,0,39,817810,589
300152508700,30-015-25087,TARGET 23 STATE 001,1995-04-01,13,0,0,0,39,817810,589
300152508700,30-015-25087,TARGET 23 STATE 001,1995-05-01,14,0,0,0,39,817810,589
300152508700,30-015-25087,TARGET 23 STATE 001,1995-06-01,15,0,0,9,39,817810,598
300152508700,30-015-25087,TARGET 23 STATE 001,1995-07-01,16,0,0,0,39,817810,598
300152508700,30-015-25087,TARGET 23 STATE 001,1995-08-01,17,0,3085,33,39,820895,631
300152508700,30-015-25087,TARGET 23 STATE 001,1995-09-01,18,0,3280,5,39,824175,636
300152508700,30-015-25087,TARGET 23 STATE 001,1995-10-01,19,0,2811,1,39,826986,637
300152508700,30-015-25087,TARGET 23 STATE 001,1995-11-01,20,0,2157,0,39,829143,637
300152508700,30-015-25087,TARGET 23 STATE 001,1995-12-01,21,0,443,0,39,829586,637
300152508700,30-015-25087,TARGET 23 STATE 001,1996-01-01,22,0,614,3,39,830200,640
300152508700,30-015-25087,TARGET 23 STATE 001,1996-02-01,23,0,16,0,39,830216,640
300152508700,30-015-25087,TARGET 23 STATE 001,1996-03-01,24,0,738,1,39,830954,641
300152508700,30-015-25087,TARGET 23 STATE 001,1996-04-01,25,0,1650,1,39,832604,642
300152508700,30-015-25087,TARGET 23 STATE 001,1996-05-01,26,0,1299,0,39,833903,642
300152508700,30-015-25087,TARGET 23 STATE 001,1996-06-01,27,0,805,0,39,834708,642
300152508700,30-015-25087,TARGET 23 STATE 001,1996-07-01,28,0,800,0,39,835508,642
300152508700,30-015-25087,TARGET 23 STATE 001,1996-08-01,29,0,563,0,39,836071,642
300152508700,30-015-25087,TARGET 23 STATE 001,1996-09-01,30,0,425,0,39,836496,642
300152508700,30-015-25087,TARGET 23 STATE 001,1996-10-01,31,0,619,0,39,837115,642
300152508700,30-015-25087,TARGET 23 STATE 001,1996-11-01,32,0,312,0,39,837427,642
300152508700,30-015-25087,TARGET 23 STATE 001,1996-12-01,33,0,14,0,39,837441,642
300152508700,30-015-25087,TARGET 23 STATE 001,1997-01-01,34,0,328,0,39,837769,642
300152508700,30-015-25087,TARGET 23 STATE 001,1997-02-01,35,0,670,0,39,838439,642
300154329600,30-015-43296,COMMODORE 30 W2PA FEDERAL 001H,2017-01-01,1,4178,25356,52998,4178,25356,52998
300154329600,30-015-43296,COMMODORE 30 W2PA FEDERAL 001H,2017-02-01,2,8854,74999,32615,13032,100355,85613
300154329600,30-015-43296,COMMODORE 30 W2PA FEDERAL 001H,2017-03-01,3,5008,44649,18030,18040,145004,103643
300154329600,30-015-43296,COMMODORE 30 W2PA FEDERAL 001H,2017-04-01,4,3861,29739,14639,21901,174743,118282
300154329600,30-015-43296,COMMODORE 30 W2PA FEDERAL 001H,2017-05-01,5,3971,41788,14728,25872,216531,133010
300154329600,30-015-43296,COMMODORE 30 W2PA FEDERAL 001H,2017-06-01,6,2550,21594,9198,28422,238125,142208
300154329600,30-015-43296,COMMODORE 30 W2PA FEDERAL 001H,2017-07-01,7,3212,30077,10315,31634,268202,152523
300154329600,30-015-43296,COMMODORE 30 W2PA FEDERAL 001H,2017-08-01,8,5756,56075,25364,37390,324277,177887
300154329600,30-015-43296,COMMODORE 30 W2PA FEDERAL 001H,2017-09-01,9,7608,73786,27658,44998,398063,205545
300154329600,30-015-43296,COMMODORE 30 W2PA FEDERAL 001H,2017-10-01,10,6779,69762,26308,51777,467825,231853
300154329600,30-015-43296,COMMODORE 30 W2PA FEDERAL 001H,2017-11-01,11,5529,56624,21016,57306,524449,252869
300154329600,30-015-43296,COMMODORE 30 W2PA FEDERAL 001H,2017-12-01,12,3831,40684,15850,61137,565133,268719
300154329600,30-015-43296,COMMODORE 30 W2PA FEDERAL 001H,2018-01-01,13,2275,21635,9938,63412,586768,278657
300154329600,30-015-43296,COMMODORE 30 W2PA FEDERAL 001H,2018-02-01,14,1036,8608,3323,64448,595376,281980
300154329600,30-015-43296,COMMODORE 30 W2PA FEDERAL 001H,2018-03-01,15,4789,47388,20780,69237,642764,302760
300154329600,30-015-43296,COMMODORE 30 W2PA FEDERAL 001H,2018-04-01,16,2733,27924,12508,71970,670688,315268
300154329600,30-015-43296,COMMODORE 30 W2PA FEDERAL 001H,2018-05-01,17,2095,19889,9316,74065,690577,324584
300154329600,30-015-43296,COMMODORE 30 W2PA FEDERAL 001H,2018-06-01,18,0,55,0,74065,690632,324584
300154329600,30-015-43296,COMMODORE 30 W2PA FEDERAL 001H,2018-07-01,19,3309,32961,15495,77374,723593,340079
300154329600,30-015-43296,COMMODORE 30 W2PA FEDERAL 001H,2018-08-01,20,4131,50087,17810,81505,773680,357889
300154329600,30-015-43296,COMMODORE 30 W2PA FEDERAL 001H,2018-09-01,21,109,1690,2075,81614,775370,359964
300154329600,30-015-43296,COMMODORE 30 W2PA FEDERAL 001H,2018-10-01,22,652,7856,8374,82266,783226,368338
300154329600,30-015-43296,COMMODORE 30 W2PA FEDERAL 001H,2018-11-01,23,2199,21468,18803,84465,804694,387141
300154329600,30-015-43296,COMMODORE 30 W2PA FEDERAL 001H,2018-12-01,24,1859,21561,12291,86324,826255,399432
300154329600,30-015-43296,COMMODORE 30 W2PA FEDERAL 001H,2019-01-01,25,2870,29666,14252,89194,855921,413684
300154329600,30-015-43296,COMMODORE 30 W2PA FEDERAL 001H,2019-02-01,26,1934,29054,8756,91128,884975,422440
300154329600,30-015-43296,COMMODORE 30 W2PA FEDERAL 001H,2019-03-01,27,381,4295,2744,91509,889270,425184
300154329600,30-015-43296,COMMODORE 30 W2PA FEDERAL 001H,2019-04-01,28,2082,28368,12430,93591,917638,437614
300154329600,30-015-43296,COMMODORE 30 W2PA FEDERAL 001H,2019-05-01,29,2610,41858,14311,96201,959496,451925
300154329600,30-015-43296,COMMODORE 30 W2PA FEDERAL 001H,2019-06-01,30,1319,22506,6889,97520,982002,458814
300154329600,30-015-43296,COMMODORE 30 W2PA FEDERAL 001H,2019-07-01,31,1572,25561,10127,99092,1007563,468941
300154329600,30-015-43296,COMMODORE 30 W2PA FEDERAL 001H,2019-08-01,32,1819,30148,10544,100911,1037711,479485
300154329600,30-015-43296,COMMODORE 30 W2PA FEDERAL 001H,2019-09-01,33,2107,37829,12653,103018,1075540,492138
300154329600,30-015-43296,COMMODORE 30 W2PA FEDERAL 001H,2019-10-01,34,962,16393,6549,103980,1091933,498687
300154329600,30-015-43296,COMMODORE 30 W2PA FEDERAL 001H,2019-11-01,35,404,5415,2691,104384,1097348,501378
300154329600,30-015-43296,COMMODORE 30 W2PA FEDERAL 001H,2019-12-01,36,1390,24722,10946,105774,1122070,512324
300154329600,30-015-43296,COMMODORE 30 W2PA FEDERAL 001H,2020-01-01,37,1168,20677,7890,106942,1142747,520214
300154329600,30-015-43296,COMMODORE 30 W2PA FEDERAL 001H,2020-02-01,38,1562,28307,9549,108504,1171054,529763
300154329600,30-015-43296,COMMODORE 30 W2PA FEDERAL 001H,2020-03-01,39,918,14754,4730,109422,1185808,534493
300154329600,30-015-43296,COMMODORE 30 W2PA FEDERAL 001H,2020-04-01,40,104,1580,413,109526,1187388,534906
300154329600,30-015-43296,COMMODORE 30 W2PA FEDERAL 001H,2020-05-01,41,241,3281,1465,109767,1190669,536371
300154329600,30-015-43296,COMMODORE 30 W2PA FEDERAL 001H,2020-06-01,42,1095,13739,9266,110862,1204408,545637
300154329600,30-015-43296,COMMODORE 30 W2PA FEDERAL 001H,2020-07-01,43,1358,29139,9397,112220,1233547,555034
300154329600,30-015-43296,COMMODORE 30 W2PA FEDERAL 001H,2020-08-01,44,1524,30959,9921,113744,1264506,564955
300154329600,30-015-43296,COMMODORE 30 W2PA FEDERAL 001H,2020-09-01,45,1477,33885,9645,115221,1298391,574600
300154329600,30-015-43296,COMMODORE 30 W2PA FEDERAL 001H,2020-10-01,46,545,15360,3991,115766,1313751,578591
300154329600,30-015-43296,COMMODORE 30 W2PA FEDERAL 001H,2020-11-01,47,333,13968,6090,116099,1327719,584681
300154329600,30-015-43296,COMMODORE 30 W2PA FEDERAL 001H,2020-12-01,48,1596,23307,8741,117695,1351026,593422
300154329600,30-015-43296,COMMODORE 30 W2PA FEDERAL 001H,2021-01-01,49,1161,16768,8051,118856,1367794,601473
300154329600,30-015-43296,COMMODORE 30 W2PA FEDERAL 001H,2021-02-01,50,772,17443,5412,119628,1385237,606885
300154329600,30-015-43296,COMMODORE 30 W2PA FEDERAL 001H,2021-03-01,51,1098,23982,8137,120726,1409219,615022
300154329600,30-015-43296,COMMODORE 30 W2PA FEDERAL 001H,2021-04-01,52,835,19233,6448,121561,1428452,621470
300154329600,30-015-43296,COMMODORE 30 W2PA FEDERAL 001H,2021-05-01,53,882,17647,6072,122443,1446099,627542
300154329600,30-015-43296,COMMODORE 30 W2PA FEDERAL 001H,2021-06-01,54,979,18913,8257,123422,1465012,635799
300154329600,30-015-43296,COMMODORE 30 W2PA FEDERAL 001H,2021-07-01,55,934,19930,7296,124356,1484942,643095
300154329600,30-015-43296,COMMODORE 30 W2PA FEDERAL 001H,2021-08-01,56,948,22409,7842,125304,1507351,650937
300154329600,30-015-43296,COMMODORE 30 W2PA FEDERAL 001H,2021-09-01,57,579,18440,6049,125883,1525791,656986
300154329600,30-015-43296,COMMODORE 30 W2PA FEDERAL 001H,2021-10-01,58,861,16849,5526,126744,1542640,662512
300154329600,30-015-43296,COMMODORE 30 W2PA FEDERAL 001H,2021-11-01,59,744,17537,6476,127488,1560177,668988
300154329600,30-015-43296,COMMODORE 30 W2PA FEDERAL 001H,2021-12-01,60,730,10219,6171,128218,1570396,675159
300154329600,30-015-43296,COMMODORE 30 W2PA FEDERAL 001H,2022-01-01,61,622,14690,5529,128840,1585086,680688
300154329600,30-015-43296,COMMODORE 30 W2PA FEDERAL 001H,2022-02-01,62,441,6440,3583,129281,1591526,684271
300154329600,30-015-43296,COMMODORE 30 W2PA FEDERAL 001H,2022-03-01,63,808,16010,6566,130089,1607536,690837
300154329600,30-015-43296,COMMODORE 30 W2PA FEDERAL 001H,2022-04-01,64,807,17058,8295,130896,1624594,699132
300154329600,30-015-43296,COMMODORE 30 W2PA FEDERAL 001H,2022-05-01,65,445,10683,3936,131341,1635277,703068
300154329600,30-015-43296,COMMODORE 30 W2PA FEDERAL 001H,2022-06-01,66,613,14171,5146,131954,1649448,708214
300154329600,30-015-43296,COMMODORE 30 W2PA FEDERAL 001H,2022-07-01,67,399,11049,4615,132353,1660497,712829
300154329600,30-015-43296,COMMODORE 30 W2PA FEDERAL 001H,2022-08-01,68,0,0,0,132353,1660497,712829
300154329600,30-015-43296,COMMODORE 30 W2PA FEDERAL 001H,2022-09-01,69,0,648,65,132353,1661145,712894
300154329600,30-015-43296,COMMODORE 30 W2PA FEDERAL 001H,2022-10-01,70,500,9890,2948,132853,1671035,715842
300154329600,30-015-43296,COMMODORE 30 W2PA FEDERAL 001H,2022-11-01,71,578,6706,5217,133431,1677741,721059
300154329600,30-015-43296,COMMODORE 30 W2PA FEDERAL 001H,2022-12-01,72,580,10381,5350,134011,1688122,726409
300154329600,30-015-43296,COMMODORE 30 W2PA FEDERAL 001H,2023-01-01,73,112,52,1164,134123,1688174,727573
300154329600,30-015-43296,COMMODORE 30 W2PA FEDERAL 001H,2023-02-01,74,59,887,1886,134182,1689061,729459
300154329600,30-015-43296,COMMODORE 30 W2PA FEDERAL 001H,2023-03-01,75,592,11204,5957,134774,1700265,735416
300154329600,30-015-43296,COMMODORE 30 W2PA FEDERAL 001H,2023-04-01,76,698,10792,6618,135472,1711057,742034
300154329600,30-015-43296,COMMODORE 30 W2PA FEDERAL 001H,2023-05-01,77,249,7407,3942,135721,1718464,745976
300154329600,30-015-43296,COMMODORE 30 W2PA FEDERAL 001H,2023-06-01,78,282,4788,2236,136003,1723252,748212
300154329600,30-015-43296,COMMODORE 30 W2PA FEDERAL 001H,2023-07-01,79,218,7439,2980,136221,1730691,751192
300153594800,30-015-35948,BAT BOY STATE COM 001,2008-09-01,1,0,5349,472,0,5349,472
300153594800,30-015-35948,BAT BOY STATE COM 001,2008-10-01,2,0,329,69,0,5678,541
300153594800,30-015-35948,BAT BOY STATE COM 001,2008-11-01,3,0,0,0,0,5678,541
300153594800,30-015-35948,BAT BOY STATE COM 001,2008-12-01,4,0,39,73,0,5717,614
300153594800,30-015-35948,BAT BOY STATE COM 001,2009-01-01,5,0,22,14,0,5739,628
300153594800,30-015-35948,BAT BOY STATE COM 001,2009-02-01,6,0,1296,48,0,7035,676
300153594800,30-015-35948,BAT BOY STATE COM 001,2009-03-01,1,0,6517,99,0,13552,775
300153594800,30-015-35948,BAT BOY STATE COM 001,2009-04-01,2,0,4780,72,0,18332,847
300153594800,30-015-35948,BAT BOY STATE COM 001,2009-05-01,3,0,4014,41,0,22346,888
300153594800,30-015-35948,BAT BOY STATE COM 001,2009-06-01,4,0,3329,36,0,25675,924
300153594800,30-015-35948,BAT BOY STATE COM 001,2009-07-01,5,0,3020,28,0,28695,952
300153594800,30-015-35948,BAT BOY STATE COM 001,2009-08-01,6,0,2642,15,0,31337,967
300153594800,30-015-35948,BAT BOY STATE COM 001,2009-09-01,7,0,2358,11,0,33695,978
300153594800,30-015-35948,BAT BOY STATE COM 001,2009-10-01,8,0,2194,6,0,35889,984
300153594800,30-015-35948,BAT BOY STATE COM 001,2009-11-01,9,0,1872,3,0,37761,987
300153594800,30-015-35948,BAT BOY STATE COM 001,2009-12-01,10,0,1868,66,0,39629,1053
300153594800,30-015-35948,BAT BOY STATE COM 001,2010-01-01,11,0,1884,19,0,41513,1072
300153594800,30-015-35948,BAT BOY STATE COM 001,2010-02-01,12,0,1581,8,0,43094,1080
300153594800,30-015-35948,BAT BOY STATE COM 001,2010-03-01,13,0,1925,36,0,45019,1116
300153594800,30-015-35948,BAT BOY STATE COM 001,2010-04-01,14,0,1607,6,0,46626,1122
300153594800,30-015-35948,BAT BOY STATE COM 001,2010-05-01,15,0,1571,0,0,48197,1122
300153594800,30-015-35948,BAT BOY STATE COM 001,2010-06-01,16,0,1517,23,0,49714,1145
300153594800,30-015-35948,BAT BOY STATE COM 001,2010-07-01,17,0,1500,0,0,51214,1145
300153594800,30-015-35948,BAT BOY STATE COM 001,2010-08-01,18,0,1596,36,0,52810,1181
300153594800,30-015-35948,BAT BOY STATE COM 001,2010-09-01,19,0,1147,0,0,53957,1181
300153594800,30-015-35948,BAT BOY STATE COM 001,2010-10-01,20,0,1012,0,0,54969,1181
300153594800,30-015-35948,BAT BOY STATE COM 001,2010-11-01,21,0,826,0,0,55795,1181
300153594800,30-015-35948,BAT BOY STATE COM 001,2010-12-01,22,0,726,0,0,56521,1181
300153594800,30-015-35948,BAT BOY STATE COM 001,2011-01-01,23,0,614,0,0,57135,1181
300153594800,30-015-35948,BAT BOY STATE COM 001,2011-02-01,24,0,539,0,0,57674,1181
300153594800,30-015-35948,BAT BOY STATE COM 001,2011-03-01,25,0,484,0,0,58158,1181
300153594800,30-015-35948,BAT BOY STATE COM 001,2011-04-01,26,0,324,0,0,58482,1181
300153594800,30-015-35948,BAT BOY STATE COM 001,2011-05-01,27,0,1152,11,0,59634,1192
300153594800,30-015-35948,BAT BOY STATE COM 001,2011-06-01,28,0,1903,11,0,61537,1203
300153594800,30-015-35948,BAT BOY STATE COM 001,2011-07-01,29,0,1800,31,0,63337,1234
300153594800,30-015-35948,BAT BOY STATE COM 001,2011-08-01,30,0,1755,22,0,65092,1256
300153594800,30-015-35948,BAT BOY STATE COM 001,2011-09-01,31,0,1578,16,0,66670,1272
300153594800,30-015-35948,BAT BOY STATE COM 001,2011-10-01,32,0,1595,17,0,68265,1289
300153594800,30-015-35948,BAT BOY STATE COM 001,2011-11-01,33,0,1536,24,0,69801,1313
300153594800,30-015-35948,BAT BOY STATE COM 001,2011-12-01,34,0,1539,16,0,71340,1329
300153594800,30-015-35948,BAT BOY STATE COM 001,2012-01-01,35,0,1507,24,0,72847,1353
300153594800,30-015-35948,BAT BOY STATE COM 001,2012-02-01,36,0,1356,11,0,74203,1364
300153594800,30-015-35948,BAT BOY STATE COM 001,2012-03-01,37,0,1408,16,0,75611,1380
300153594800,30-015-35948,BAT BOY STATE COM 001,2012-04-01,38,0,1354,17,0,76965,1397
300153594800,30-015-35948,BAT BOY STATE COM 001,2012-05-01,39,0,1358,11,0,78323,1408
300153594800,30-015-35948,BAT BOY STATE COM 001,2012-06-01,40,0,1289,14,0,79612,1422
300153594800,30-015-35948,BAT BOY STATE COM 001,2012-07-01,41,0,1315,11,0,80927,1433
300153594800,30-015-35948,BAT BOY STATE COM 001,2012-08-01,42,0,1287,14,0,82214,1447
300153594800,30-015-35948,BAT BOY STATE COM 001,2012-09-01,43,0,1221,9,0,83435,1456
300153594800,30-015-35948,BAT BOY STATE COM 001,2012-10-01,44,0,1242,11,0,84677,1467
300153594800,30-015-35948,BAT BOY STATE COM 001,2012-11-01,45,0,1158,11,0,85835,1478
300153594800,30-015-35948,BAT BOY STATE COM 001,2012-12-01,46,0,1053,0,0,86888,1478
300153594800,30-015-35948,BAT BOY STATE COM 001,2013-01-01,47,0,873,0,0,87761,1478
300153594800,30-015-35948,BAT BOY STATE COM 001,2013-02-01,48,0,980,15,0,88741,1493
300153594800,30-015-35948,BAT BOY STATE COM 001,2013-03-01,49,0,1153,12,0,89894,1505
300153594800,30-015-35948,BAT BOY STATE COM 001,2013-04-01,50,0,986,9,0,90880,1514
300153594800,30-015-35948,BAT BOY STATE COM 001,2013-05-01,51,0,1024,3,0,91904,1517
300153594800,30-015-35948,BAT BOY STATE COM 001,2013-06-01,52,14,803,0,14,92707,1517
300153594800,30-015-35948,BAT BOY STATE COM 001,2013-07-01,53,0,748,0,14,93455,1517
300153594800,30-015-35948,BAT BOY STATE COM 001,2013-08-01,54,0,658,0,14,94113,1517
300153594800,30-015-35948,BAT BOY STATE COM 001,2013-09-01,55,0,569,0,14,94682,1517
300153594800,30-015-35948,BAT BOY STATE COM 001,2013-10-01,56,0,863,0,14,95545,1517
300153594800,30-015-35948,BAT BOY STATE COM 001,2013-11-01,57,0,615,0,14,96160,1517
300153594800,30-015-35948,BAT BOY STATE COM 001,2013-12-01,58,0,795,0,14,96955,1517
300153594800,30-015-35948,BAT BOY STATE COM 001,2014-01-01,59,0,634,0,14,97589,1517
300153594800,30-015-35948,BAT BOY STATE COM 001,2014-02-01,60,0,496,0,14,98085,1517
300153594800,30-015-35948,BAT BOY STATE COM 001,2014-03-01,61,0,515,0,14,98600,1517
300153594800,30-015-35948,BAT BOY STATE COM 001,2014-04-01,62,0,483,0,14,99083,1517
300153594800,30-015-35948,BAT BOY STATE COM 001,2014-05-01,63,0,979,0,14,100062,1517
300153594800,30-015-35948,BAT BOY STATE COM 001,2014-06-01,64,0,712,0,14,100774,1517
300153594800,30-015-35948,BAT BOY STATE COM 001,2014-07-01,65,0,543,0,14,101317,1517
300153594800,30-015-35948,BAT BOY STATE COM 001,2014-08-01,66,0,363,0,14,101680,1517
300153594800,30-015-35948,BAT BOY STATE COM 001,2014-09-01,67,0,1017,0,14,102697,1517
300153594800,30-015-35948,BAT BOY STATE COM 001,2014-10-01,68,0,1617,0,14,104314,1517
300153594800,30-015-35948,BAT BOY STATE COM 001,2014-11-01,69,0,1360,0,14,105674,1517
300153594800,30-015-35948,BAT BOY STATE COM 001,2014-12-01,70,0,1190,0,14,106864,1517
300153594800,30-015-35948,BAT BOY STATE COM 001,2015-01-01,71,0,1052,0,14,107916,1517
300153594800,30-015-35948,BAT BOY STATE COM 001,2015-02-01,72,0,2085,0,14,110001,1517
300153594800,30-015-35948,BAT BOY STATE COM 001,2015-03-01,73,0,966,0,14,110967,1517
300153594800,30-015-35948,BAT BOY STATE COM 001,2015-04-01,74,1,755,0,15,111722,1517
300153594800,30-015-35948,BAT BOY STATE COM 001,2015-05-01,75,0,650,0,15,112372,1517
300153594800,30-015-35948,BAT BOY STATE COM 001,2015-06-01,76,0,624,0,15,112996,1517
300153594800,30-015-35948,BAT BOY STATE COM 001,2015-07-01,77,0,442,0,15,113438,1517
300153594800,30-015-35948,BAT BOY STATE COM 001,2015-08-01,78,0,229,0,15,113667,1517
300153594800,30-015-35948,BAT BOY STATE COM 001,2015-09-01,79,0,235,0,15,113902,1517
300153594800,30-015-35948,BAT BOY STATE COM 001,2015-10-01,80,0,482,0,15,114384,1517
300153594800,30-015-35948,BAT BOY STATE COM 001,2015-11-01,81,0,379,0,15,114763,1517
300153594800,30-015-35948,BAT BOY STATE COM 001,2015-12-01,82,0,280,0,15,115043,1517
300153594800,30-015-35948,BAT BOY STATE COM 001,2016-01-01,83,0,363,0,15,115406,1517
300153594800,30-015-35948,BAT BOY STATE COM 001,2016-02-01,84,0,75,0,15,115481,1517
300153594800,30-015-35948,BAT BOY STATE COM 001,2016-03-01,85,52,410,0,67,115891,1517
300153594800,30-015-35948,BAT BOY STATE COM 001,2016-04-01,86,0,532,0,67,116423,1517
300153594800,30-015-35948,BAT BOY STATE COM 001,2016-05-01,87,0,10,0,67,116433,1517
300153594800,30-015-35948,BAT BOY STATE COM 001,2016-06-01,88,0,0,0,67,116433,1517
300153594800,30-015-35948,BAT BOY STATE COM 001,2016-07-01,89,0,11,0,67,116444,1517
300153594800,30-015-35948,BAT BOY STATE COM 001,2016-08-01,90,0,0,0,67,116444,1517
300153594800,30-015-35948,BAT BOY STATE COM 001,2016-09-01,91,0,368,0,67,116812,1517
300153594800,30-015-35948,BAT BOY STATE COM 001,2016-10-01,92,0,476,0,67,117288,1517
300153594800,30-015-35948,BAT BOY STATE COM 001,2016-11-01,93,0,389,0,67,117677,1517
300153594800,30-015-35948,BAT BOY STATE COM 001,2016-12-01,94,0,318,0,67,117995,1517
300153594800,30-015-35948,BAT BOY STATE COM 001,2017-01-01,95,0,91,0,67,118086,1517
300153594800,30-015-35948,BAT BOY STATE COM 001,2017-02-01,96,0,458,0,67,118544,1517
300153594800,30-015-35948,BAT BOY STATE COM 001,2017-03-01,97,0,279,0,67,118823,1517
300153594800,30-015-35948,BAT BOY STATE COM 001,2017-04-01,98,0,335,0,67,119158,1517
300153594800,30-015-35948,BAT BOY STATE COM 001,2017-05-01,99,0,214,0,67,119372,1517
300153594800,30-015-35948,BAT BOY STATE COM 001,2017-06-01,100,0,150,0,67,119522,1517
300153594800,30-015-35948,BAT BOY STATE COM 001,2017-07-01,101,0,189,0,67,119711,1517
300153594800,30-015-35948,BAT BOY STATE COM 001,2017-08-01,102,0,198,0,67,119909,1517
300153594800,30-015-35948,BAT BOY STATE COM 001,2017-09-01,103,1,251,0,68,120160,1517
300153594800,30-015-35948,BAT BOY STATE COM 001,2017-10-01,104,0,190,0,68,120350,1517
300153594800,30-015-35948,BAT BOY STATE COM 001,2017-11-01,105,6,813,0,74,121163,1517
300153594800,30-015-35948,BAT BOY STATE COM 001,2017-12-01,106,0,930,0,74,122093,1517
300153594800,30-015-35948,BAT BOY STATE COM 001,2018-01-01,107,0,372,10,74,122465,1527
300153594800,30-015-35948,BAT BOY STATE COM 001,2018-02-01,108,0,760,0,74,123225,1527
300153594800,30-015-35948,BAT BOY STATE COM 001,2018-03-01,109,0,480,0,74,123705,1527
300153594800,30-015-35948,BAT BOY STATE COM 001,2018-04-01,110,0,0,0,74,123705,1527
300153594800,30-015-35948,BAT BOY STATE COM 001,2018-05-01,111,0,0,0,74,123705,1527
300153594800,30-015-35948,BAT BOY STATE COM 001,2018-06-01,112,0,393,0,74,124098,1527
300153594800,30-015-35948,BAT BOY STATE COM 001,2018-07-01,113,0,141,0,74,124239,1527
300153594800,30-015-35948,BAT BOY STATE COM 001,2018-08-01,114,0,0,0,74,124239,1527
300153594800,30-015-35948,BAT BOY STATE COM 001,2018-09-01,115,0,222,0,74,124461,1527
300153594800,30-015-35948,BAT BOY STATE COM 001,2018-10-01,116,0,325,0,74,124786,1527
300153594800,30-015-35948,BAT BOY STATE COM 001,2018-11-01,117,0,215,0,74,125001,1527
300153594800,30-015-35948,BAT BOY STATE COM 001,2018-12-01,118,0,201,0,74,125202,1527
300153594800,30-015-35948,BAT BOY STATE COM 001,2019-01-01,119,0,429,0,74,125631,1527
300153594800,30-015-35948,BAT BOY STATE COM 001,2019-02-01,120,0,97,0,74,125728,1527
300153594800,30-015-35948,BAT BOY STATE COM 001,2019-03-01,121,0,60,0,74,125788,1527
300153594800,30-015-35948,BAT BOY STATE COM 001,2019-04-01,122,11,22,0,85,125810,1527
300153594800,30-015-35948,BAT BOY STATE COM 001,2019-05-01,123,0,17,0,85,125827,1527
300153594800,30-015-35948,BAT BOY STATE COM 001,2019-06-01,124,0,318,0,85,126145,1527
300153594800,30-015-35948,BAT BOY STATE COM 001,2019-07-01,125,0,277,0,85,126422,1527
300153594800,30-015-35948,BAT BOY STATE COM 001,2019-08-01,126,0,41,0,85,126463,1527
300153594800,30-015-35948,BAT BOY STATE COM 001,2019-09-01,127,0,98,0,85,126561,1527
300153594800,30-015-35948,BAT BOY STATE COM 001,2019-10-01,128,0,75,0,85,126636,1527
300153594800,30-015-35948,BAT BOY STATE COM 001,2019-11-01,129,0,101,0,85,126737,1527
300153594800,30-015-35948,BAT BOY STATE COM 001,2019-12-01,130,0,102,0,85,126839,1527
300153594800,30-015-35948,BAT BOY STATE COM 001,2020-01-01,131,0,208,0,85,127047,1527
300153594800,30-015-35948,BAT BOY STATE COM 001,2020-02-01,132,0,163,0,85,127210,1527
300153594800,30-015-35948,BAT BOY STATE COM 001,2020-03-01,133,0,163,0,85,127373,1527
300153594800,30-015-35948,BAT BOY STATE COM 001,2020-04-01,134,0,175,0,85,127548,1527
300153594800,30-015-35948,BAT BOY STATE COM 001,2020-05-01,135,0,142,0,85,127690,1527
300153594800,30-015-35948,BAT BOY STATE COM 001,2020-06-01,136,0,24,0,85,127714,1527
300153594800,30-015-35948,BAT BOY STATE COM 001,2020-07-01,137,0,9,0,85,127723,1527
300153594800,30-015-35948,BAT BOY STATE COM 001,2020-08-01,138,0,152,0,85,127875,1527
300153594800,30-015-35948,BAT BOY STATE COM 001,2020-09-01,139,0,70,0,85,127945,1527
300153594800,30-015-35948,BAT BOY STATE COM 001,2020-10-01,140,0,60,0,85,128005,1527
300153594800,30-015-35948,BAT BOY STATE COM 001,2020-11-01,141,0,89,0,85,128094,1527
300153594800,30-015-35948,BAT BOY STATE COM 001,2020-12-01,142,0,69,0,85,128163,1527
300153594800,30-015-35948,BAT BOY STATE COM 001,2021-01-01,143,0,50,0,85,128213,1527
300153594800,30-015-35948,BAT BOY STATE COM 001,2021-02-01,144,0,12,0,85,128225,1527
300153594800,30-015-35948,BAT BOY STATE COM 001,2021-03-01,145,0,36,0,85,128261,1527
300153594800,30-015-35948,BAT BOY STATE COM 001,2021-04-01,146,0,15,0,85,128276,1527
300153594800,30-015-35948,BAT BOY STATE COM 001,2021-05-01,147,0,21,0,85,128297,1527
300153594800,30-015-35948,BAT BOY STATE COM 001,2021-06-01,148,0,32,0,85,128329,1527
300153594800,30-015-35948,BAT BOY STATE COM 001,2021-07-01,149,0,66,33,85,128395,1560
300153594800,30-015-35948,BAT BOY STATE COM 001,2021-08-01,150,0,84,0,85,128479,1560
300153594800,30-015-35948,BAT BOY STATE COM 001,2021-09-01,151,0,62,0,85,128541,1560
300153594800,30-015-35948,BAT BOY STATE COM 001,2021-10-01,152,0,28,0,85,128569,1560
300153594800,30-015-35948,BAT BOY STATE COM 001,2021-11-01,153,0,40,0,85,128609,1560
300153594800,30-015-35948,BAT BOY STATE COM 001,2021-12-01,154,0,8,0,85,128617,1560
300153594800,30-015-35948,BAT BOY STATE COM 001,2022-01-01,155,0,15,0,85,128632,1560
300153594800,30-015-35948,BAT BOY STATE COM 001,2022-02-01,156,0,30,0,85,128662,1560
300153594800,30-015-35948,BAT BOY STATE COM 001,2022-03-01,157,0,25,0,85,128687,1560
300153594800,30-015-35948,BAT BOY STATE COM 001,2022-04-01,158,0,0,0,85,128687,1560
300153594800,30-015-35948,BAT BOY STATE COM 001,2022-05-01,159,0,33,0,85,128720,1560
300153594800,30-015-35948,BAT BOY STATE COM 001,2022-06-01,160,0,5,0,85,128725,1560
300153594800,30-015-35948,BAT BOY STATE COM 001,2022-07-01,161,0,12,0,85,128737,1560
300153594800,30-015-35948,BAT BOY STATE COM 001,2022-08-01,162,0,0,0,85,128737,1560
300153594800,30-015-35948,BAT BOY STATE COM 001,2022-09-01,163,0,3,0,85,128740,1560
300153594800,30-015-35948,BAT BOY STATE COM 001,2022-10-01,164,0,8371,0,85,137111,1560
300153594800,30-015-35948,BAT BOY STATE COM 001,2022-11-01,165,0,1315,0,85,138426,1560
300153594800,30-015-35948,BAT BOY STATE COM 001,2022-12-01,166,0,0,0,85,138426,1560
300153594800,30-015-35948,BAT BOY STATE COM 001,2023-01-01,167,0,12,0,85,138438,1560
300153594800,30-015-35948,BAT BOY STATE COM 001,2023-02-01,168,0,23,0,85,138461,1560
300153594800,30-015-35948,BAT BOY STATE COM 001,2023-03-01,169,0,6014,0,85,144475,1560
300153594800,30-015-35948,BAT BOY STATE COM 001,2023-04-01,170,0,29,0,85,144504,1560
300153594800,30-015-35948,BAT BOY STATE COM 001,2023-05-01,171,0,26,0,85,144530,1560
300153594800,30-015-35948,BAT BOY STATE COM 001,2023-06-01,172,0,17,0,85,144547,1560
300153594800,30-015-35948,BAT BOY STATE COM 001,2023-07-01,173,0,24,0,85,144571,1560
300154289300,30-015-42893,MACANUDO BTE STATE COM 001H,2016-05-01,1,8479,12885,20263,8479,12885,20263
300154289300,30-015-42893,MACANUDO BTE STATE COM 001H,2016-06-01,2,20819,55469,41397,29298,68354,61660
300154289300,30-015-42893,MACANUDO BTE STATE COM 001H,2016-07-01,3,10137,41165,27279,39435,109519,88939
300154289300,30-015-42893,MACANUDO BTE STATE COM 001H,2016-08-01,4,7389,22319,16492,46824,131838,105431
300154289300,30-015-42893,MACANUDO BTE STATE COM 001H,2016-09-01,5,5601,30690,17555,52425,162528,122986
300154289300,30-015-42893,MACANUDO BTE STATE COM 001H,2016-10-01,6,4998,26268,13971,57423,188796,136957
300154289300,30-015-42893,MACANUDO BTE STATE COM 001H,2016-11-01,7,3962,20369,11511,61385,209165,148468
300154289300,30-015-42893,MACANUDO BTE STATE COM 001H,2016-12-01,8,3366,20641,10147,64751,229806,158615
300154289300,30-015-42893,MACANUDO BTE STATE COM 001H,2017-01-01,9,3344,20034,10283,68095,249840,168898
300154289300,30-015-42893,MACANUDO BTE STATE COM 001H,2017-02-01,10,2875,16727,8812,70970,266567,177710
300154289300,30-015-42893,MACANUDO BTE STATE COM 001H,2017-03-01,11,2703,19009,9587,73673,285576,187297
300154289300,30-015-42893,MACANUDO BTE STATE COM 001H,2017-04-01,12,2537,17996,7595,76210,303572,194892
300154289300,30-015-42893,MACANUDO BTE STATE COM 001H,2017-05-01,13,2578,16818,7790,78788,320390,202682
300154289300,30-015-42893,MACANUDO BTE STATE COM 001H,2017-06-01,14,2338,12695,7427,81126,333085,210109
300154289300,30-015-42893,MACANUDO BTE STATE COM 001H,2017-07-01,15,2305,9982,7274,83431,343067,217383
300154289300,30-015-42893,MACANUDO BTE STATE COM 001H,2017-08-01,16,739,2879,2031,84170,345946,219414
300154289300,30-015-42893,MACANUDO BTE STATE COM 001H,2017-09-01,17,624,981,879,84794,346927,220293
300154289300,30-015-42893,MACANUDO BTE STATE COM 001H,2017-10-01,18,0,9365,877,84794,356292,221170
300154289300,30-015-42893,MACANUDO BTE STATE COM 001H,2017-11-01,19,1751,7906,3811,86545,364198,224981
300154289300,30-015-42893,MACANUDO BTE STATE COM 001H,2017-12-01,20,2162,7919,4916,88707,372117,229897
300154289300,30-015-42893,MACANUDO BTE STATE COM 001H,2018-01-01,21,1813,7756,4668,90520,379873,234565
300154289300,30-015-42893,MACANUDO BTE STATE COM 001H,2018-02-01,22,1554,7169,3981,92074,387042,238546
300154289300,30-015-42893,MACANUDO BTE STATE COM 001H,2018-03-01,23,1659,8134,4403,93733,395176,242949
300154289300,30-015-42893,MACANUDO BTE STATE COM 001H,2018-04-01,24,1589,7259,4265,95322,402435,247214
300154289300,30-015-42893,MACANUDO BTE STATE COM 001H,2018-05-01,25,1595,7560,4326,96917,409995,251540
300154289300,30-015-42893,MACANUDO BTE STATE COM 001H,2018-06-01,26,1477,7052,3997,98394,417047,255537
300154289300,30-015-42893,MACANUDO BTE STATE COM 001H,2018-07-01,27,1483,7236,4020,99877,424283,259557
300154289300,30-015-42893,MACANUDO BTE STATE COM 001H,2018-08-01,28,1465,7011,4120,101342,431294,263677
300154289300,30-015-42893,MACANUDO BTE STATE COM 001H,2018-09-01,29,1424,6771,4001,102766,438065,267678
300154289300,30-015-42893,MACANUDO BTE STATE COM 001H,2018-10-01,30,1426,6780,4071,104192,444845,271749
300154289300,30-015-42893,MACANUDO BTE STATE COM 001H,2018-11-01,31,1429,8027,3762,105621,452872,275511
300154289300,30-015-42893,MACANUDO BTE STATE COM 001H,2018-12-01,32,1438,8613,3819,107059,461485,279330
300154289300,30-015-42893,MACANUDO BTE STATE COM 001H,2019-01-01,33,1434,6994,3802,108493,468479,283132
300154289300,30-015-42893,MACANUDO BTE STATE COM 001H,2019-02-01,34,1167,5998,3293,109660,474477,286425
300154289300,30-015-42893,MACANUDO BTE STATE COM 001H,2019-03-01,35,1350,6596,3665,111010,481073,290090
300154289300,30-015-42893,MACANUDO BTE STATE COM 001H,2019-04-01,36,1269,5693,3670,112279,486766,293760
300154289300,30-015-42893,MACANUDO BTE STATE COM 001H,2019-05-01,37,1214,5163,3535,113493,491929,297295
300154289300,30-015-42893,MACANUDO BTE STATE COM 001H,2019-06-01,38,1185,5530,3410,114678,497459,300705
300154289300,30-015-42893,MACANUDO BTE STATE COM 001H,2019-07-01,39,1144,4805,3407,115822,502264,304112
300154289300,30-015-42893,MACANUDO BTE STATE COM 001H,2019-08-01,40,1094,4865,3465,116916,507129,307577
300154289300,30-015-42893,MACANUDO BTE STATE COM 001H,2019-09-01,41,1058,4342,3314,117974,511471,310891
300154289300,30-015-42893,MACANUDO BTE STATE COM 001H,2019-10-01,42,1027,4512,2873,119001,515983,313764
300154289300,30-015-42893,MACANUDO BTE STATE COM 001H,2019-11-01,43,1061,4835,3015,120062,520818,316779
300154289300,30-015-42893,MACANUDO BTE STATE COM 001H,2019-12-01,44,1041,5434,3163,121103,526252,319942
300154289300,30-015-42893,MACANUDO BTE STATE COM 001H,2020-01-01,45,983,5158,3040,122086,531410,322982
300154289300,30-015-42893,MACANUDO BTE STATE COM 001H,2020-02-01,46,1061,5566,2638,123147,536976,325620
300154289300,30-015-42893,MACANUDO BTE STATE COM 001H,2020-03-01,47,1058,4931,3066,124205,541907,328686
300154289300,30-015-42893,MACANUDO BTE STATE COM 001H,2020-04-01,48,865,4363,2594,125070,546270,331280
300154289300,30-015-42893,MACANUDO BTE STATE COM 001H,2020-05-01,49,629,4911,1838,125699,551181,333118
300154289300,30-015-42893,MACANUDO BTE STATE COM 001H,2020-06-01,50,1017,5280,4097,126716,556461,337215
300154289300,30-015-42893,MACANUDO BTE STATE COM 001H,2020-07-01,51,1018,6254,3715,127734,562715,340930
300154289300,30-015-42893,MACANUDO BTE STATE COM 001H,2020-08-01,52,974,6266,3988,128708,568981,344918
300154289300,30-015-42893,MACANUDO BTE STATE COM 001H,2020-09-01,53,926,5550,3672,129634,574531,348590
300154289300,30-015-42893,MACANUDO BTE STATE COM 001H,2020-10-01,54,999,5376,3171,130633,579907,351761
300154289300,30-015-42893,MACANUDO BTE STATE COM 001H,2020-11-01,55,959,5404,2919,131592,585311,354680
300154289300,30-015-42893,MACANUDO BTE STATE COM 001H,2020-12-01,56,931,5255,3048,132523,590566,357728
300154289300,30-015-42893,MACANUDO BTE STATE COM 001H,2021-01-01,57,1310,6692,3654,133833,597258,361382
300154289300,30-015-42893,MACANUDO BTE STATE COM 001H,2021-02-01,58,931,5265,2511,134764,602523,363893
300154289300,30-015-42893,MACANUDO BTE STATE COM 001H,2021-03-01,59,1137,7116,3462,135901,609639,367355
300154289300,30-015-42893,MACANUDO BTE STATE COM 001H,2021-04-01,60,961,6793,3151,136862,616432,370506
300154289300,30-015-42893,MACANUDO BTE STATE COM 001H,2021-05-01,61,942,6606,3174,137804,623038,373680
300154289300,30-015-42893,MACANUDO BTE STATE COM 001H,2021-06-01,62,780,6455,3143,138584,629493,376823
300154289300,30-015-42893,MACANUDO BTE STATE COM 001H,2021-07-01,63,760,6875,3072,139344,636368,379895
300154289300,30-015-42893,MACANUDO BTE STATE COM 001H,2021-08-01,64,717,6203,2946,140061,642571,382841
300154289300,30-015-42893,MACANUDO BTE STATE COM 001H,2021-09-01,65,802,5490,3001,140863,648061,385842
300154289300,30-015-42893,MACANUDO BTE STATE COM 001H,2021-10-01,66,739,6283,3240,141602,654344,389082
300154289300,30-015-42893,MACANUDO BTE STATE COM 001H,2021-11-01,67,779,5808,3168,142381,660152,392250
300154289300,30-015-42893,MACANUDO BTE STATE COM 001H,2021-12-01,68,748,5785,2672,143129,665937,394922
300154289300,30-015-42893,MACANUDO BTE STATE COM 001H,2022-01-01,69,703,4755,2584,143832,670692,397506
300154289300,30-015-42893,MACANUDO BTE STATE COM 001H,2022-02-01,70,483,3800,1393,144315,674492,398899
300154289300,30-015-42893,MACANUDO BTE STATE COM 001H,2022-03-01,71,762,5157,2196,145077,679649,401095
300154289300,30-015-42893,MACANUDO BTE STATE COM 001H,2022-04-01,72,738,5606,2821,145815,685255,403916
300154289300,30-015-42893,MACANUDO BTE STATE COM 001H,2022-05-01,73,725,5732,2528,146540,690987,406444
300154289300,30-015-42893,MACANUDO BTE STATE COM 001H,2022-06-01,74,504,4178,1753,147044,695165,408197
300154289300,30-015-42893,MACANUDO BTE STATE COM 001H,2022-07-01,75,761,4934,2550,147805,700099,410747
300154289300,30-015-42893,MACANUDO BTE STATE COM 001H,2022-08-01,76,802,4960,2567,148607,705059,413314
300154289300,30-015-42893,MACANUDO BTE STATE COM 001H,2022-09-01,77,778,4576,2194,149385,709635,415508
300154289300,30-015-42893,MACANUDO BTE STATE COM 001H,2022-10-01,78,576,3872,1874,149961,713507,417382
300154289300,30-015-42893,MACANUDO BTE STATE COM 001H,2022-11-01,79,661,3696,2209,150622,717203,419591
300154289300,30-015-42893,MACANUDO BTE STATE COM 001H,2022-12-01,80,624,2946,2212,151246,720149,421803
300154289300,30-015-42893,MACANUDO BTE STATE COM 001H,2023-01-01,81,389,1275,547,151635,721424,422350
300154289300,30-015-42893,MACANUDO BTE STATE COM 001H,2023-02-01,82,487,3650,1272,152122,725074,423622
300154289300,30-015-42893,MACANUDO BTE STATE COM 001H,2023-03-01,83,535,2963,2097,152657,728037,425719
300154289300,30-015-42893,MACANUDO BTE STATE COM 001H,2023-04-01,84,0,20,0,152657,728057,425719
300154289300,30-015-42893,MACANUDO BTE STATE COM 001H,2023-05-01,85,1081,4718,1000,153738,732775,426719
300154289300,30-015-42893,MACANUDO BTE STATE COM 001H,2023-06-01,86,328,1836,473,154066,734611,427192
300154289300,30-015-42893,MACANUDO BTE STATE COM 001H,2023-07-01,87,432,1158,436,154498,735769,427628
300154272801,30-015-42728,BLACK RIVER 10 STATE COM 002H,2018-03-01,1,26471,113957,118483,26471,113957,118483
300154272801,30-015-42728,BLACK RIVER 10 STATE COM 002H,2018-04-01,2,22713,51111,76494,49184,165068,194977
300154272801,30-015-42728,BLACK RIVER 10 STATE COM 002H,2018-05-01,3,3750,7505,18594,52934,172573,213571
300154272801,30-015-42728,BLACK RIVER 10 STATE COM 002H,2018-06-01,4,17280,40926,87919,70214,213499,301490
300154272801,30-015-42728,BLACK RIVER 10 STATE COM 002H,2018-07-01,5,11779,21966,65205,81993,235465,366695
300154272801,30-015-42728,BLACK RIVER 10 STATE COM 002H,2018-08-01,6,15937,30308,50882,97930,265773,417577
300154272801,30-015-42728,BLACK RIVER 10 STATE COM 002H,2018-09-01,7,17394,48119,50865,115324,313892,468442
300154272801,30-015-42728,BLACK RIVER 10 STATE COM 002H,2018-10-01,8,13229,51867,50932,128553,365759,519374
300154272801,30-015-42728,BLACK RIVER 10 STATE COM 002H,2018-11-01,9,10815,51295,39722,139368,417054,559096
300154272801,30-015-42728,BLACK RIVER 10 STATE COM 002H,2018-12-01,10,9669,71419,36167,149037,488473,595263
300154272801,30-015-42728,BLACK RIVER 10 STATE COM 002H,2019-01-01,11,7183,53269,24405,156220,541742,619668
300154272801,30-015-42728,BLACK RIVER 10 STATE COM 002H,2019-02-01,12,6552,43404,24969,162772,585146,644637
300154272801,30-015-42728,BLACK RIVER 10 STATE COM 002H,2019-03-01,13,9007,39851,34792,171779,624997,679429
300154272801,30-015-42728,BLACK RIVER 10 STATE COM 002H,2019-04-01,14,1290,11525,10117,173069,636522,689546
300154272801,30-015-42728,BLACK RIVER 10 STATE COM 002H,2019-05-01,15,8186,37272,33760,181255,673794,723306
300154272801,30-015-42728,BLACK RIVER 10 STATE COM 002H,2019-06-01,16,5508,25245,19391,186763,699039,742697
300154272801,30-015-42728,BLACK RIVER 10 STATE COM 002H,2019-07-01,17,7825,46139,36749,194588,745178,779446
300154272801,30-015-42728,BLACK RIVER 10 STATE COM 002H,2019-08-01,18,7077,46717,37265,201665,791895,816711
300154272801,30-015-42728,BLACK RIVER 10 STATE COM 002H,2019-09-01,19,6051,35545,34226,207716,827440,850937
300154272801,30-015-42728,BLACK RIVER 10 STATE COM 002H,2019-10-01,20,5831,35994,31396,213547,863434,882333
300154272801,30-015-42728,BLACK RIVER 10 STATE COM 002H,2019-11-01,21,6071,29838,30536,219618,893272,912869
300154272801,30-015-42728,BLACK RIVER 10 STATE COM 002H,2019-12-01,22,5936,32686,22764,225554,925958,935633
300154272801,30-015-42728,BLACK RIVER 10 STATE COM 002H,2020-01-01,23,3866,17832,21654,229420,943790,957287
300154272801,30-015-42728,BLACK RIVER 10 STATE COM 002H,2020-02-01,24,4254,22969,21927,233674,966759,979214
300154272801,30-015-42728,BLACK RIVER 10 STATE COM 002H,2020-03-01,25,4294,20649,24427,237968,987408,1003641
300154272801,30-015-42728,BLACK RIVER 10 STATE COM 002H,2020-04-01,26,4372,32714,27530,242340,1020122,1031171
300154272801,30-015-42728,BLACK RIVER 10 STATE COM 002H,2020-05-01,27,3971,33526,26178,246311,1053648,1057349
300154272801,30-015-42728,BLACK RIVER 10 STATE COM 002H,2020-06-01,28,3759,47719,24782,250070,1101367,1082131
300154272801,30-015-42728,BLACK RIVER 10 STATE COM 002H,2020-07-01,29,3155,43580,20175,253225,1144947,1102306
300154272801,30-015-42728,BLACK RIVER 10 STATE COM 002H,2020-08-01,30,3774,45805,25097,256999,1190752,1127403
300154272801,30-015-42728,BLACK RIVER 10 STATE COM 002H,2020-09-01,31,3287,44669,23030,260286,1235421,1150433
300154272801,30-015-42728,BLACK RIVER 10 STATE COM 002H,2020-10-01,32,2882,46382,20000,263168,1281803,1170433
300154272801,30-015-42728,BLACK RIVER 10 STATE COM 002H,2020-11-01,33,1305,15330,8030,264473,1297133,1178463
300154272801,30-015-42728,BLACK RIVER 10 STATE COM 002H,2020-12-01,34,2322,20391,13071,266795,1317524,1191534
300154272801,30-015-42728,BLACK RIVER 10 STATE COM 002H,2021-01-01,35,2514,21493,15553,269309,1339017,1207087
300154272801,30-015-42728,BLACK RIVER 10 STATE COM 002H,2021-02-01,36,1189,11421,9367,270498,1350438,1216454
300154272801,30-015-42728,BLACK RIVER 10 STATE COM 002H,2021-03-01,37,2505,21138,13723,273003,1371576,1230177
300154272801,30-015-42728,BLACK RIVER 10 STATE COM 002H,2021-04-01,38,2844,25714,17825,275847,1397290,1248002
300154272801,30-015-42728,BLACK RIVER 10 STATE COM 002H,2021-05-01,39,1869,21908,13517,277716,1419198,1261519
300154272801,30-015-42728,BLACK RIVER 10 STATE COM 002H,2021-06-01,40,4089,31302,17914,281805,1450500,1279433
300154272801,30-015-42728,BLACK RIVER 10 STATE COM 002H,2021-07-01,41,2008,30962,18803,283813,1481462,1298236
300154272801,30-015-42728,BLACK RIVER 10 STATE COM 002H,2021-08-01,42,1944,25827,14929,285757,1507289,1313165
300154272801,30-015-42728,BLACK RIVER 10 STATE COM 002H,2021-09-01,43,1939,23186,13501,287696,1530475,1326666
300154272801,30-015-42728,BLACK RIVER 10 STATE COM 002H,2021-10-01,44,835,11285,6949,288531,1541760,1333615
300154272801,30-015-42728,BLACK RIVER 10 STATE COM 002H,2021-11-01,45,5,0,350,288536,1541760,1333965
300154272801,30-015-42728,BLACK RIVER 10 STATE COM 002H,2021-12-01,46,499,485,2390,289035,1542245,1336355
300154272801,30-015-42728,BLACK RIVER 10 STATE COM 002H,2022-01-01,47,1553,5358,10347,290588,1547603,1346702
300154272801,30-015-42728,BLACK RIVER 10 STATE COM 002H,2022-02-01,48,1548,6223,9279,292136,1553826,1355981
300154272801,30-015-42728,BLACK RIVER 10 STATE COM 002H,2022-03-01,49,2071,11894,13359,294207,1565720,1369340
300154272801,30-015-42728,BLACK RIVER 10 STATE COM 002H,2022-04-01,50,2354,15647,15543,296561,1581367,1384883
300154272801,30-015-42728,BLACK RIVER 10 STATE COM 002H,2022-05-01,51,2616,20835,18087,299177,1602202,1402970
300154272801,30-015-42728,BLACK RIVER 10 STATE COM 002H,2022-06-01,52,1979,23159,16785,301156,1625361,1419755
300154272801,30-015-42728,BLACK RIVER 10 STATE COM 002H,2022-07-01,53,1794,23457,16279,302950,1648818,1436034
300154272801,30-015-42728,BLACK RIVER 10 STATE COM 002H,2022-08-01,54,3209,24727,16812,306159,1673545,1452846
300154272801,30-015-42728,BLACK RIVER 10 STATE COM 002H,2022-09-01,55,1760,21724,15578,307919,1695269,1468424
300154272801,30-015-42728,BLACK RIVER 10 STATE COM 002H,2022-10-01,56,1649,22186,16337,309568,1717455,1484761
300154272801,30-015-42728,BLACK RIVER 10 STATE COM 002H,2022-11-01,57,1756,22032,16771,311324,1739487,1501532
300154272801,30-015-42728,BLACK RIVER 10 STATE COM 002H,2022-12-01,58,981,17163,10297,312305,1756650,1511829
300154272801,30-015-42728,BLACK RIVER 10 STATE COM 002H,2023-01-01,59,1695,18436,14976,314000,1775086,1526805
300154272801,30-015-42728,BLACK RIVER 10 STATE COM 002H,2023-02-01,60,1628,18894,14720,315628,1793980,1541525
300154272801,30-015-42728,BLACK RIVER 10 STATE COM 002H,2023-03-01,61,1485,18726,13665,317113,1812706,1555190
300154272801,30-015-42728,BLACK RIVER 10 STATE COM 002H,2023-04-01,62,1494,18667,13476,318607,1831373,1568666
300154272801,30-015-42728,BLACK RIVER 10 STATE COM 002H,2023-05-01,63,1601,20535,14339,320208,1851908,1583005
300154272801,30-015-42728,BLACK RIVER 10 STATE COM 002H,2023-06-01,64,1243,17703,12731,321451,1869611,1595736
300154406200,30-015-44062,MAD RIVER 13 STATE COM 005H,2018-07-01,1,6375,103125,32083,6375,103125,32083
300154406200,30-015-44062,MAD RIVER 13 STATE COM 005H,2018-08-01,2,8175,144574,20083,14550,247699,52166
300154406200,30-015-44062,MAD RIVER 13 STATE COM 005H,2018-09-01,3,8910,140317,20293,23460,388016,72459
300154406200,30-015-44062,MAD RIVER 13 STATE COM 005H,2018-10-01,4,8321,152304,24200,31781,540320,96659
300154406200,30-015-44062,MAD RIVER 13 STATE COM 005H,2018-11-01,5,9461,172226,24799,41242,712546,121458
300154406200,30-015-44062,MAD RIVER 13 STATE COM 005H,2018-12-01,6,8276,161329,23106,49518,873875,144564
300154406200,30-015-44062,MAD RIVER 13 STATE COM 005H,2019-01-01,7,7604,154118,21861,57122,1027993,166425
300154406200,30-015-44062,MAD RIVER 13 STATE COM 005H,2019-02-01,8,6380,138911,19010,63502,1166904,185435
300154406200,30-015-44062,MAD RIVER 13 STATE COM 005H,2019-03-01,9,6037,155052,19044,69539,1321956,204479
300154406200,30-015-44062,MAD RIVER 13 STATE COM 005H,2019-04-01,10,6444,149547,16070,75983,1471503,220549
300154406200,30-015-44062,MAD RIVER 13 STATE COM 005H,2019-05-01,11,5273,142322,16016,81256,1613825,236565
300154406200,30-015-44062,MAD RIVER 13 STATE COM 005H,2019-06-01,12,4703,132662,14816,85959,1746487,251381
300154406200,30-015-44062,MAD RIVER 13 STATE COM 005H,2019-07-01,13,2409,56102,4068,88368,1802589,255449
300154406200,30-015-44062,MAD RIVER 13 STATE COM 005H,2019-08-01,14,2019,44488,4322,90387,1847077,259771
300154406200,30-015-44062,MAD RIVER 13 STATE COM 005H,2019-09-01,15,3429,84609,12038,93816,1931686,271809
300154406200,30-015-44062,MAD RIVER 13 STATE COM 005H,2019-10-01,16,4167,117324,13866,97983,2049010,285675
300154406200,30-015-44062,MAD RIVER 13 STATE COM 005H,2019-11-01,17,3785,109805,11947,101768,2158815,297622
300154406200,30-015-44062,MAD RIVER 13 STATE COM 005H,2019-12-01,18,3409,107655,11603,105177,2266470,309225
300154406200,30-015-44062,MAD RIVER 13 STATE COM 005H,2020-01-01,19,3628,105776,12016,108805,2372246,321241
300154406200,30-015-44062,MAD RIVER 13 STATE COM 005H,2020-02-01,20,2756,81828,10110,111561,2454074,331351
300154406200,30-015-44062,MAD RIVER 13 STATE COM 005H,2020-03-01,21,2763,81514,9203,114324,2535588,340554
300154406200,30-015-44062,MAD RIVER 13 STATE COM 005H,2020-04-01,22,56,0,1,114380,2535588,340555
300154406200,30-015-44062,MAD RIVER 13 STATE COM 005H,2020-05-01,23,0,0,0,114380,2535588,340555
300154406200,30-015-44062,MAD RIVER 13 STATE COM 005H,2020-06-01,24,2349,59608,17456,116729,2595196,358011
300154406200,30-015-44062,MAD RIVER 13 STATE COM 005H,2020-07-01,25,2596,65378,11176,119325,2660574,369187
300154406200,30-015-44062,MAD RIVER 13 STATE COM 005H,2020-08-01,26,2412,68177,9195,121737,2728751,378382
300154406200,30-015-44062,MAD RIVER 13 STATE COM 005H,2020-09-01,27,2399,65405,9617,124136,2794156,387999
300154406200,30-015-44062,MAD RIVER 13 STATE COM 005H,2020-10-01,28,2560,71104,10006,126696,2865260,398005
300154406200,30-015-44062,MAD RIVER 13 STATE COM 005H,2020-11-01,29,2327,56998,8422,129023,2922258,406427
300154406200,30-015-44062,MAD RIVER 13 STATE COM 005H,2020-12-01,30,2339,68271,8574,131362,2990529,415001
300154406200,30-015-44062,MAD RIVER 13 STATE COM 005H,2021-01-01,31,2350,58653,7917,133712,3049182,422918
300154406200,30-015-44062,MAD RIVER 13 STATE COM 005H,2021-02-01,32,2881,47989,9899,136593,3097171,432817
300154406200,30-015-44062,MAD RIVER 13 STATE COM 005H,2021-03-01,33,2237,61389,8395,138830,3158560,441212
300154406200,30-015-44062,MAD RIVER 13 STATE COM 005H,2021-04-01,34,2134,62051,7176,140964,3220611,448388
300154406200,30-015-44062,MAD RIVER 13 STATE COM 005H,2021-05-01,35,2340,64923,7909,143304,3285534,456297
300154406200,30-015-44062,MAD RIVER 13 STATE COM 005H,2021-06-01,36,1976,55613,7308,145280,3341147,463605
300154406200,30-015-44062,MAD RIVER 13 STATE COM 005H,2021-07-01,37,2104,50274,7023,147384,3391421,470628
300154406200,30-015-44062,MAD RIVER 13 STATE COM 005H,2021-08-01,38,2128,38209,7079,149512,3429630,477707
300154406200,30-015-44062,MAD RIVER 13 STATE COM 005H,2021-09-01,39,2149,44788,8353,151661,3474418,486060
300154406200,30-015-44062,MAD RIVER 13 STATE COM 005H,2021-10-01,40,1968,63820,8421,153629,3538238,494481
300154406200,30-015-44062,MAD RIVER 13 STATE COM 005H,2021-11-01,41,1851,52910,6785,155480,3591148,501266
300154406200,30-015-44062,MAD RIVER 13 STATE COM 005H,2021-12-01,42,1723,65833,6791,157203,3656981,508057
300154406200,30-015-44062,MAD RIVER 13 STATE COM 005H,2022-01-01,43,1739,70113,6975,158942,3727094,515032
300154406200,30-015-44062,MAD RIVER 13 STATE COM 005H,2022-02-01,44,1577,55715,5840,160519,3782809,520872
300154406200,30-015-44062,MAD RIVER 13 STATE COM 005H,2022-03-01,45,1650,66553,6475,162169,3849362,527347
300154406200,30-015-44062,MAD RIVER 13 STATE COM 005H,2022-04-01,46,1340,59620,5544,163509,3908982,532891
300154406200,30-015-44062,MAD RIVER 13 STATE COM 005H,2022-05-01,47,1381,61468,6059,164890,3970450,538950
300154406200,30-015-44062,MAD RIVER 13 STATE COM 005H,2022-06-01,48,1323,57931,4766,166213,4028381,543716
300154406200,30-015-44062,MAD RIVER 13 STATE COM 005H,2022-07-01,49,1555,56124,6859,167768,4084505,550575
300154406200,30-015-44062,MAD RIVER 13 STATE COM 005H,2022-08-01,50,1412,53992,9276,169180,4138497,559851
300154406200,30-015-44062,MAD RIVER 13 STATE COM 005H,2022-09-01,51,1300,45069,7810,170480,4183566,567661
300154406200,30-015-44062,MAD RIVER 13 STATE COM 005H,2022-10-01,52,156,4293,5984,170636,4187859,573645
300154406200,30-015-44062,MAD RIVER 13 STATE COM 005H,2022-11-01,53,584,19701,17758,171220,4207560,591403
300154406200,30-015-44062,MAD RIVER 13 STATE COM 005H,2022-12-01,54,638,26378,17694,171858,4233938,609097
300154406200,30-015-44062,MAD RIVER 13 STATE COM 005H,2023-01-01,55,589,28749,15577,172447,4262687,624674
300154406200,30-015-44062,MAD RIVER 13 STATE COM 005H,2023-02-01,56,570,27170,11891,173017,4289857,636565
300154406200,30-015-44062,MAD RIVER 13 STATE COM 005H,2023-03-01,57,903,31932,10746,173920,4321789,647311
300154406200,30-015-44062,MAD RIVER 13 STATE COM 005H,2023-04-01,58,1110,31849,7506,175030,4353638,654817
300154406200,30-015-44062,MAD RIVER 13 STATE COM 005H,2023-05-01,59,1927,32637,6125,176957,4386275,660942
300154406200,30-015-44062,MAD RIVER 13 STATE COM 005H,2023-06-01,60,1557,34129,4625,178514,4420404,665567
300154617000,30-015-46170,WESTLOVING 11 12 W0GH FEDERAL COM 002H,2021-09-01,1,9099,20091,63419,9099,20091,63419
300154617000,30-015-46170,WESTLOVING 11 12 W0GH FEDERAL COM 002H,2021-10-01,2,18999,35762,83485,28098,55853,146904
300154617000,30-015-46170,WESTLOVING 11 12 W0GH FEDERAL COM 002H,2021-11-01,3,15901,33115,66032,43999,88968,212936
300154617000,30-015-46170,WESTLOVING 11 12 W0GH FEDERAL COM 002H,2021-12-01,4,14808,37102,61228,58807,126070,274164
300154617000,30-015-46170,WESTLOVING 11 12 W0GH FEDERAL COM 002H,2022-01-01,5,13635,41259,61733,72442,167329,335897
300154617000,30-015-46170,WESTLOVING 11 12 W0GH FEDERAL COM 002H,2022-02-01,6,11249,42787,52658,83691,210116,388555
300154617000,30-015-46170,WESTLOVING 11 12 W0GH FEDERAL COM 002H,2022-03-01,7,10463,48701,55610,94154,258817,444165
300154617000,30-015-46170,WESTLOVING 11 12 W0GH FEDERAL COM 002H,2022-04-01,8,9343,44632,50456,103497,303449,494621
300154617000,30-015-46170,WESTLOVING 11 12 W0GH FEDERAL COM 002H,2022-05-01,9,8482,43460,46018,111979,346909,540639
300154617000,30-015-46170,WESTLOVING 11 12 W0GH FEDERAL COM 002H,2022-06-01,10,7076,39670,44198,119055,386579,584837
300154617000,30-015-46170,WESTLOVING 11 12 W0GH FEDERAL COM 002H,2022-07-01,11,6885,31813,34212,125940,418392,619049
300154617000,30-015-46170,WESTLOVING 11 12 W0GH FEDERAL COM 002H,2022-08-01,12,6113,29081,32985,132053,447473,652034
300154617000,30-015-46170,WESTLOVING 11 12 W0GH FEDERAL COM 002H,2022-09-01,13,5423,32954,31460,137476,480427,683494
300154617000,30-015-46170,WESTLOVING 11 12 W0GH FEDERAL COM 002H,2022-10-01,14,4855,27701,27482,142331,508128,710976
300154617000,30-015-46170,WESTLOVING 11 12 W0GH FEDERAL COM 002H,2022-11-01,15,2627,12093,16615,144958,520221,727591
300154617000,30-015-46170,WESTLOVING 11 12 W0GH FEDERAL COM 002H,2022-12-01,16,3817,11559,21436,148775,531780,749027
300154617000,30-015-46170,WESTLOVING 11 12 W0GH FEDERAL COM 002H,2023-01-01,17,3442,13856,20448,152217,545636,769475
300154617000,30-015-46170,WESTLOVING 11 12 W0GH FEDERAL COM 002H,2023-02-01,18,2891,12994,16279,155108,558630,785754
300154617000,30-015-46170,WESTLOVING 11 12 W0GH FEDERAL COM 002H,2023-03-01,19,3557,14165,19385,158665,572795,805139
300154617000,30-015-46170,WESTLOVING 11 12 W0GH FEDERAL COM 002H,2023-04-01,20,3259,13805,18775,161924,586600,823914
300154617000,30-015-46170,WESTLOVING 11 12 W0GH FEDERAL COM 002H,2023-05-01,21,3372,17474,18491,165296,604074,842405
300154617000,30-015-46170,WESTLOVING 11 12 W0GH FEDERAL COM 002H,2023-06-01,22,1866,15548,11331,167162,619622,853736
300154617000,30-015-46170,WESTLOVING 11 12 W0GH FEDERAL COM 002H,2023-07-01,23,4637,35264,26138,171799,654886,879874
300154109001,30-015-41090,JOSEY WALES 16 STATE COM 003H,2013-08-01,1,2221,2686,25043,2221,2686,25043
300154109001,30-015-41090,JOSEY WALES 16 STATE COM 003H,2013-09-01,2,5495,17557,65211,7716,20243,90254
300154109001,30-015-41090,JOSEY WALES 16 STATE COM 003H,2013-10-01,3,3489,22418,49385,11205,42661,139639
300154109001,30-015-41090,JOSEY WALES 16 STATE COM 003H,2013-11-01,4,1951,16986,34595,13156,59647,174234
300154109001,30-015-41090,JOSEY WALES 16 STATE COM 003H,2013-12-01,5,1960,7008,20931,15116,66655,195165
300154109001,30-015-41090,JOSEY WALES 16 STATE COM 003H,2014-01-01,6,1720,6064,25622,16836,72719,220787
300154109001,30-015-41090,JOSEY WALES 16 STATE COM 003H,2014-02-01,7,1327,5110,23192,18163,77829,243979
300154109001,30-015-41090,JOSEY WALES 16 STATE COM 003H,2014-03-01,8,1213,1643,14736,19376,79472,258715
300154109001,30-015-41090,JOSEY WALES 16 STATE COM 003H,2014-04-01,9,1134,2482,15971,20510,81954,274686
300154109001,30-015-41090,JOSEY WALES 16 STATE COM 003H,2014-05-01,10,1001,1441,10640,21511,83395,285326
300154109001,30-015-41090,JOSEY WALES 16 STATE COM 003H,2014-06-01,11,455,347,6676,21966,83742,292002
300154109001,30-015-41090,JOSEY WALES 16 STATE COM 003H,2014-07-01,12,1045,578,11711,23011,84320,303713
300154109001,30-015-41090,JOSEY WALES 16 STATE COM 003H,2014-08-01,13,701,1370,10356,23712,85690,314069
300154109001,30-015-41090,JOSEY WALES 16 STATE COM 003H,2014-09-01,14,359,291,1875,24071,85981,315944
300154109001,30-015-41090,JOSEY WALES 16 STATE COM 003H,2014-10-01,15,995,387,8700,25066,86368,324644
300154109001,30-015-41090,JOSEY WALES 16 STATE COM 003H,2014-11-01,16,84,65,501,25150,86433,325145
300154109001,30-015-41090,JOSEY WALES 16 STATE COM 003H,2014-12-01,17,601,30,3695,25751,86463,328840
300154109001,30-015-41090,JOSEY WALES 16 STATE COM 003H,2015-01-01,18,904,31,6979,26655,86494,335819
300154109001,30-015-41090,JOSEY WALES 16 STATE COM 003H,2015-02-01,19,596,46,3898,27251,86540,339717
300154109001,30-015-41090,JOSEY WALES 16 STATE COM 003H,2015-03-01,20,702,58,4013,27953,86598,343730
300154109001,30-015-41090,JOSEY WALES 16 STATE COM 003H,2015-04-01,21,707,56,3885,28660,86654,347615
300154109001,30-015-41090,JOSEY WALES 16 STATE COM 003H,2015-05-01,22,488,40,2910,29148,86694,350525
300154109001,30-015-41090,JOSEY WALES 16 STATE COM 003H,2015-06-01,23,427,40,3109,29575,86734,353634
300154109001,30-015-41090,JOSEY WALES 16 STATE COM 003H,2015-07-01,24,487,52,3318,30062,86786,356952
300154109001,30-015-41090,JOSEY WALES 16 STATE COM 003H,2015-08-01,25,573,62,4343,30635,86848,361295
300154109001,30-015-41090,JOSEY WALES 16 STATE COM 003H,2015-09-01,26,557,58,4297,31192,86906,365592
300154109001,30-015-41090,JOSEY WALES 16 STATE COM 003H,2015-10-01,27,540,58,4699,31732,86964,370291
300154109001,30-015-41090,JOSEY WALES 16 STATE COM 003H,2015-11-01,28,547,60,4488,32279,87024,374779
300154109001,30-015-41090,JOSEY WALES 16 STATE COM 003H,2015-12-01,29,420,52,3955,32699,87076,378734
300154109001,30-015-41090,JOSEY WALES 16 STATE COM 003H,2016-01-01,30,535,56,4306,33234,87132,383040
300154109001,30-015-41090,JOSEY WALES 16 STATE COM 003H,2016-02-01,31,501,58,4351,33735,87190,387391
300154109001,30-015-41090,JOSEY WALES 16 STATE COM 003H,2016-03-01,32,457,60,4517,34192,87250,391908
300154109001,30-015-41090,JOSEY WALES 16 STATE COM 003H,2016-04-01,33,480,60,4585,34672,87310,396493
300154109001,30-015-41090,JOSEY WALES 16 STATE COM 003H,2016-05-01,34,466,60,4782,35138,87370,401275
300154109001,30-015-41090,JOSEY WALES 16 STATE COM 003H,2016-06-01,35,216,36,2327,35354,87406,403602
300154109001,30-015-41090,JOSEY WALES 16 STATE COM 003H,2016-07-01,36,34,4,367,35388,87410,403969
300154109001,30-015-41090,JOSEY WALES 16 STATE COM 003H,2016-08-01,37,160,613,1024,35548,88023,404993
300154109001,30-015-41090,JOSEY WALES 16 STATE COM 003H,2016-09-01,38,742,2599,4674,36290,90622,409667
300154109001,30-015-41090,JOSEY WALES 16 STATE COM 003H,2016-10-01,39,490,1940,4799,36780,92562,414466
300154109001,30-015-41090,JOSEY WALES 16 STATE COM 003H,2016-11-01,40,460,2005,4838,37240,94567,419304
300154109001,30-015-41090,JOSEY WALES 16 STATE COM 003H,2016-12-01,41,465,1833,4884,37705,96400,424188
300154109001,30-015-41090,JOSEY WALES 16 STATE COM 003H,2017-01-01,42,422,2005,4633,38127,98405,428821
300154109001,30-015-41090,JOSEY WALES 16 STATE COM 003H,2017-02-01,43,411,2216,4361,38538,100621,433182
300154109001,30-015-41090,JOSEY WALES 16 STATE COM 003H,2017-03-01,44,424,2444,4868,38962,103065,438050
300154109001,30-015-41090,JOSEY WALES 16 STATE COM 003H,2017-04-01,45,393,2394,4645,39355,105459,442695
300154109001,30-015-41090,JOSEY WALES 16 STATE COM 003H,2017-05-01,46,380,2283,4497,39735,107742,447192
300154109001,30-015-41090,JOSEY WALES 16 STATE COM 003H,2017-06-01,47,361,2614,4818,40096,110356,452010
300154109001,30-015-41090,JOSEY WALES 16 STATE COM 003H,2017-07-01,48,320,1665,4958,40416,112021,456968
300154109001,30-015-41090,JOSEY WALES 16 STATE COM 003H,2017-08-01,49,355,888,4186,40771,112909,461154
300154109001,30-015-41090,JOSEY WALES 16 STATE COM 003H,2017-09-01,50,256,179,2801,41027,113088,463955
300154109001,30-015-41090,JOSEY WALES 16 STATE COM 003H,2017-10-01,51,299,1246,3515,41326,114334,467470
300154109001,30-015-41090,JOSEY WALES 16 STATE COM 003H,2017-11-01,52,344,353,3282,41670,114687,470752
300154109001,30-015-41090,JOSEY WALES 16 STATE COM 003H,2017-12-01,53,394,631,4294,42064,115318,475046
300154109001,30-015-41090,JOSEY WALES 16 STATE COM 003H,2018-01-01,54,189,342,2361,42253,115660,477407
300154109001,30-015-41090,JOSEY WALES 16 STATE COM 003H,2018-02-01,55,0,0,0,42253,115660,477407
300154109001,30-015-41090,JOSEY WALES 16 STATE COM 003H,2018-03-01,56,327,1319,1212,42580,116979,478619
300154109001,30-015-41090,JOSEY WALES 16 STATE COM 003H,2018-04-01,57,347,990,2043,42927,117969,480662
300154109001,30-015-41090,JOSEY WALES 16 STATE COM 003H,2018-05-01,58,322,77,4037,43249,118046,484699
300154109001,30-015-41090,JOSEY WALES 16 STATE COM 003H,2018-06-01,59,86,12,226,43335,118058,484925
300154109001,30-015-41090,JOSEY WALES 16 STATE COM 003H,2018-07-01,60,0,0,0,43335,118058,484925
300154109001,30-015-41090,JOSEY WALES 16 STATE COM 003H,2018-08-01,61,2,46,0,43337,118104,484925
300154109001,30-015-41090,JOSEY WALES 16 STATE COM 003H,2018-09-01,62,0,60,0,43337,118164,484925
300154109001,30-015-41090,JOSEY WALES 16 STATE COM 003H,2018-10-01,63,163,70,0,43500,118234,484925
300154109001,30-015-41090,JOSEY WALES 16 STATE COM 003H,2018-11-01,64,53,534,0,43553,118768,484925
300154109001,30-015-41090,JOSEY WALES 16 STATE COM 003H,2018-12-01,65,245,62,0,43798,118830,484925
300154109001,30-015-41090,JOSEY WALES 16 STATE COM 003H,2019-01-01,66,0,20,951,43798,118850,485876
300154109001,30-015-41090,JOSEY WALES 16 STATE COM 003H,2019-02-01,67,118,158,86,43916,119008,485962
300154109001,30-015-41090,JOSEY WALES 16 STATE COM 003H,2019-03-01,68,82,0,0,43998,119008,485962
300154109001,30-015-41090,JOSEY WALES 16 STATE COM 003H,2019-04-01,69,2,0,0,44000,119008,485962
300154109001,30-015-41090,JOSEY WALES 16 STATE COM 003H,2019-05-01,70,564,992,2461,44564,120000,488423
300154109001,30-015-41090,JOSEY WALES 16 STATE COM 003H,2019-06-01,71,561,1652,3812,45125,121652,492235
300154109001,30-015-41090,JOSEY WALES 16 STATE COM 003H,2019-07-01,72,415,1901,3425,45540,123553,495660
300154109001,30-015-41090,JOSEY WALES 16 STATE COM 003H,2019-08-01,73,189,364,723,45729,123917,496383
300154109001,30-015-41090,JOSEY WALES 16 STATE COM 003H,2019-09-01,74,458,590,3670,46187,124507,500053
300154109001,30-015-41090,JOSEY WALES 16 STATE COM 003H,2019-10-01,75,323,264,3720,46510,124771,503773
300154109001,30-015-41090,JOSEY WALES 16 STATE COM 003H,2019-11-01,76,374,219,2040,46884,124990,505813
300154109001,30-015-41090,JOSEY WALES 16 STATE COM 003H,2019-12-01,77,98,300,896,46982,125290,506709
300154109001,30-015-41090,JOSEY WALES 16 STATE COM 003H,2020-01-01,78,2,231,0,46984,125521,506709
300154109001,30-015-41090,JOSEY WALES 16 STATE COM 003H,2020-02-01,79,0,604,0,46984,126125,506709
300154109001,30-015-41090,JOSEY WALES 16 STATE COM 003H,2020-03-01,80,0,741,0,46984,126866,506709
300154109001,30-015-41090,JOSEY WALES 16 STATE COM 003H,2020-04-01,81,0,132,0,46984,126998,506709
300154109001,30-015-41090,JOSEY WALES 16 STATE COM 003H,2020-05-01,82,0,0,0,46984,126998,506709
300154109001,30-015-41090,JOSEY WALES 16 STATE COM 003H,2020-06-01,83,395,2262,789,47379,129260,507498
300154109001,30-015-41090,JOSEY WALES 16 STATE COM 003H,2020-07-01,84,663,2406,5487,48042,131666,512985
300154109001,30-015-41090,JOSEY WALES 16 STATE COM 003H,2020-08-01,85,392,1913,3420,48434,133579,516405
300154109001,30-015-41090,JOSEY WALES 16 STATE COM 003H,2020-09-01,86,191,1316,951,48625,134895,517356
300154109001,30-015-41090,JOSEY WALES 16 STATE COM 003H,2020-10-01,87,85,848,20,48710,135743,517376
300154109001,30-015-41090,JOSEY WALES 16 STATE COM 003H,2020-11-01,88,252,687,0,48962,136430,517376
300154109001,30-015-41090,JOSEY WALES 16 STATE COM 003H,2020-12-01,89,890,3223,6310,49852,139653,523686
300154109001,30-015-41090,JOSEY WALES 16 STATE COM 003H,2021-01-01,90,334,3052,6250,50186,142705,529936
300154109001,30-015-41090,JOSEY WALES 16 STATE COM 003H,2021-02-01,91,456,3080,6834,50642,145785,536770
300154109001,30-015-41090,JOSEY WALES 16 STATE COM 003H,2021-03-01,92,427,3863,6979,51069,149648,543749
300154109001,30-015-41090,JOSEY WALES 16 STATE COM 003H,2021-04-01,93,214,2564,5248,51283,152212,548997
300154109001,30-015-41090,JOSEY WALES 16 STATE COM 003H,2021-05-01,94,363,2923,7090,51646,155135,556087
300154109001,30-015-41090,JOSEY WALES 16 STATE COM 003H,2021-06-01,95,323,3340,7349,51969,158475,563436
300154109001,30-015-41090,JOSEY WALES 16 STATE COM 003H,2021-07-01,96,337,3209,7039,52306,161684,570475
300154109001,30-015-41090,JOSEY WALES 16 STATE COM 003H,2021-08-01,97,276,3157,5822,52582,164841,576297
300154109001,30-015-41090,JOSEY WALES 16 STATE COM 003H,2021-09-01,98,314,3871,6940,52896,168712,583237
300154109001,30-015-41090,JOSEY WALES 16 STATE COM 003H,2021-10-01,99,279,4111,6991,53175,172823,590228
300154109001,30-015-41090,JOSEY WALES 16 STATE COM 003H,2021-11-01,100,252,3005,5950,53427,175828,596178
300154109001,30-015-41090,JOSEY WALES 16 STATE COM 003H,2021-12-01,101,279,3589,6384,53706,179417,602562
300154109001,30-015-41090,JOSEY WALES 16 STATE COM 003H,2022-01-01,102,226,3151,4485,53932,182568,607047
300154109001,30-015-41090,JOSEY WALES 16 STATE COM 003H,2022-02-01,103,244,2591,4674,54176,185159,611721
300154109001,30-015-41090,JOSEY WALES 16 STATE COM 003H,2022-03-01,104,252,2933,5822,54428,188092,617543
300154109001,30-015-41090,JOSEY WALES 16 STATE COM 003H,2022-04-01,105,171,2043,4712,54599,190135,622255
300154109001,30-015-41090,JOSEY WALES 16 STATE COM 003H,2022-05-01,106,0,0,0,54599,190135,622255
300154109001,30-015-41090,JOSEY WALES 16 STATE COM 003H,2022-06-01,107,83,1338,771,54682,191473,623026
300154109001,30-015-41090,JOSEY WALES 16 STATE COM 003H,2022-07-01,108,60,636,485,54742,192109,623511
300154109001,30-015-41090,JOSEY WALES 16 STATE COM 003H,2022-08-01,109,0,0,0,54742,192109,623511
300154109001,30-015-41090,JOSEY WALES 16 STATE COM 003H,2022-09-01,110,251,2687,2032,54993,194796,625543
300154109001,30-015-41090,JOSEY WALES 16 STATE COM 003H,2022-10-01,111,244,1639,3478,55237,196435,629021
300154109001,30-015-41090,JOSEY WALES 16 STATE COM 003H,2022-11-01,112,380,3871,6020,55617,200306,635041
300154109001,30-015-41090,JOSEY WALES 16 STATE COM 003H,2022-12-01,113,295,3186,5443,55912,203492,640484
300154109001,30-015-41090,JOSEY WALES 16 STATE COM 003H,2023-01-01,114,186,2108,3247,56098,205600,643731
300154109001,30-015-41090,JOSEY WALES 16 STATE COM 003H,2023-02-01,115,305,3063,4098,56403,208663,647829
300154109001,30-015-41090,JOSEY WALES 16 STATE COM 003H,2023-03-01,116,285,3449,5064,56688,212112,652893
300154109001,30-015-41090,JOSEY WALES 16 STATE COM 003H,2023-04-01,117,243,2850,3753,56931,214962,656646
300154109001,30-015-41090,JOSEY WALES 16 STATE COM 003H,2023-05-01,118,201,2247,3298,57132,217209,659944
300154109001,30-015-41090,JOSEY WALES 16 STATE COM 003H,2023-06-01,119,169,1934,3090,57301,219143,663034
300154109001,30-015-41090,JOSEY WALES 16 STATE COM 003H,2023-07-01,120,23,664,91,57324,219807,663125
300153824800,30-015-38248,TAOS FEDERAL 003,2011-08-01,1,183,74439,0,183,74439,0
300153824800,30-015-38248,TAOS FEDERAL 003,2011-09-01,2,1240,143953,15745,1423,218392,15745
300153824800,30-015-38248,TAOS FEDERAL 003,2011-10-01,3,621,103842,2717,2044,322234,18462
300153824800,30-015-38248,TAOS FEDERAL 003,2011-11-01,4,539,84566,3587,2583,406800,22049
300153824800,30-015-38248,TAOS FEDERAL 003,2011-12-01,5,515,64486,2189,3098,471286,24238
300153824800,30-015-38248,TAOS FEDERAL 003,2012-01-01,6,116,71531,994,3214,542817,25232
300153824800,30-015-38248,TAOS FEDERAL 003,2012-02-01,7,85,63097,2952,3299,605914,28184
300153824800,30-015-38248,TAOS FEDERAL 003,2012-03-01,8,560,60003,5953,3859,665917,34137
300153824800,30-015-38248,TAOS FEDERAL 003,2012-04-01,9,375,50518,5018,4234,716435,39155
300153824800,30-015-38248,TAOS FEDERAL 003,2012-05-01,10,456,49752,6435,4690,766187,45590
300153824800,30-015-38248,TAOS FEDERAL 003,2012-06-01,11,377,46664,5663,5067,812851,51253
300153824800,30-015-38248,TAOS FEDERAL 003,2012-07-01,12,298,43661,4839,5365,856512,56092
300153824800,30-015-38248,TAOS FEDERAL 003,2012-08-01,13,423,45149,4328,5788,901661,60420
300153824800,30-015-38248,TAOS FEDERAL 003,2012-09-01,14,308,36539,3287,6096,938200,63707
300153824800,30-015-38248,TAOS FEDERAL 003,2012-10-01,15,374,35826,4108,6470,974026,67815
300153824800,30-015-38248,TAOS FEDERAL 003,2012-11-01,16,154,22472,2943,6624,996498,70758
300153824800,30-015-38248,TAOS FEDERAL 003,2012-12-01,17,322,33989,4106,6946,1030487,74864
300153824800,30-015-38248,TAOS FEDERAL 003,2013-01-01,18,196,20260,2266,7142,1050747,77130
300153824800,30-015-38248,TAOS FEDERAL 003,2013-02-01,19,142,14464,2332,7284,1065211,79462
300153824800,30-015-38248,TAOS FEDERAL 003,2013-03-01,20,386,41874,5037,7670,1107085,84499
300153824800,30-015-38248,TAOS FEDERAL 003,2013-04-01,21,307,30583,3487,7977,1137668,87986
300153824800,30-015-38248,TAOS FEDERAL 003,2013-05-01,22,375,39633,4686,8352,1177301,92672
300153824800,30-015-38248,TAOS FEDERAL 003,2013-06-01,23,277,33862,3883,8629,1211163,96555
300153824800,30-015-38248,TAOS FEDERAL 003,2013-07-01,24,340,40871,5374,8969,1252034,101929
300153824800,30-015-38248,TAOS FEDERAL 003,2013-08-01,25,218,35182,4272,9187,1287216,106201
300153824800,30-015-38248,TAOS FEDERAL 003,2013-09-01,26,281,52295,5983,9468,1339511,112184
300153824800,30-015-38248,TAOS FEDERAL 003,2013-10-01,27,246,40792,5049,9714,1380303,117233
300153824800,30-015-38248,TAOS FEDERAL 003,2013-11-01,28,136,19428,2656,9850,1399731,119889
300153824800,30-015-38248,TAOS FEDERAL 003,2013-12-01,29,326,35228,5439,10176,1434959,125328
300153824800,30-015-38248,TAOS FEDERAL 003,2014-01-01,30,237,28914,4212,10413,1463873,129540
300153824800,30-015-38248,TAOS FEDERAL 003,2014-02-01,31,412,21631,3684,10825,1485504,133224
300153824800,30-015-38248,TAOS FEDERAL 003,2014-03-01,32,226,30670,3557,11051,1516174,136781
300153824800,30-015-38248,TAOS FEDERAL 003,2014-04-01,33,461,25827,4541,11512,1542001,141322
300153824800,30-015-38248,TAOS FEDERAL 003,2014-05-01,34,253,28668,4051,11765,1570669,145373
300153824800,30-015-38248,TAOS FEDERAL 003,2014-06-01,35,211,29108,3480,11976,1599777,148853
300153824800,30-015-38248,TAOS FEDERAL 003,2014-07-01,36,210,25714,3690,12186,1625491,152543
300153824800,30-015-38248,TAOS FEDERAL 003,2014-08-01,37,221,27530,3627,12407,1653021,156170
300153824800,30-015-38248,TAOS FEDERAL 003,2014-09-01,38,106,13719,1838,12513,1666740,158008
300153824800,30-015-38248,TAOS FEDERAL 003,2014-10-01,39,278,26681,4340,12791,1693421,162348
300153824800,30-015-38248,TAOS FEDERAL 003,2014-11-01,40,206,22412,3401,12997,1715833,165749
300153824800,30-015-38248,TAOS FEDERAL 003,2014-12-01,41,176,20867,3157,13173,1736700,168906
300153824800,30-015-38248,TAOS FEDERAL 003,2015-01-01,42,244,13710,2059,13417,1750410,170965
300153824800,30-015-38248,TAOS FEDERAL 003,2015-02-01,43,288,28835,2751,13705,1779245,173716
300153824800,30-015-38248,TAOS FEDERAL 003,2015-03-01,44,247,36186,3372,13952,1815431,177088
300153824800,30-015-38248,TAOS FEDERAL 003,2015-04-01,45,220,40631,3147,14172,1856062,180235
300153824800,30-015-38248,TAOS FEDERAL 003,2015-05-01,46,184,30988,2930,14356,1887050,183165
300153824800,30-015-38248,TAOS FEDERAL 003,2015-06-01,47,184,26398,2638,14540,1913448,185803
300153824800,30-015-38248,TAOS FEDERAL 003,2015-07-01,48,192,20940,1936,14732,1934388,187739
300153824800,30-015-38248,TAOS FEDERAL 003,2015-08-01,49,172,20541,2795,14904,1954929,190534
300153824800,30-015-38248,TAOS FEDERAL 003,2015-09-01,50,164,19255,2524,15068,1974184,193058
300153824800,30-015-38248,TAOS FEDERAL 003,2015-10-01,51,173,20909,2674,15241,1995093,195732
300153824800,30-015-38248,TAOS FEDERAL 003,2015-11-01,52,166,19427,2574,15407,2014520,198306
300153824800,30-015-38248,TAOS FEDERAL 003,2015-12-01,53,142,15234,2143,15549,2029754,200449
300153824800,30-015-38248,TAOS FEDERAL 003,2016-01-01,54,165,12935,1843,15714,2042689,202292
300153824800,30-015-38248,TAOS FEDERAL 003,2016-02-01,55,149,19516,2584,15863,2062205,204876
300153824800,30-015-38248,TAOS FEDERAL 003,2016-03-01,56,114,16634,2336,15977,2078839,207212
300153824800,30-015-38248,TAOS FEDERAL 003,2016-04-01,57,145,18432,2697,16122,2097271,209909
300153824800,30-015-38248,TAOS FEDERAL 003,2016-05-01,58,137,17984,2607,16259,2115255,212516
300153824800,30-015-38248,TAOS FEDERAL 003,2016-06-01,59,141,16183,2589,16400,2131438,215105
300153824800,30-015-38248,TAOS FEDERAL 003,2016-07-01,60,253,16980,2690,16653,2148418,217795
300153824800,30-015-38248,TAOS FEDERAL 003,2016-08-01,61,165,17501,2728,16818,2165919,220523
300153824800,30-015-38248,TAOS FEDERAL 003,2016-09-01,62,158,16142,2531,16976,2182061,223054
300153824800,30-015-38248,TAOS FEDERAL 003,2016-10-01,63,152,16231,2581,17128,2198292,225635
300153824800,30-015-38248,TAOS FEDERAL 003,2016-11-01,64,148,15304,2370,17276,2213596,228005
300153824800,30-015-38248,TAOS FEDERAL 003,2016-12-01,65,174,15380,2365,17450,2228976,230370
300153824800,30-015-38248,TAOS FEDERAL 003,2017-01-01,66,154,15478,2221,17604,2244454,232591
300153824800,30-015-38248,TAOS FEDERAL 003,2017-02-01,67,130,13336,1406,17734,2257790,233997
300153824800,30-015-38248,TAOS FEDERAL 003,2017-03-01,68,142,14824,1532,17876,2272614,235529
300153824800,30-015-38248,TAOS FEDERAL 003,2017-04-01,69,122,14354,1259,17998,2286968,236788
300153824800,30-015-38248,TAOS FEDERAL 003,2017-05-01,70,131,14752,1264,18129,2301720,238052
300153824800,30-015-38248,TAOS FEDERAL 003,2017-06-01,71,135,8654,976,18264,2310374,239028
300153824800,30-015-38248,TAOS FEDERAL 003,2017-07-01,72,118,14819,1260,18382,2325193,240288
300153824800,30-015-38248,TAOS FEDERAL 003,2017-08-01,73,135,15186,1456,18517,2340379,241744
300153824800,30-015-38248,TAOS FEDERAL 003,2017-09-01,74,123,13316,1243,18640,2353695,242987
300153824800,30-015-38248,TAOS FEDERAL 003,2017-10-01,75,152,15044,1492,18792,2368739,244479
300153824800,30-015-38248,TAOS FEDERAL 003,2017-11-01,76,131,13410,1566,18923,2382149,246045
300153824800,30-015-38248,TAOS FEDERAL 003,2017-12-01,77,145,13104,1627,19068,2395253,247672
300153824800,30-015-38248,TAOS FEDERAL 003,2018-01-01,78,143,12736,1607,19211,2407989,249279
300153824800,30-015-38248,TAOS FEDERAL 003,2018-02-01,79,123,8256,1116,19334,2416245,250395
300153824800,30-015-38248,TAOS FEDERAL 003,2018-03-01,80,130,13115,2239,19464,2429360,252634
300153824800,30-015-38248,TAOS FEDERAL 003,2018-04-01,81,134,13053,2003,19598,2442413,254637
300153824800,30-015-38248,TAOS FEDERAL 003,2018-05-01,82,128,12612,1755,19726,2455025,256392
300153824800,30-015-38248,TAOS FEDERAL 003,2018-06-01,83,117,11140,1320,19843,2466165,257712
300153824800,30-015-38248,TAOS FEDERAL 003,2018-07-01,84,122,13116,1973,19965,2479281,259685
300153824800,30-015-38248,TAOS FEDERAL 003,2018-08-01,85,127,12601,1664,20092,2491882,261349
300153824800,30-015-38248,TAOS FEDERAL 003,2018-09-01,86,114,11711,1603,20206,2503593,262952
300153824800,30-015-38248,TAOS FEDERAL 003,2018-10-01,87,56,11617,2289,20262,2515210,265241
300153824800,30-015-38248,TAOS FEDERAL 003,2018-11-01,88,107,6902,2035,20369,2522112,267276
300153824800,30-015-38248,TAOS FEDERAL 003,2018-12-01,89,70,12113,2554,20439,2534225,269830
300153824800,30-015-38248,TAOS FEDERAL 003,2019-01-01,90,73,7983,2564,20512,2542208,272394
300153824800,30-015-38248,TAOS FEDERAL 003,2019-02-01,91,127,10924,3010,20639,2553132,275404
300153824800,30-015-38248,TAOS FEDERAL 003,2019-03-01,92,104,7655,3308,20743,2560787,278712
300153824800,30-015-38248,TAOS FEDERAL 003,2019-04-01,93,127,12782,3186,20870,2573569,281898
300153824800,30-015-38248,TAOS FEDERAL 003,2019-05-01,94,83,12924,3251,20953,2586493,285149
300153824800,30-015-38248,TAOS FEDERAL 003,2019-06-01,95,88,9048,3263,21041,2595541,288412
300153824800,30-015-38248,TAOS FEDERAL 003,2019-07-01,96,98,14349,3092,21139,2609890,291504
300153824800,30-015-38248,TAOS FEDERAL 003,2019-08-01,97,87,11398,2896,21226,2621288,294400
300153824800,30-015-38248,TAOS FEDERAL 003,2019-09-01,98,21,8333,2555,21247,2629621,296955
300153824800,30-015-38248,TAOS FEDERAL 003,2019-10-01,99,2,7143,2383,21249,2636764,299338
300153824800,30-015-38248,TAOS FEDERAL 003,2019-11-01,100,2,8800,1795,21251,2645564,301133
300153824800,30-015-38248,TAOS FEDERAL 003,2019-12-01,101,1,9767,1923,21252,2655331,303056
300153824800,30-015-38248,TAOS FEDERAL 003,2020-01-01,102,0,9256,1944,21252,2664587,305000
300153824800,30-015-38248,TAOS FEDERAL 003,2020-02-01,103,0,6033,1210,21252,2670620,306210
300153824800,30-015-38248,TAOS FEDERAL 003,2020-03-01,104,0,7248,1089,21252,2677868,307299
300153824800,30-015-38248,TAOS FEDERAL 003,2020-04-01,105,0,0,0,21252,2677868,307299
300153824800,30-015-38248,TAOS FEDERAL 003,2020-05-01,106,0,0,0,21252,2677868,307299
300153824800,30-015-38248,TAOS FEDERAL 003,2020-06-01,107,0,4672,501,21252,2682540,307800
300153824800,30-015-38248,TAOS FEDERAL 003,2020-07-01,108,0,883,248,21252,2683423,308048
300153824800,30-015-38248,TAOS FEDERAL 003,2020-08-01,109,0,2450,200,21252,2685873,308248
300153824800,30-015-38248,TAOS FEDERAL 003,2020-09-01,110,69,5683,1595,21321,2691556,309843
300153824800,30-015-38248,TAOS FEDERAL 003,2020-10-01,111,56,8298,2241,21377,2699854,312084
300153824800,30-015-38248,TAOS FEDERAL 003,2020-11-01,112,8,7508,912,21385,2707362,312996
300153824800,30-015-38248,TAOS FEDERAL 003,2020-12-01,113,14,1603,284,21399,2708965,313280
300153824800,30-015-38248,TAOS FEDERAL 003,2021-01-01,114,4,11260,2887,21403,2720225,316167
300153824800,30-015-38248,TAOS FEDERAL 003,2021-02-01,115,12,6800,2258,21415,2727025,318425
300153824800,30-015-38248,TAOS FEDERAL 003,2021-03-01,116,9,9380,2424,21424,2736405,320849
300153824800,30-015-38248,TAOS FEDERAL 003,2021-04-01,117,6,9511,2170,21430,2745916,323019
300153824800,30-015-38248,TAOS FEDERAL 003,2021-05-01,118,3,9642,2147,21433,2755558,325166
300153824800,30-015-38248,TAOS FEDERAL 003,2021-06-01,119,2,8672,1391,21435,2764230,326557
300153824800,30-015-38248,TAOS FEDERAL 003,2021-07-01,120,0,9054,1871,21435,2773284,328428
300153824800,30-015-38248,TAOS FEDERAL 003,2021-08-01,121,0,8795,1805,21435,2782079,330233
300153824800,30-015-38248,TAOS FEDERAL 003,2021-09-01,122,6,4943,1367,21441,2787022,331600
300153824800,30-015-38248,TAOS FEDERAL 003,2021-10-01,123,5,8687,1522,21446,2795709,333122
300153824800,30-015-38248,TAOS FEDERAL 003,2021-11-01,124,5,9038,2111,21451,2804747,335233
300153824800,30-015-38248,TAOS FEDERAL 003,2021-12-01,125,0,9118,2195,21451,2813865,337428
300153824800,30-015-38248,TAOS FEDERAL 003,2022-01-01,126,0,7499,1876,21451,2821364,339304
300153824800,30-015-38248,TAOS FEDERAL 003,2022-02-01,127,1,7411,2106,21452,2828775,341410
300153824800,30-015-38248,TAOS FEDERAL 003,2022-03-01,128,0,7678,2079,21452,2836453,343489
300153824800,30-015-38248,TAOS FEDERAL 003,2022-04-01,129,4,7751,2240,21456,2844204,345729
300153824800,30-015-38248,TAOS FEDERAL 003,2022-05-01,130,9,7861,2547,21465,2852065,348276
300153824800,30-015-38248,TAOS FEDERAL 003,2022-06-01,131,0,9405,3009,21465,2861470,351285
300153824800,30-015-38248,TAOS FEDERAL 003,2022-07-01,132,5,7947,3036,21470,2869417,354321
300153824800,30-015-38248,TAOS FEDERAL 003,2022-08-01,133,0,8961,2969,21470,2878378,357290
300153824800,30-015-38248,TAOS FEDERAL 003,2022-09-01,134,0,7277,2908,21470,2885655,360198
300153824800,30-015-38248,TAOS FEDERAL 003,2022-10-01,135,0,9355,1501,21470,2895010,361699
300153824800,30-015-38248,TAOS FEDERAL 003,2022-11-01,136,0,8386,1736,21470,2903396,363435
300153824800,30-015-38248,TAOS FEDERAL 003,2022-12-01,137,0,7214,1683,21470,2910610,365118
300153824800,30-015-38248,TAOS FEDERAL 003,2023-01-01,138,0,8131,1770,21470,2918741,366888
300153824800,30-015-38248,TAOS FEDERAL 003,2023-02-01,139,2,7662,1362,21472,2926403,368250
300153824800,30-015-38248,TAOS FEDERAL 003,2023-03-01,140,1,7766,1304,21473,2934169,369554
300153824800,30-015-38248,TAOS FEDERAL 003,2023-04-01,141,2,3950,1180,21475,2938119,370734
300153824800,30-015-38248,TAOS FEDERAL 003,2023-05-01,142,2,7236,1677,21477,2945355,372411
300153824800,30-015-38248,TAOS FEDERAL 003,2023-06-01,143,3,4217,1261,21480,2949572,373672
300154407700,30-015-44077,MAD RIVER 13 STATE COM 006H,2017-05-01,1,9847,80144,53086,9847,80144,53086
300154407700,30-015-44077,MAD RIVER 13 STATE COM 006H,2017-06-01,2,13453,114949,53058,23300,195093,106144
300154407700,30-015-44077,MAD RIVER 13 STATE COM 006H,2017-07-01,3,11362,109272,40252,34662,304365,146396
300154407700,30-015-44077,MAD RIVER 13 STATE COM 006H,2017-08-01,4,10052,95141,33398,44714,399506,179794
300154407700,30-015-44077,MAD RIVER 13 STATE COM 006H,2017-09-01,5,8684,83145,28289,53398,482651,208083
300154407700,30-015-44077,MAD RIVER 13 STATE COM 006H,2017-10-01,6,8082,80288,23565,61480,562939,231648
300154407700,30-015-44077,MAD RIVER 13 STATE COM 006H,2017-11-01,7,7305,78596,21625,68785,641535,253273
300154407700,30-015-44077,MAD RIVER 13 STATE COM 006H,2017-12-01,8,7033,88627,19531,75818,730162,272804
300154407700,30-015-44077,MAD RIVER 13 STATE COM 006H,2018-01-01,9,6286,69018,18983,82104,799180,291787
300154407700,30-015-44077,MAD RIVER 13 STATE COM 006H,2018-02-01,10,5139,61821,14139,87243,861001,305926
300154407700,30-015-44077,MAD RIVER 13 STATE COM 006H,2018-03-01,11,6091,75916,17254,93334,936917,323180
300154407700,30-015-44077,MAD RIVER 13 STATE COM 006H,2018-04-01,12,4995,64580,15534,98329,1001497,338714
300154407700,30-015-44077,MAD RIVER 13 STATE COM 006H,2018-05-01,13,5100,60484,14898,103429,1061981,353612
300154407700,30-015-44077,MAD RIVER 13 STATE COM 006H,2018-06-01,14,4325,54107,13281,107754,1116088,366893
300154407700,30-015-44077,MAD RIVER 13 STATE COM 006H,2018-07-01,15,3783,45498,10546,111537,1161586,377439
300154407700,30-015-44077,MAD RIVER 13 STATE COM 006H,2018-08-01,16,3609,44880,11252,115146,1206466,388691
300154407700,30-015-44077,MAD RIVER 13 STATE COM 006H,2018-09-01,17,3400,40215,9143,118546,1246681,397834
300154407700,30-015-44077,MAD RIVER 13 STATE COM 006H,2018-10-01,18,3475,39710,9349,122021,1286391,407183
300154407700,30-015-44077,MAD RIVER 13 STATE COM 006H,2018-11-01,19,3289,35727,7011,125310,1322118,414194
300154407700,30-015-44077,MAD RIVER 13 STATE COM 006H,2018-12-01,20,3363,36522,8102,128673,1358640,422296
300154407700,30-015-44077,MAD RIVER 13 STATE COM 006H,2019-01-01,21,3189,33173,9667,131862,1391813,431963
300154407700,30-015-44077,MAD RIVER 13 STATE COM 006H,2019-02-01,22,2772,28890,6680,134634,1420703,438643
300154407700,30-015-44077,MAD RIVER 13 STATE COM 006H,2019-03-01,23,2988,30723,8549,137622,1451426,447192
300154407700,30-015-44077,MAD RIVER 13 STATE COM 006H,2019-04-01,24,2842,30089,8038,140464,1481515,455230
300154407700,30-015-44077,MAD RIVER 13 STATE COM 006H,2019-05-01,25,2428,29742,8618,142892,1511257,463848
300154407700,30-015-44077,MAD RIVER 13 STATE COM 006H,2019-06-01,26,2960,29618,9245,145852,1540875,473093
300154407700,30-015-44077,MAD RIVER 13 STATE COM 006H,2019-07-01,27,2558,30467,8026,148410,1571342,481119
300154407700,30-015-44077,MAD RIVER 13 STATE COM 006H,2019-08-01,28,2480,30586,4660,150890,1601928,485779
300154407700,30-015-44077,MAD RIVER 13 STATE COM 006H,2019-09-01,29,2447,28969,7756,153337,1630897,493535
300154407700,30-015-44077,MAD RIVER 13 STATE COM 006H,2019-10-01,30,2511,29727,9189,155848,1660624,502724
300154407700,30-015-44077,MAD RIVER 13 STATE COM 006H,2019-11-01,31,1646,24150,4385,157494,1684774,507109
300154407700,30-015-44077,MAD RIVER 13 STATE COM 006H,2019-12-01,32,2397,31214,6992,159891,1715988,514101
300154407700,30-015-44077,MAD RIVER 13 STATE COM 006H,2020-01-01,33,2430,28886,3886,162321,1744874,517987
300154407700,30-015-44077,MAD RIVER 13 STATE COM 006H,2020-02-01,34,2081,27849,3419,164402,1772723,521406
300154407700,30-015-44077,MAD RIVER 13 STATE COM 006H,2020-03-01,35,2239,29318,5098,166641,1802041,526504
300154407700,30-015-44077,MAD RIVER 13 STATE COM 006H,2020-04-01,36,42,0,1,166683,1802041,526505
300154407700,30-015-44077,MAD RIVER 13 STATE COM 006H,2020-05-01,37,0,0,0,166683,1802041,526505
300154407700,30-015-44077,MAD RIVER 13 STATE COM 006H,2020-06-01,38,3542,35690,9496,170225,1837731,536001
300154407700,30-015-44077,MAD RIVER 13 STATE COM 006H,2020-07-01,39,2472,25656,10158,172697,1863387,546159
300154407700,30-015-44077,MAD RIVER 13 STATE COM 006H,2020-08-01,40,2224,23464,8354,174921,1886851,554513
300154407700,30-015-44077,MAD RIVER 13 STATE COM 006H,2020-09-01,41,2076,24208,9154,176997,1911059,563667
300154407700,30-015-44077,MAD RIVER 13 STATE COM 006H,2020-10-01,42,2091,26643,10070,179088,1937702,573737
300154407700,30-015-44077,MAD RIVER 13 STATE COM 006H,2020-11-01,43,2465,25508,10898,181553,1963210,584635
300154407700,30-015-44077,MAD RIVER 13 STATE COM 006H,2020-12-01,44,1841,24117,8443,183394,1987327,593078
300154407700,30-015-44077,MAD RIVER 13 STATE COM 006H,2021-01-01,45,2105,30738,9549,185499,2018065,602627
300154407700,30-015-44077,MAD RIVER 13 STATE COM 006H,2021-02-01,46,1722,26577,7987,187221,2044642,610614
300154407700,30-015-44077,MAD RIVER 13 STATE COM 006H,2021-03-01,47,2181,31984,10123,189402,2076626,620737
300154407700,30-015-44077,MAD RIVER 13 STATE COM 006H,2021-04-01,48,1836,31356,7990,191238,2107982,628727
300154407700,30-015-44077,MAD RIVER 13 STATE COM 006H,2021-05-01,49,2156,35575,9724,193394,2143557,638451
300154407700,30-015-44077,MAD RIVER 13 STATE COM 006H,2021-06-01,50,1926,31909,8379,195320,2175466,646830
300154407700,30-015-44077,MAD RIVER 13 STATE COM 006H,2021-07-01,51,1969,36185,8482,197289,2211651,655312
300154407700,30-015-44077,MAD RIVER 13 STATE COM 006H,2021-08-01,52,1962,39136,7699,199251,2250787,663011
300154407700,30-015-44077,MAD RIVER 13 STATE COM 006H,2021-09-01,53,1674,30820,6829,200925,2281607,669840
300154407700,30-015-44077,MAD RIVER 13 STATE COM 006H,2021-10-01,54,1710,31956,7717,202635,2313563,677557
300154407700,30-015-44077,MAD RIVER 13 STATE COM 006H,2021-11-01,55,1409,22449,6580,204044,2336012,684137
300154407700,30-015-44077,MAD RIVER 13 STATE COM 006H,2021-12-01,56,1426,25578,6501,205470,2361590,690638
300154407700,30-015-44077,MAD RIVER 13 STATE COM 006H,2022-01-01,57,1259,20888,5774,206729,2382478,696412
300154407700,30-015-44077,MAD RIVER 13 STATE COM 006H,2022-02-01,58,1232,18265,4863,207961,2400743,701275
300154407700,30-015-44077,MAD RIVER 13 STATE COM 006H,2022-03-01,59,1439,20221,5639,209400,2420964,706914
300154407700,30-015-44077,MAD RIVER 13 STATE COM 006H,2022-04-01,60,1277,21174,4600,210677,2442138,711514
300154407700,30-015-44077,MAD RIVER 13 STATE COM 006H,2022-05-01,61,1234,19636,4275,211911,2461774,715789
300154407700,30-015-44077,MAD RIVER 13 STATE COM 006H,2022-06-01,62,1339,21084,5362,213250,2482858,721151
300154407700,30-015-44077,MAD RIVER 13 STATE COM 006H,2022-07-01,63,1048,22268,3594,214298,2505126,724745
300154407700,30-015-44077,MAD RIVER 13 STATE COM 006H,2022-08-01,64,1301,23847,4057,215599,2528973,728802
300154407700,30-015-44077,MAD RIVER 13 STATE COM 006H,2022-09-01,65,693,11655,2184,216292,2540628,730986
300154407700,30-015-44077,MAD RIVER 13 STATE COM 006H,2022-10-01,66,374,3728,139,216666,2544356,731125
300154407700,30-015-44077,MAD RIVER 13 STATE COM 006H,2022-11-01,67,1570,23203,1284,218236,2567559,732409
300154407700,30-015-44077,MAD RIVER 13 STATE COM 006H,2022-12-01,68,1229,15634,8155,219465,2583193,740564
300154407700,30-015-44077,MAD RIVER 13 STATE COM 006H,2023-01-01,69,1129,12857,7563,220594,2596050,748127
300154407700,30-015-44077,MAD RIVER 13 STATE COM 006H,2023-02-01,70,983,9559,5633,221577,2605609,753760
300154407700,30-015-44077,MAD RIVER 13 STATE COM 006H,2023-03-01,71,1143,12340,5478,222720,2617949,759238
300154407700,30-015-44077,MAD RIVER 13 STATE COM 006H,2023-04-01,72,1159,12069,5676,223879,2630018,764914
300154407700,30-015-44077,MAD RIVER 13 STATE COM 006H,2023-05-01,73,1142,9547,4358,225021,2639565,769272
300154407700,30-015-44077,MAD RIVER 13 STATE COM 006H,2023-06-01,74,959,11401,4431,225980,2650966,773703
300154062200,30-015-40622,MUNNYNTHABANK STATE 002H,2013-04-01,1,1412,2275,3674,1412,2275,3674
300154062200,30-015-40622,MUNNYNTHABANK STATE 002H,2013-05-01,2,8066,14400,44871,9478,16675,48545
300154062200,30-015-40622,MUNNYNTHABANK STATE 002H,2013-06-01,3,4555,19537,35059,14033,36212,83604
300154062200,30-015-40622,MUNNYNTHABANK STATE 002H,2013-07-01,4,3311,16146,23254,17344,52358,106858
300154062200,30-015-40622,MUNNYNTHABANK STATE 002H,2013-08-01,5,2703,15398,19886,20047,67756,126744
300154062200,30-015-40622,MUNNYNTHABANK STATE 002H,2013-09-01,6,2217,10193,14766,22264,77949,141510
300154062200,30-015-40622,MUNNYNTHABANK STATE 002H,2013-10-01,7,1935,9669,12814,24199,87618,154324
300154062200,30-015-40622,MUNNYNTHABANK STATE 002H,2013-11-01,8,1479,7353,9812,25678,94971,164136
300154062200,30-015-40622,MUNNYNTHABANK STATE 002H,2013-12-01,9,1344,7921,8213,27022,102892,172349
300154062200,30-015-40622,MUNNYNTHABANK STATE 002H,2014-01-01,10,1689,4757,8545,28711,107649,180894
300154062200,30-015-40622,MUNNYNTHABANK STATE 002H,2014-02-01,11,1435,5110,8776,30146,112759,189670
300154062200,30-015-40622,MUNNYNTHABANK STATE 002H,2014-03-01,12,1436,7409,10395,31582,120168,200065
300154062200,30-015-40622,MUNNYNTHABANK STATE 002H,2014-04-01,13,1277,6886,8010,32859,127054,208075
300154062200,30-015-40622,MUNNYNTHABANK STATE 002H,2014-05-01,14,1236,6588,8253,34095,133642,216328
300154062200,30-015-40622,MUNNYNTHABANK STATE 002H,2014-06-01,15,170,972,981,34265,134614,217309
300154062200,30-015-40622,MUNNYNTHABANK STATE 002H,2014-07-01,16,842,3094,1979,35107,137708,219288
300154062200,30-015-40622,MUNNYNTHABANK STATE 002H,2014-08-01,17,786,2357,2634,35893,140065,221922
300154062200,30-015-40622,MUNNYNTHABANK STATE 002H,2014-09-01,18,561,1911,1647,36454,141976,223569
300154062200,30-015-40622,MUNNYNTHABANK STATE 002H,2014-10-01,19,490,1037,1420,36944,143013,224989
300154062200,30-015-40622,MUNNYNTHABANK STATE 002H,2014-11-01,20,735,1805,2414,37679,144818,227403
300154062200,30-015-40622,MUNNYNTHABANK STATE 002H,2014-12-01,21,623,1046,2388,38302,145864,229791
300154062200,30-015-40622,MUNNYNTHABANK STATE 002H,2015-01-01,22,676,929,2856,38978,146793,232647
300154062200,30-015-40622,MUNNYNTHABANK STATE 002H,2015-02-01,23,561,640,2763,39539,147433,235410
300154062200,30-015-40622,MUNNYNTHABANK STATE 002H,2015-03-01,24,508,290,1607,40047,147723,237017
300154062200,30-015-40622,MUNNYNTHABANK STATE 002H,2015-04-01,25,564,57,1605,40611,147780,238622
300154062200,30-015-40622,MUNNYNTHABANK STATE 002H,2015-05-01,26,338,358,1619,40949,148138,240241
300154062200,30-015-40622,MUNNYNTHABANK STATE 002H,2015-06-01,27,838,7,2803,41787,148145,243044
300154062200,30-015-40622,MUNNYNTHABANK STATE 002H,2015-07-01,28,794,306,3974,42581,148451,247018
300154062200,30-015-40622,MUNNYNTHABANK STATE 002H,2015-08-01,29,702,854,3708,43283,149305,250726
300154062200,30-015-40622,MUNNYNTHABANK STATE 002H,2015-09-01,30,556,922,3185,43839,150227,253911
300154062200,30-015-40622,MUNNYNTHABANK STATE 002H,2015-10-01,31,780,2174,4117,44619,152401,258028
300154062200,30-015-40622,MUNNYNTHABANK STATE 002H,2015-11-01,32,709,2078,3890,45328,154479,261918
300154062200,30-015-40622,MUNNYNTHABANK STATE 002H,2015-12-01,33,572,2010,2963,45900,156489,264881
300154062200,30-015-40622,MUNNYNTHABANK STATE 002H,2016-01-01,34,667,2016,2994,46567,158505,267875
300154062200,30-015-40622,MUNNYNTHABANK STATE 002H,2016-02-01,35,639,2436,2976,47206,160941,270851
300154062200,30-015-40622,MUNNYNTHABANK STATE 002H,2016-03-01,36,635,2688,3164,47841,163629,274015
300154062200,30-015-40622,MUNNYNTHABANK STATE 002H,2016-04-01,37,573,2786,3087,48414,166415,277102
300154062200,30-015-40622,MUNNYNTHABANK STATE 002H,2016-05-01,38,622,3020,3168,49036,169435,280270
300154062200,30-015-40622,MUNNYNTHABANK STATE 002H,2016-06-01,39,531,2951,2702,49567,172386,282972
300154062200,30-015-40622,MUNNYNTHABANK STATE 002H,2016-07-01,40,606,2492,3320,50173,174878,286292
300154062200,30-015-40622,MUNNYNTHABANK STATE 002H,2016-08-01,41,578,2303,3172,50751,177181,289464
300154062200,30-015-40622,MUNNYNTHABANK STATE 002H,2016-09-01,42,550,2672,3234,51301,179853,292698
300154062200,30-015-40622,MUNNYNTHABANK STATE 002H,2016-10-01,43,583,2780,3528,51884,182633,296226
300154062200,30-015-40622,MUNNYNTHABANK STATE 002H,2016-11-01,44,130,944,1003,52014,183577,297229
300154062200,30-015-40622,MUNNYNTHABANK STATE 002H,2016-12-01,45,492,2142,1330,52506,185719,298559
300154062200,30-015-40622,MUNNYNTHABANK STATE 002H,2017-01-01,46,624,2391,2803,53130,188110,301362
300154062200,30-015-40622,MUNNYNTHABANK STATE 002H,2017-02-01,47,342,1564,1613,53472,189674,302975
300154062200,30-015-40622,MUNNYNTHABANK STATE 002H,2017-03-01,48,545,2438,3404,54017,192112,306379
300154062200,30-015-40622,MUNNYNTHABANK STATE 002H,2017-04-01,49,600,2616,3762,54617,194728,310141
300154062200,30-015-40622,MUNNYNTHABANK STATE 002H,2017-05-01,50,571,2194,3666,55188,196922,313807
300154062200,30-015-40622,MUNNYNTHABANK STATE 002H,2017-06-01,51,357,733,2513,55545,197655,316320
300154062200,30-015-40622,MUNNYNTHABANK STATE 002H,2017-07-01,52,374,1546,1847,55919,199201,318167
300154062200,30-015-40622,MUNNYNTHABANK STATE 002H,2017-08-01,53,523,2888,3257,56442,202089,321424
300154062200,30-015-40622,MUNNYNTHABANK STATE 002H,2017-09-01,54,362,2192,1583,56804,204281,323007
300154062200,30-015-40622,MUNNYNTHABANK STATE 002H,2017-10-01,55,553,3181,3602,57357,207462,326609
300154062200,30-015-40622,MUNNYNTHABANK STATE 002H,2017-11-01,56,413,2644,2653,57770,210106,329262
300154062200,30-015-40622,MUNNYNTHABANK STATE 002H,2017-12-01,57,415,2766,2739,58185,212872,332001
300154062200,30-015-40622,MUNNYNTHABANK STATE 002H,2018-01-01,58,422,2492,2938,58607,215364,334939
300154062200,30-015-40622,MUNNYNTHABANK STATE 002H,2018-02-01,59,430,2721,2895,59037,218085,337834
300154062200,30-015-40622,MUNNYNTHABANK STATE 002H,2018-03-01,60,441,3159,3842,59478,221244,341676
300154062200,30-015-40622,MUNNYNTHABANK STATE 002H,2018-04-01,61,553,1992,3940,60031,223236,345616
300154062200,30-015-40622,MUNNYNTHABANK STATE 002H,2018-05-01,62,330,2306,2067,60361,225542,347683
300154062200,30-015-40622,MUNNYNTHABANK STATE 002H,2018-06-01,63,322,2788,1829,60683,228330,349512
300154062200,30-015-40622,MUNNYNTHABANK STATE 002H,2018-07-01,64,368,3105,2725,61051,231435,352237
300154062200,30-015-40622,MUNNYNTHABANK STATE 002H,2018-08-01,65,390,3298,3614,61441,234733,355851
300154062200,30-015-40622,MUNNYNTHABANK STATE 002H,2018-09-01,66,480,3862,4228,61921,238595,360079
300154062200,30-015-40622,MUNNYNTHABANK STATE 002H,2018-10-01,67,424,3968,4470,62345,242563,364549
300154062200,30-015-40622,MUNNYNTHABANK STATE 002H,2018-11-01,68,392,4049,3991,62737,246612,368540
300154062200,30-015-40622,MUNNYNTHABANK STATE 002H,2018-12-01,69,444,4149,4291,63181,250761,372831
300154062200,30-015-40622,MUNNYNTHABANK STATE 002H,2019-01-01,70,371,4168,3834,63552,254929,376665
300154062200,30-015-40622,MUNNYNTHABANK STATE 002H,2019-02-01,71,348,3509,2824,63900,258438,379489
300154062200,30-015-40622,MUNNYNTHABANK STATE 002H,2019-03-01,72,400,3808,3590,64300,262246,383079
300154062200,30-015-40622,MUNNYNTHABANK STATE 002H,2019-04-01,73,338,3578,3599,64638,265824,386678
300154062200,30-015-40622,MUNNYNTHABANK STATE 002H,2019-05-01,74,294,3166,3540,64932,268990,390218
300154062200,30-015-40622,MUNNYNTHABANK STATE 002H,2019-06-01,75,119,1086,1417,65051,270076,391635
300154062200,30-015-40622,MUNNYNTHABANK STATE 002H,2019-07-01,76,287,2814,2259,65338,272890,393894
300154062200,30-015-40622,MUNNYNTHABANK STATE 002H,2019-08-01,77,524,4307,5320,65862,277197,399214
300154062200,30-015-40622,MUNNYNTHABANK STATE 002H,2019-09-01,78,304,3663,3906,66166,280860,403120
300154062200,30-015-40622,MUNNYNTHABANK STATE 002H,2019-10-01,79,319,3360,3156,66485,284220,406276
300154062200,30-015-40622,MUNNYNTHABANK STATE 002H,2019-11-01,80,374,3723,3777,66859,287943,410053
300154062200,30-015-40622,MUNNYNTHABANK STATE 002H,2019-12-01,81,307,3560,3157,67166,291503,413210
300154062200,30-015-40622,MUNNYNTHABANK STATE 002H,2020-01-01,82,223,2805,2068,67389,294308,415278
300154062200,30-015-40622,MUNNYNTHABANK STATE 002H,2020-02-01,83,214,2308,1564,67603,296616,416842
300154062200,30-015-40622,MUNNYNTHABANK STATE 002H,2020-03-01,84,195,2376,1704,67798,298992,418546
300154062200,30-015-40622,MUNNYNTHABANK STATE 002H,2020-04-01,85,361,2988,2931,68159,301980,421477
300154062200,30-015-40622,MUNNYNTHABANK STATE 002H,2020-05-01,86,333,3115,3435,68492,305095,424912
300154062200,30-015-40622,MUNNYNTHABANK STATE 002H,2020-06-01,87,49,123,467,68541,305218,425379
300154062200,30-015-40622,MUNNYNTHABANK STATE 002H,2020-07-01,88,227,2314,1621,68768,307532,427000
300154062200,30-015-40622,MUNNYNTHABANK STATE 002H,2020-08-01,89,254,0,608,69022,307532,427608
300154062200,30-015-40622,MUNNYNTHABANK STATE 002H,2020-09-01,90,342,2685,2808,69364,310217,430416
300154062200,30-015-40622,MUNNYNTHABANK STATE 002H,2020-10-01,91,366,2806,2955,69730,313023,433371
300154062200,30-015-40622,MUNNYNTHABANK STATE 002H,2020-11-01,92,357,2865,2741,70087,315888,436112
300154062200,30-015-40622,MUNNYNTHABANK STATE 002H,2020-12-01,93,336,2950,2891,70423,318838,439003
300154062200,30-015-40622,MUNNYNTHABANK STATE 002H,2021-01-01,94,330,2920,3162,70753,321758,442165
300154062200,30-015-40622,MUNNYNTHABANK STATE 002H,2021-02-01,95,256,2683,2650,71009,324441,444815
300154062200,30-015-40622,MUNNYNTHABANK STATE 002H,2021-03-01,96,329,3176,3204,71338,327617,448019
300154062200,30-015-40622,MUNNYNTHABANK STATE 002H,2021-04-01,97,310,3186,3023,71648,330803,451042
300154062200,30-015-40622,MUNNYNTHABANK STATE 002H,2021-05-01,98,230,2880,2470,71878,333683,453512
300154062200,30-015-40622,MUNNYNTHABANK STATE 002H,2021-06-01,99,223,2754,2748,72101,336437,456260
300154062200,30-015-40622,MUNNYNTHABANK STATE 002H,2021-07-01,100,250,3163,3085,72351,339600,459345
300154062200,30-015-40622,MUNNYNTHABANK STATE 002H,2021-08-01,101,324,3175,2970,72675,342775,462315
300154062200,30-015-40622,MUNNYNTHABANK STATE 002H,2021-09-01,102,247,2963,2804,72922,345738,465119
300154062200,30-015-40622,MUNNYNTHABANK STATE 002H,2021-10-01,103,273,3332,3167,73195,349070,468286
300154062200,30-015-40622,MUNNYNTHABANK STATE 002H,2021-11-01,104,252,3192,2937,73447,352262,471223
300154062200,30-015-40622,MUNNYNTHABANK STATE 002H,2021-12-01,105,273,3523,3197,73720,355785,474420
300154062200,30-015-40622,MUNNYNTHABANK STATE 002H,2022-01-01,106,223,3089,2775,73943,358874,477195
300154062200,30-015-40622,MUNNYNTHABANK STATE 002H,2022-02-01,107,205,2786,2329,74148,361660,479524
300154062200,30-015-40622,MUNNYNTHABANK STATE 002H,2022-03-01,108,293,3504,3139,74441,365164,482663
300154062200,30-015-40622,MUNNYNTHABANK STATE 002H,2022-04-01,109,211,2918,2592,74652,368082,485255
300154062200,30-015-40622,MUNNYNTHABANK STATE 002H,2022-05-01,110,214,3048,1977,74866,371130,487232
300154062200,30-015-40622,MUNNYNTHABANK STATE 002H,2022-06-01,111,253,3099,2669,75119,374229,489901
300154062200,30-015-40622,MUNNYNTHABANK STATE 002H,2022-07-01,112,244,3333,2841,75363,377562,492742
300154062200,30-015-40622,MUNNYNTHABANK STATE 002H,2022-08-01,113,258,3437,2663,75621,380999,495405
300154062200,30-015-40622,MUNNYNTHABANK STATE 002H,2022-09-01,114,216,3148,2399,75837,384147,497804
300154062200,30-015-40622,MUNNYNTHABANK STATE 002H,2022-10-01,115,249,3228,2422,76086,387375,500226
300154062200,30-015-40622,MUNNYNTHABANK STATE 002H,2022-11-01,116,237,3131,2513,76323,390506,502739
300154062200,30-015-40622,MUNNYNTHABANK STATE 002H,2022-12-01,117,198,2827,2037,76521,393333,504776
300154062200,30-015-40622,MUNNYNTHABANK STATE 002H,2023-01-01,118,227,3029,2259,76748,396362,507035
300154062200,30-015-40622,MUNNYNTHABANK STATE 002H,2023-02-01,119,246,2735,2223,76994,399097,509258
300154062200,30-015-40622,MUNNYNTHABANK STATE 002H,2023-03-01,120,248,3007,2614,77242,402104,511872
300154062200,30-015-40622,MUNNYNTHABANK STATE 002H,2023-04-01,121,200,2582,2496,77442,404686,514368
300154062200,30-015-40622,MUNNYNTHABANK STATE 002H,2023-05-01,122,109,1567,782,77551,406253,515150
300154062200,30-015-40622,MUNNYNTHABANK STATE 002H,2023-06-01,123,81,1215,503,77632,407468,515653
300154062200,30-015-40622,MUNNYNTHABANK STATE 002H,2023-07-01,124,3,749,8,77635,408217,515661
300154406901,30-015-44069,BLACK RIVER 15 10 STATE COM X 006H,2018-03-01,1,11199,93554,97835,11199,93554,97835
300154406901,30-015-44069,BLACK RIVER 15 10 STATE COM X 006H,2018-04-01,2,20172,54725,99799,31371,148279,197634
300154406901,30-015-44069,BLACK RIVER 15 10 STATE COM X 006H,2018-05-01,3,3760,7997,26248,35131,156276,223882
300154406901,30-015-44069,BLACK RIVER 15 10 STATE COM X 006H,2018-06-01,4,8263,10523,48957,43394,166799,272839
300154406901,30-015-44069,BLACK RIVER 15 10 STATE COM X 006H,2018-07-01,5,11871,26939,56005,55265,193738,328844
300154406901,30-015-44069,BLACK RIVER 15 10 STATE COM X 006H,2018-08-01,6,9260,16553,45223,64525,210291,374067
300154406901,30-015-44069,BLACK RIVER 15 10 STATE COM X 006H,2018-09-01,7,9125,26552,48255,73650,236843,422322
300154406901,30-015-44069,BLACK RIVER 15 10 STATE COM X 006H,2018-10-01,8,7470,20839,41534,81120,257682,463856
300154406901,30-015-44069,BLACK RIVER 15 10 STATE COM X 006H,2018-11-01,9,9347,32777,36733,90467,290459,500589
300154406901,30-015-44069,BLACK RIVER 15 10 STATE COM X 006H,2018-12-01,10,5540,35236,33539,96007,325695,534128
300154406901,30-015-44069,BLACK RIVER 15 10 STATE COM X 006H,2019-01-01,11,3490,23750,24824,99497,349445,558952
300154406901,30-015-44069,BLACK RIVER 15 10 STATE COM X 006H,2019-02-01,12,1040,13598,8477,100537,363043,567429
300154406901,30-015-44069,BLACK RIVER 15 10 STATE COM X 006H,2019-03-01,13,4604,24013,37358,105141,387056,604787
300154406901,30-015-44069,BLACK RIVER 15 10 STATE COM X 006H,2019-04-01,14,5395,26377,18432,110536,413433,623219
300154406901,30-015-44069,BLACK RIVER 15 10 STATE COM X 006H,2019-05-01,15,1591,8861,13321,112127,422294,636540
300154406901,30-015-44069,BLACK RIVER 15 10 STATE COM X 006H,2019-06-01,16,930,5005,11323,113057,427299,647863
300154406901,30-015-44069,BLACK RIVER 15 10 STATE COM X 006H,2019-07-01,17,1511,6438,16328,114568,433737,664191
300154406901,30-015-44069,BLACK RIVER 15 10 STATE COM X 006H,2019-08-01,18,1495,5456,17885,116063,439193,682076
300154406901,30-015-44069,BLACK RIVER 15 10 STATE COM X 006H,2019-09-01,19,824,2514,13057,116887,441707,695133
300154406901,30-015-44069,BLACK RIVER 15 10 STATE COM X 006H,2019-10-01,20,737,5137,10729,117624,446844,705862
300154406901,30-015-44069,BLACK RIVER 15 10 STATE COM X 006H,2019-11-01,21,1726,9302,18176,119350,456146,724038
300154406901,30-015-44069,BLACK RIVER 15 10 STATE COM X 006H,2019-12-01,22,2884,27011,30464,122234,483157,754502
300154406901,30-015-44069,BLACK RIVER 15 10 STATE COM X 006H,2020-01-01,23,2257,14870,20231,124491,498027,774733
300154406901,30-015-44069,BLACK RIVER 15 10 STATE COM X 006H,2020-02-01,24,2340,20078,15261,126831,518105,789994
300154406901,30-015-44069,BLACK RIVER 15 10 STATE COM X 006H,2020-03-01,25,2116,20882,21319,128947,538987,811313
300154406901,30-015-44069,BLACK RIVER 15 10 STATE COM X 006H,2020-04-01,26,1797,18518,19679,130744,557505,830992
300154406901,30-015-44069,BLACK RIVER 15 10 STATE COM X 006H,2020-05-01,27,1347,12623,15835,132091,570128,846827
300154406901,30-015-44069,BLACK RIVER 15 10 STATE COM X 006H,2020-06-01,28,1549,18022,18414,133640,588150,865241
300154406901,30-015-44069,BLACK RIVER 15 10 STATE COM X 006H,2020-07-01,29,1444,16388,14755,135084,604538,879996
300154406901,30-015-44069,BLACK RIVER 15 10 STATE COM X 006H,2020-08-01,30,2256,21599,25858,137340,626137,905854
300154406901,30-015-44069,BLACK RIVER 15 10 STATE COM X 006H,2020-09-01,31,2287,16146,24983,139627,642283,930837
300154406901,30-015-44069,BLACK RIVER 15 10 STATE COM X 006H,2020-10-01,32,894,5444,10974,140521,647727,941811
300154406901,30-015-44069,BLACK RIVER 15 10 STATE COM X 006H,2020-11-01,33,578,7809,9172,141099,655536,950983
300154406901,30-015-44069,BLACK RIVER 15 10 STATE COM X 006H,2020-12-01,34,514,3042,8154,141613,658578,959137
300154406901,30-015-44069,BLACK RIVER 15 10 STATE COM X 006H,2021-01-01,35,865,2547,8983,142478,661125,968120
300154406901,30-015-44069,BLACK RIVER 15 10 STATE COM X 006H,2021-02-01,36,461,7467,5678,142939,668592,973798
300154406901,30-015-44069,BLACK RIVER 15 10 STATE COM X 006H,2021-03-01,37,225,3150,7507,143164,671742,981305
300154406901,30-015-44069,BLACK RIVER 15 10 STATE COM X 006H,2021-04-01,38,326,3715,7952,143490,675457,989257
300154406901,30-015-44069,BLACK RIVER 15 10 STATE COM X 006H,2021-05-01,39,427,966,2103,143917,676423,991360
300154406901,30-015-44069,BLACK RIVER 15 10 STATE COM X 006H,2021-06-01,40,0,0,0,143917,676423,991360
300154406901,30-015-44069,BLACK RIVER 15 10 STATE COM X 006H,2021-07-01,41,0,0,0,143917,676423,991360
300154406901,30-015-44069,BLACK RIVER 15 10 STATE COM X 006H,2021-08-01,42,175,61,71,144092,676484,991431
300154406901,30-015-44069,BLACK RIVER 15 10 STATE COM X 006H,2021-09-01,43,358,3938,7883,144450,680422,999314
300154406901,30-015-44069,BLACK RIVER 15 10 STATE COM X 006H,2021-10-01,44,5,2352,5635,144455,682774,1004949
300154406901,30-015-44069,BLACK RIVER 15 10 STATE COM X 006H,2021-11-01,45,17,2458,9037,144472,685232,1013986
300154406901,30-015-44069,BLACK RIVER 15 10 STATE COM X 006H,2021-12-01,46,1039,1504,5156,145511,686736,1019142
300154406901,30-015-44069,BLACK RIVER 15 10 STATE COM X 006H,2022-01-01,47,115,2275,4368,145626,689011,1023510
300154406901,30-015-44069,BLACK RIVER 15 10 STATE COM X 006H,2022-02-01,48,45,101,3684,145671,689112,1027194
300154406901,30-015-44069,BLACK RIVER 15 10 STATE COM X 006H,2022-03-01,49,10,1157,1479,145681,690269,1028673
300154406901,30-015-44069,BLACK RIVER 15 10 STATE COM X 006H,2022-04-01,50,0,0,0,145681,690269,1028673
300154406901,30-015-44069,BLACK RIVER 15 10 STATE COM X 006H,2022-05-01,51,0,1,164,145681,690270,1028837
300150113000,30-015-01130,HUMBLE ST 001,1952-08-01,1,266,0,1064,266,0,1064
300150113000,30-015-01130,HUMBLE ST 001,1952-09-01,2,47,0,190,313,0,1254
300150113000,30-015-01130,HUMBLE ST 001,1952-10-01,3,0,0,0,313,0,1254
300150113000,30-015-01130,HUMBLE ST 001,1952-11-01,4,50,0,0,363,0,1254
300154188700,30-015-41887,PREACHER 19 FEDERAL 003H,2014-07-01,1,2818,22622,38695,2818,22622,38695
300154188700,30-015-41887,PREACHER 19 FEDERAL 003H,2014-08-01,2,2282,16687,39096,5100,39309,77791
300154188700,30-015-41887,PREACHER 19 FEDERAL 003H,2014-09-01,3,1128,6257,17427,6228,45566,95218
300154188700,30-015-41887,PREACHER 19 FEDERAL 003H,2014-10-01,4,1970,10256,29780,8198,55822,124998
300154188700,30-015-41887,PREACHER 19 FEDERAL 003H,2014-11-01,5,1653,7985,20729,9851,63807,145727
300154188700,30-015-41887,PREACHER 19 FEDERAL 003H,2014-12-01,6,1270,11218,21341,11121,75025,167068
300154188700,30-015-41887,PREACHER 19 FEDERAL 003H,2015-01-01,7,1472,4541,7883,12593,79566,174951
300154188700,30-015-41887,PREACHER 19 FEDERAL 003H,2015-02-01,8,894,4051,5617,13487,83617,180568
300154188700,30-015-41887,PREACHER 19 FEDERAL 003H,2015-03-01,9,554,3652,1810,14041,87269,182378
300154188700,30-015-41887,PREACHER 19 FEDERAL 003H,2015-04-01,10,614,1122,2042,14655,88391,184420
300154188700,30-015-41887,PREACHER 19 FEDERAL 003H,2015-05-01,11,689,637,1689,15344,89028,186109
300154188700,30-015-41887,PREACHER 19 FEDERAL 003H,2015-06-01,12,708,1557,2402,16052,90585,188511
300154188700,30-015-41887,PREACHER 19 FEDERAL 003H,2015-07-01,13,855,3222,2965,16907,93807,191476
300154188700,30-015-41887,PREACHER 19 FEDERAL 003H,2015-08-01,14,915,3096,4213,17822,96903,195689
300154188700,30-015-41887,PREACHER 19 FEDERAL 003H,2015-09-01,15,887,2545,3780,18709,99448,199469
300154188700,30-015-41887,PREACHER 19 FEDERAL 003H,2015-10-01,16,912,1976,4009,19621,101424,203478
300154188700,30-015-41887,PREACHER 19 FEDERAL 003H,2015-11-01,17,811,2653,3704,20432,104077,207182
300154188700,30-015-41887,PREACHER 19 FEDERAL 003H,2015-12-01,18,630,1316,2728,21062,105393,209910
300154188700,30-015-41887,PREACHER 19 FEDERAL 003H,2016-01-01,19,770,2676,2785,21832,108069,212695
300154188700,30-015-41887,PREACHER 19 FEDERAL 003H,2016-02-01,20,823,4284,3883,22655,112353,216578
300154188700,30-015-41887,PREACHER 19 FEDERAL 003H,2016-03-01,21,691,3751,3622,23346,116104,220200
300154188700,30-015-41887,PREACHER 19 FEDERAL 003H,2016-04-01,22,381,2029,2125,23727,118133,222325
300154188700,30-015-41887,PREACHER 19 FEDERAL 003H,2016-05-01,23,804,3570,3770,24531,121703,226095
300154188700,30-015-41887,PREACHER 19 FEDERAL 003H,2016-06-01,24,803,3965,4311,25334,125668,230406
300154188700,30-015-41887,PREACHER 19 FEDERAL 003H,2016-07-01,25,672,3078,4424,26006,128746,234830
300154188700,30-015-41887,PREACHER 19 FEDERAL 003H,2016-08-01,26,604,2666,3789,26610,131412,238619
300154188700,30-015-41887,PREACHER 19 FEDERAL 003H,2016-09-01,27,444,2625,1532,27054,134037,240151
300154188700,30-015-41887,PREACHER 19 FEDERAL 003H,2016-10-01,28,593,2957,3249,27647,136994,243400
300154188700,30-015-41887,PREACHER 19 FEDERAL 003H,2016-11-01,29,555,3516,3028,28202,140510,246428
300154188700,30-015-41887,PREACHER 19 FEDERAL 003H,2016-12-01,30,658,3454,3639,28860,143964,250067
300154188700,30-015-41887,PREACHER 19 FEDERAL 003H,2017-01-01,31,559,2658,3155,29419,146622,253222
300154188700,30-015-41887,PREACHER 19 FEDERAL 003H,2017-02-01,32,551,3089,3111,29970,149711,256333
300154188700,30-015-41887,PREACHER 19 FEDERAL 003H,2017-03-01,33,569,3126,3310,30539,152837,259643
300154188700,30-015-41887,PREACHER 19 FEDERAL 003H,2017-04-01,34,592,3294,3382,31131,156131,263025
300154188700,30-015-41887,PREACHER 19 FEDERAL 003H,2017-05-01,35,522,2784,3437,31653,158915,266462
300154188700,30-015-41887,PREACHER 19 FEDERAL 003H,2017-06-01,36,518,2830,3026,32171,161745,269488
300154188700,30-015-41887,PREACHER 19 FEDERAL 003H,2017-07-01,37,477,3112,3516,32648,164857,273004
300154188700,30-015-41887,PREACHER 19 FEDERAL 003H,2017-08-01,38,559,3087,2689,33207,167944,275693
300154188700,30-015-41887,PREACHER 19 FEDERAL 003H,2017-09-01,39,404,2182,1992,33611,170126,277685
300154188700,30-015-41887,PREACHER 19 FEDERAL 003H,2017-10-01,40,478,2462,1787,34089,172588,279472
300154188700,30-015-41887,PREACHER 19 FEDERAL 003H,2017-11-01,41,318,2628,1094,34407,175216,280566
300154188700,30-015-41887,PREACHER 19 FEDERAL 003H,2017-12-01,42,228,1641,970,34635,176857,281536
300154188700,30-015-41887,PREACHER 19 FEDERAL 003H,2018-01-01,43,113,667,0,34748,177524,281536
300154188700,30-015-41887,PREACHER 19 FEDERAL 003H,2018-02-01,44,10,0,28,34758,177524,281564
300154188700,30-015-41887,PREACHER 19 FEDERAL 003H,2018-03-01,45,99,4277,23,34857,181801,281587
300154188700,30-015-41887,PREACHER 19 FEDERAL 003H,2018-04-01,46,78,109,31,34935,181910,281618
300154188700,30-015-41887,PREACHER 19 FEDERAL 003H,2018-05-01,47,0,373,5,34935,182283,281623
300154188700,30-015-41887,PREACHER 19 FEDERAL 003H,2018-06-01,48,118,2745,51,35053,185028,281674
300154188700,30-015-41887,PREACHER 19 FEDERAL 003H,2018-07-01,49,73,541,1109,35126,185569,282783
300154188700,30-015-41887,PREACHER 19 FEDERAL 003H,2018-08-01,50,398,4385,979,35524,189954,283762
300154188700,30-015-41887,PREACHER 19 FEDERAL 003H,2018-09-01,51,203,1992,1768,35727,191946,285530
300154188700,30-015-41887,PREACHER 19 FEDERAL 003H,2018-10-01,52,621,1913,1211,36348,193859,286741
300154188700,30-015-41887,PREACHER 19 FEDERAL 003H,2018-11-01,53,564,1249,2753,36912,195108,289494
300154188700,30-015-41887,PREACHER 19 FEDERAL 003H,2018-12-01,54,454,1662,1364,37366,196770,290858
300154188700,30-015-41887,PREACHER 19 FEDERAL 003H,2019-01-01,55,482,1828,4696,37848,198598,295554
300154188700,30-015-41887,PREACHER 19 FEDERAL 003H,2019-02-01,56,245,714,1525,38093,199312,297079
300154188700,30-015-41887,PREACHER 19 FEDERAL 003H,2019-03-01,57,172,1511,802,38265,200823,297881
300154188700,30-015-41887,PREACHER 19 FEDERAL 003H,2019-04-01,58,470,1442,2011,38735,202265,299892
300154188700,30-015-41887,PREACHER 19 FEDERAL 003H,2019-05-01,59,830,953,940,39565,203218,300832
300154188700,30-015-41887,PREACHER 19 FEDERAL 003H,2019-06-01,60,457,2356,1803,40022,205574,302635
300154188700,30-015-41887,PREACHER 19 FEDERAL 003H,2019-07-01,61,657,2553,3417,40679,208127,306052
300154188700,30-015-41887,PREACHER 19 FEDERAL 003H,2019-08-01,62,340,1311,854,41019,209438,306906
300154188700,30-015-41887,PREACHER 19 FEDERAL 003H,2019-09-01,63,393,1464,2439,41412,210902,309345
300154188700,30-015-41887,PREACHER 19 FEDERAL 003H,2019-10-01,64,453,1787,2674,41865,212689,312019
300154188700,30-015-41887,PREACHER 19 FEDERAL 003H,2019-11-01,65,187,3262,1608,42052,215951,313627
300154188700,30-015-41887,PREACHER 19 FEDERAL 003H,2019-12-01,66,428,1757,2668,42480,217708,316295
300154188700,30-015-41887,PREACHER 19 FEDERAL 003H,2020-01-01,67,490,2395,1855,42970,220103,318150
300154188700,30-015-41887,PREACHER 19 FEDERAL 003H,2020-02-01,68,283,1229,420,43253,221332,318570
300154188700,30-015-41887,PREACHER 19 FEDERAL 003H,2020-03-01,69,491,2886,1349,43744,224218,319919
300154188700,30-015-41887,PREACHER 19 FEDERAL 003H,2020-04-01,70,113,1294,1,43857,225512,319920
300154188700,30-015-41887,PREACHER 19 FEDERAL 003H,2020-05-01,71,67,0,1,43924,225512,319921
300154188700,30-015-41887,PREACHER 19 FEDERAL 003H,2020-06-01,72,0,0,1,43924,225512,319922
300154188700,30-015-41887,PREACHER 19 FEDERAL 003H,2020-07-01,73,595,2584,785,44519,228096,320707
300154188700,30-015-41887,PREACHER 19 FEDERAL 003H,2020-08-01,74,607,3135,8201,45126,231231,328908
300154188700,30-015-41887,PREACHER 19 FEDERAL 003H,2020-09-01,75,580,3825,5887,45706,235056,334795
300154188700,30-015-41887,PREACHER 19 FEDERAL 003H,2020-10-01,76,498,3819,5453,46204,238875,340248
300154188700,30-015-41887,PREACHER 19 FEDERAL 003H,2020-11-01,77,456,3228,6404,46660,242103,346652
300154188700,30-015-41887,PREACHER 19 FEDERAL 003H,2020-12-01,78,518,3616,4960,47178,245719,351612
300154188700,30-015-41887,PREACHER 19 FEDERAL 003H,2021-01-01,79,242,15049,1441,47420,260768,353053
300154188700,30-015-41887,PREACHER 19 FEDERAL 003H,2021-02-01,80,268,2262,639,47688,263030,353692
300154188700,30-015-41887,PREACHER 19 FEDERAL 003H,2021-03-01,81,553,2843,5668,48241,265873,359360
300154188700,30-015-41887,PREACHER 19 FEDERAL 003H,2021-04-01,82,311,1983,3423,48552,267856,362783
300154188700,30-015-41887,PREACHER 19 FEDERAL 003H,2021-05-01,83,40,206,4,48592,268062,362787
300154188700,30-015-41887,PREACHER 19 FEDERAL 003H,2021-06-01,84,211,2882,790,48803,270944,363577
300154188700,30-015-41887,PREACHER 19 FEDERAL 003H,2021-07-01,85,374,3332,3431,49177,274276,367008
300154188700,30-015-41887,PREACHER 19 FEDERAL 003H,2021-08-01,86,332,2361,4897,49509,276637,371905
300154188700,30-015-41887,PREACHER 19 FEDERAL 003H,2021-09-01,87,590,3821,10007,50099,280458,381912
300154188700,30-015-41887,PREACHER 19 FEDERAL 003H,2021-10-01,88,257,1527,3926,50356,281985,385838
300154188700,30-015-41887,PREACHER 19 FEDERAL 003H,2021-11-01,89,508,4533,8793,50864,286518,394631
300154188700,30-015-41887,PREACHER 19 FEDERAL 003H,2021-12-01,90,386,3453,5686,51250,289971,400317
300154188700,30-015-41887,PREACHER 19 FEDERAL 003H,2022-01-01,91,406,3404,5644,51656,293375,405961
300154188700,30-015-41887,PREACHER 19 FEDERAL 003H,2022-02-01,92,118,2992,196,51774,296367,406157
300154188700,30-015-41887,PREACHER 19 FEDERAL 003H,2022-03-01,93,22,3851,78,51796,300218,406235
300154188700,30-015-41887,PREACHER 19 FEDERAL 003H,2022-04-01,94,3,4144,2,51799,304362,406237
300154188700,30-015-41887,PREACHER 19 FEDERAL 003H,2022-05-01,95,151,1511,199,51950,305873,406436
300154188700,30-015-41887,PREACHER 19 FEDERAL 003H,2022-06-01,96,138,2228,0,52088,308101,406436
300154188700,30-015-41887,PREACHER 19 FEDERAL 003H,2022-07-01,97,128,1977,708,52216,310078,407144
300154188700,30-015-41887,PREACHER 19 FEDERAL 003H,2022-08-01,98,0,0,448,52216,310078,407592
300154188700,30-015-41887,PREACHER 19 FEDERAL 003H,2022-09-01,99,300,1180,8,52516,311258,407600
300154188700,30-015-41887,PREACHER 19 FEDERAL 003H,2022-10-01,100,701,4736,2967,53217,315994,410567
300154188700,30-015-41887,PREACHER 19 FEDERAL 003H,2022-11-01,101,587,3695,5268,53804,319689,415835
300154188700,30-015-41887,PREACHER 19 FEDERAL 003H,2022-12-01,102,353,2415,2360,54157,322104,418195
300154188700,30-015-41887,PREACHER 19 FEDERAL 003H,2023-01-01,103,285,1906,1498,54442,324010,419693
300154188700,30-015-41887,PREACHER 19 FEDERAL 003H,2023-02-01,104,230,879,2292,54672,324889,421985
300154188700,30-015-41887,PREACHER 19 FEDERAL 003H,2023-03-01,105,667,86,5510,55339,324975,427495
300154188700,30-015-41887,PREACHER 19 FEDERAL 003H,2023-04-01,106,342,2692,3329,55681,327667,430824
300154188700,30-015-41887,PREACHER 19 FEDERAL 003H,2023-05-01,107,242,2912,1151,55923,330579,431975
300154188700,30-015-41887,PREACHER 19 FEDERAL 003H,2023-06-01,108,199,3735,286,56122,334314,432261
300154188700,30-015-41887,PREACHER 19 FEDERAL 003H,2023-07-01,109,0,1176,0,56122,335490,432261
300153630500,30-015-36305,STOGEY BLG STATE COM 001H,2008-11-01,1,2530,2292,1997,2530,2292,1997
300153630500,30-015-36305,STOGEY BLG STATE COM 001H,2008-12-01,2,2233,1337,1970,4763,3629,3967
300153630500,30-015-36305,STOGEY BLG STATE COM 001H,2009-01-01,3,1589,2273,1339,6352,5902,5306
300153630500,30-015-36305,STOGEY BLG STATE COM 001H,2009-02-01,4,1192,1082,932,7544,6984,6238
300153630500,30-015-36305,STOGEY BLG STATE COM 001H,2009-03-01,5,1191,1463,935,8735,8447,7173
300153630500,30-015-36305,STOGEY BLG STATE COM 001H,2009-04-01,6,988,1458,770,9723,9905,7943
300153630500,30-015-36305,STOGEY BLG STATE COM 001H,2009-05-01,7,928,1316,703,10651,11221,8646
300153630500,30-015-36305,STOGEY BLG STATE COM 001H,2009-06-01,8,526,394,1734,11177,11615,10380
300153630500,30-015-36305,STOGEY BLG STATE COM 001H,2009-07-01,9,907,1083,1180,12084,12698,11560
300153630500,30-015-36305,STOGEY BLG STATE COM 001H,2009-08-01,10,799,1428,758,12883,14126,12318
300153630500,30-015-36305,STOGEY BLG STATE COM 001H,2009-09-01,11,704,1523,591,13587,15649,12909
300153630500,30-015-36305,STOGEY BLG STATE COM 001H,2009-10-01,12,673,1248,553,14260,16897,13462
300153630500,30-015-36305,STOGEY BLG STATE COM 001H,2009-11-01,13,570,1270,439,14830,18167,13901
300153630500,30-015-36305,STOGEY BLG STATE COM 001H,2009-12-01,14,632,1324,571,15462,19491,14472
300153630500,30-015-36305,STOGEY BLG STATE COM 001H,2010-01-01,15,619,1139,510,16081,20630,14982
300153630500,30-015-36305,STOGEY BLG STATE COM 001H,2010-02-01,16,524,1273,431,16605,21903,15413
300153630500,30-015-36305,STOGEY BLG STATE COM 001H,2010-03-01,17,543,1080,453,17148,22983,15866
300153630500,30-015-36305,STOGEY BLG STATE COM 001H,2010-04-01,18,503,1069,406,17651,24052,16272
300153630500,30-015-36305,STOGEY BLG STATE COM 001H,2010-05-01,19,483,896,391,18134,24948,16663
300153630500,30-015-36305,STOGEY BLG STATE COM 001H,2010-06-01,20,428,938,335,18562,25886,16998
300153630500,30-015-36305,STOGEY BLG STATE COM 001H,2010-07-01,21,405,1065,374,18967,26951,17372
300153630500,30-015-36305,STOGEY BLG STATE COM 001H,2010-08-01,22,463,1204,366,19430,28155,17738
300153630500,30-015-36305,STOGEY BLG STATE COM 001H,2010-09-01,23,428,976,290,19858,29131,18028
300153630500,30-015-36305,STOGEY BLG STATE COM 001H,2010-10-01,24,450,1155,334,20308,30286,18362
300153630500,30-015-36305,STOGEY BLG STATE COM 001H,2010-11-01,25,416,702,299,20724,30988,18661
300153630500,30-015-36305,STOGEY BLG STATE COM 001H,2010-12-01,26,0,46,0,20724,31034,18661
300153630500,30-015-36305,STOGEY BLG STATE COM 001H,2011-01-01,27,458,134,518,21182,31168,19179
300153630500,30-015-36305,STOGEY BLG STATE COM 001H,2011-02-01,28,365,595,539,21547,31763,19718
300153630500,30-015-36305,STOGEY BLG STATE COM 001H,2011-03-01,29,434,42,353,21981,31805,20071
300153630500,30-015-36305,STOGEY BLG STATE COM 001H,2011-04-01,30,428,1133,328,22409,32938,20399
300153630500,30-015-36305,STOGEY BLG STATE COM 001H,2011-05-01,31,409,1562,357,22818,34500,20756
300153630500,30-015-36305,STOGEY BLG STATE COM 001H,2011-06-01,32,393,1465,272,23211,35965,21028
300153630500,30-015-36305,STOGEY BLG STATE COM 001H,2011-07-01,33,357,1560,267,23568,37525,21295
300153630500,30-015-36305,STOGEY BLG STATE COM 001H,2011-08-01,34,369,1643,353,23937,39168,21648
300153630500,30-015-36305,STOGEY BLG STATE COM 001H,2011-09-01,35,298,1437,258,24235,40605,21906
300153630500,30-015-36305,STOGEY BLG STATE COM 001H,2011-10-01,36,346,1572,958,24581,42177,22864
300153630500,30-015-36305,STOGEY BLG STATE COM 001H,2011-11-01,37,320,1419,259,24901,43596,23123
300153630500,30-015-36305,STOGEY BLG STATE COM 001H,2011-12-01,38,360,1393,264,25261,44989,23387
300153630500,30-015-36305,STOGEY BLG STATE COM 001H,2012-01-01,39,331,1247,199,25592,46236,23586
300153630500,30-015-36305,STOGEY BLG STATE COM 001H,2012-02-01,40,307,997,1281,25899,47233,24867
300153630500,30-015-36305,STOGEY BLG STATE COM 001H,2012-03-01,41,337,892,258,26236,48125,25125
300153630500,30-015-36305,STOGEY BLG STATE COM 001H,2012-04-01,42,289,728,287,26525,48853,25412
300153630500,30-015-36305,STOGEY BLG STATE COM 001H,2012-05-01,43,307,898,343,26832,49751,25755
300153630500,30-015-36305,STOGEY BLG STATE COM 001H,2012-06-01,44,297,999,252,27129,50750,26007
300153630500,30-015-36305,STOGEY BLG STATE COM 001H,2012-07-01,45,287,987,248,27416,51737,26255
300153630500,30-015-36305,STOGEY BLG STATE COM 001H,2012-08-01,46,252,1074,306,27668,52811,26561
300153630500,30-015-36305,STOGEY BLG STATE COM 001H,2012-09-01,47,296,720,273,27964,53531,26834
300153630500,30-015-36305,STOGEY BLG STATE COM 001H,2012-10-01,48,262,805,291,28226,54336,27125
300153630500,30-015-36305,STOGEY BLG STATE COM 001H,2012-11-01,49,255,1035,259,28481,55371,27384
300153630500,30-015-36305,STOGEY BLG STATE COM 001H,2012-12-01,50,276,1448,290,28757,56819,27674
300153630500,30-015-36305,STOGEY BLG STATE COM 001H,2013-01-01,51,302,1343,357,29059,58162,28031
300153630500,30-015-36305,STOGEY BLG STATE COM 001H,2013-02-01,52,265,1085,276,29324,59247,28307
300153630500,30-015-36305,STOGEY BLG STATE COM 001H,2013-03-01,53,266,1181,270,29590,60428,28577
300153630500,30-015-36305,STOGEY BLG STATE COM 001H,2013-04-01,54,239,1027,306,29829,61455,28883
300153630500,30-015-36305,STOGEY BLG STATE COM 001H,2013-05-01,55,248,542,254,30077,61997,29137
300153630500,30-015-36305,STOGEY BLG STATE COM 001H,2013-06-01,56,240,257,326,30317,62254,29463
300153630500,30-015-36305,STOGEY BLG STATE COM 001H,2013-07-01,57,232,364,198,30549,62618,29661
300153630500,30-015-36305,STOGEY BLG STATE COM 001H,2013-08-01,58,290,408,145,30839,63026,29806
300153630500,30-015-36305,STOGEY BLG STATE COM 001H,2013-09-01,59,205,243,138,31044,63269,29944
300153630500,30-015-36305,STOGEY BLG STATE COM 001H,2013-10-01,60,264,1096,152,31308,64365,30096
300153630500,30-015-36305,STOGEY BLG STATE COM 001H,2013-11-01,61,227,1008,225,31535,65373,30321
300153630500,30-015-36305,STOGEY BLG STATE COM 001H,2013-12-01,62,215,767,172,31750,66140,30493
300153630500,30-015-36305,STOGEY BLG STATE COM 001H,2014-01-01,63,244,708,185,31994,66848,30678
300153630500,30-015-36305,STOGEY BLG STATE COM 001H,2014-02-01,64,235,610,282,32229,67458,30960
300153630500,30-015-36305,STOGEY BLG STATE COM 001H,2014-03-01,65,439,1053,245,32668,68511,31205
300153630500,30-015-36305,STOGEY BLG STATE COM 001H,2014-04-01,66,231,1157,196,32899,69668,31401
300153630500,30-015-36305,STOGEY BLG STATE COM 001H,2014-05-01,67,164,940,265,33063,70608,31666
300153630500,30-015-36305,STOGEY BLG STATE COM 001H,2014-06-01,68,241,953,188,33304,71561,31854
300153630500,30-015-36305,STOGEY BLG STATE COM 001H,2014-07-01,69,246,1247,209,33550,72808,32063
300153630500,30-015-36305,STOGEY BLG STATE COM 001H,2014-08-01,70,187,1197,165,33737,74005,32228
300153630500,30-015-36305,STOGEY BLG STATE COM 001H,2014-09-01,71,153,1172,149,33890,75177,32377
300153630500,30-015-36305,STOGEY BLG STATE COM 001H,2014-10-01,72,257,1104,140,34147,76281,32517
300153630500,30-015-36305,STOGEY BLG STATE COM 001H,2014-11-01,73,196,860,150,34343,77141,32667
300153630500,30-015-36305,STOGEY BLG STATE COM 001H,2014-12-01,74,155,417,152,34498,77558,32819
300153630500,30-015-36305,STOGEY BLG STATE COM 001H,2015-01-01,75,230,602,232,34728,78160,33051
300153630500,30-015-36305,STOGEY BLG STATE COM 001H,2015-02-01,76,85,418,82,34813,78578,33133
300153630500,30-015-36305,STOGEY BLG STATE COM 001H,2015-03-01,77,51,165,0,34864,78743,33133
300153630500,30-015-36305,STOGEY BLG STATE COM 001H,2015-04-01,78,264,424,168,35128,79167,33301
300153630500,30-015-36305,STOGEY BLG STATE COM 001H,2015-05-01,79,319,329,349,35447,79496,33650
300153630500,30-015-36305,STOGEY BLG STATE COM 001H,2015-06-01,80,199,415,37,35646,79911,33687
300153630500,30-015-36305,STOGEY BLG STATE COM 001H,2015-07-01,81,214,153,29,35860,80064,33716
300153630500,30-015-36305,STOGEY BLG STATE COM 001H,2015-08-01,82,125,157,297,35985,80221,34013
300153630500,30-015-36305,STOGEY BLG STATE COM 001H,2015-09-01,83,159,156,211,36144,80377,34224
300153630500,30-015-36305,STOGEY BLG STATE COM 001H,2015-10-01,84,497,152,129,36641,80529,34353
300153630500,30-015-36305,STOGEY BLG STATE COM 001H,2015-11-01,85,210,147,337,36851,80676,34690
300153630500,30-015-36305,STOGEY BLG STATE COM 001H,2015-12-01,86,97,152,275,36948,80828,34965
300153630500,30-015-36305,STOGEY BLG STATE COM 001H,2016-01-01,87,284,139,406,37232,80967,35371
300153630500,30-015-36305,STOGEY BLG STATE COM 001H,2016-02-01,88,438,0,212,37670,80967,35583
300153630500,30-015-36305,STOGEY BLG STATE COM 001H,2016-03-01,89,194,249,1277,37864,81216,36860
300153630500,30-015-36305,STOGEY BLG STATE COM 001H,2016-04-01,90,205,621,98,38069,81837,36958
300153630500,30-015-36305,STOGEY BLG STATE COM 001H,2016-05-01,91,356,546,233,38425,82383,37191
300153630500,30-015-36305,STOGEY BLG STATE COM 001H,2016-06-01,92,801,622,142,39226,83005,37333
300153630500,30-015-36305,STOGEY BLG STATE COM 001H,2016-07-01,93,242,754,129,39468,83759,37462
300153630500,30-015-36305,STOGEY BLG STATE COM 001H,2016-08-01,94,495,585,165,39963,84344,37627
300153630500,30-015-36305,STOGEY BLG STATE COM 001H,2016-09-01,95,188,530,208,40151,84874,37835
300153630500,30-015-36305,STOGEY BLG STATE COM 001H,2016-10-01,96,192,592,153,40343,85466,37988
300153630500,30-015-36305,STOGEY BLG STATE COM 001H,2016-11-01,97,172,409,149,40515,85875,38137
300153630500,30-015-36305,STOGEY BLG STATE COM 001H,2016-12-01,98,191,890,135,40706,86765,38272
300153630500,30-015-36305,STOGEY BLG STATE COM 001H,2017-01-01,99,183,782,146,40889,87547,38418
300153630500,30-015-36305,STOGEY BLG STATE COM 001H,2017-02-01,100,143,421,135,41032,87968,38553
300153630500,30-015-36305,STOGEY BLG STATE COM 001H,2017-03-01,101,175,719,163,41207,88687,38716
300153630500,30-015-36305,STOGEY BLG STATE COM 001H,2017-04-01,102,175,747,139,41382,89434,38855
300153630500,30-015-36305,STOGEY BLG STATE COM 001H,2017-05-01,103,182,875,190,41564,90309,39045
300153630500,30-015-36305,STOGEY BLG STATE COM 001H,2017-06-01,104,140,708,135,41704,91017,39180
300153630500,30-015-36305,STOGEY BLG STATE COM 001H,2017-07-01,105,188,856,296,41892,91873,39476
300153630500,30-015-36305,STOGEY BLG STATE COM 001H,2017-08-01,106,177,885,226,42069,92758,39702
300153630500,30-015-36305,STOGEY BLG STATE COM 001H,2017-09-01,107,153,721,219,42222,93479,39921
300153630500,30-015-36305,STOGEY BLG STATE COM 001H,2017-10-01,108,164,813,270,42386,94292,40191
300153630500,30-015-36305,STOGEY BLG STATE COM 001H,2017-11-01,109,162,675,190,42548,94967,40381
300153630500,30-015-36305,STOGEY BLG STATE COM 001H,2017-12-01,110,127,809,159,42675,95776,40540
300153630500,30-015-36305,STOGEY BLG STATE COM 001H,2018-01-01,111,139,890,164,42814,96666,40704
300153630500,30-015-36305,STOGEY BLG STATE COM 001H,2018-02-01,112,244,824,216,43058,97490,40920
300153630500,30-015-36305,STOGEY BLG STATE COM 001H,2018-03-01,113,307,911,272,43365,98401,41192
300153630500,30-015-36305,STOGEY BLG STATE COM 001H,2018-04-01,114,173,837,155,43538,99238,41347
300153630500,30-015-36305,STOGEY BLG STATE COM 001H,2018-05-01,115,100,718,133,43638,99956,41480
300153630500,30-015-36305,STOGEY BLG STATE COM 001H,2018-06-01,116,275,845,154,43913,100801,41634
300153630500,30-015-36305,STOGEY BLG STATE COM 001H,2018-07-01,117,153,847,127,44066,101648,41761
300153630500,30-015-36305,STOGEY BLG STATE COM 001H,2018-08-01,118,175,874,211,44241,102522,41972
300153630500,30-015-36305,STOGEY BLG STATE COM 001H,2018-09-01,119,126,751,96,44367,103273,42068
300153630500,30-015-36305,STOGEY BLG STATE COM 001H,2018-10-01,120,54,569,67,44421,103842,42135
300153630500,30-015-36305,STOGEY BLG STATE COM 001H,2018-11-01,121,153,684,133,44574,104526,42268
300153630500,30-015-36305,STOGEY BLG STATE COM 001H,2018-12-01,122,230,725,96,44804,105251,42364
300153630500,30-015-36305,STOGEY BLG STATE COM 001H,2019-01-01,123,134,720,94,44938,105971,42458
300153630500,30-015-36305,STOGEY BLG STATE COM 001H,2019-02-01,124,168,707,88,45106,106678,42546
300153630500,30-015-36305,STOGEY BLG STATE COM 001H,2019-03-01,125,196,870,98,45302,107548,42644
300153630500,30-015-36305,STOGEY BLG STATE COM 001H,2019-04-01,126,191,919,179,45493,108467,42823
300153630500,30-015-36305,STOGEY BLG STATE COM 001H,2019-05-01,127,295,971,216,45788,109438,43039
300153630500,30-015-36305,STOGEY BLG STATE COM 001H,2019-06-01,128,169,609,136,45957,110047,43175
300153630500,30-015-36305,STOGEY BLG STATE COM 001H,2019-07-01,129,0,126,0,45957,110173,43175
300153630500,30-015-36305,STOGEY BLG STATE COM 001H,2019-08-01,130,0,85,0,45957,110258,43175
300153630500,30-015-36305,STOGEY BLG STATE COM 001H,2019-09-01,131,0,27,0,45957,110285,43175
300153630500,30-015-36305,STOGEY BLG STATE COM 001H,2019-10-01,132,329,1404,342,46286,111689,43517
300153630500,30-015-36305,STOGEY BLG STATE COM 001H,2019-11-01,133,239,1055,380,46525,112744,43897
300153630500,30-015-36305,STOGEY BLG STATE COM 001H,2019-12-01,134,213,992,465,46738,113736,44362
300153630500,30-015-36305,STOGEY BLG STATE COM 001H,2020-01-01,135,214,974,597,46952,114710,44959
300153630500,30-015-36305,STOGEY BLG STATE COM 001H,2020-02-01,136,152,967,373,47104,115677,45332
300153630500,30-015-36305,STOGEY BLG STATE COM 001H,2020-03-01,137,134,878,434,47238,116555,45766
300153630500,30-015-36305,STOGEY BLG STATE COM 001H,2020-04-01,138,167,792,412,47405,117347,46178
300153630500,30-015-36305,STOGEY BLG STATE COM 001H,2020-05-01,139,1,31,3,47406,117378,46181
300153630500,30-015-36305,STOGEY BLG STATE COM 001H,2020-06-01,140,2,180,15,47408,117558,46196
300153630500,30-015-36305,STOGEY BLG STATE COM 001H,2020-07-01,141,2,324,12,47410,117882,46208
300153630500,30-015-36305,STOGEY BLG STATE COM 001H,2020-08-01,142,0,160,0,47410,118042,46208
300153630500,30-015-36305,STOGEY BLG STATE COM 001H,2020-09-01,143,0,0,0,47410,118042,46208
300153630500,30-015-36305,STOGEY BLG STATE COM 001H,2020-10-01,144,0,0,0,47410,118042,46208
300153630500,30-015-36305,STOGEY BLG STATE COM 001H,2020-11-01,145,403,1372,423,47813,119414,46631
300153630500,30-015-36305,STOGEY BLG STATE COM 001H,2020-12-01,146,312,1388,1225,48125,120802,47856
300153630500,30-015-36305,STOGEY BLG STATE COM 001H,2021-01-01,147,227,963,771,48352,121765,48627
300153630500,30-015-36305,STOGEY BLG STATE COM 001H,2021-02-01,148,200,898,734,48552,122663,49361
300153630500,30-015-36305,STOGEY BLG STATE COM 001H,2021-03-01,149,185,942,492,48737,123605,49853
300153630500,30-015-36305,STOGEY BLG STATE COM 001H,2021-04-01,150,170,840,427,48907,124445,50280
300153630500,30-015-36305,STOGEY BLG STATE COM 001H,2021-05-01,151,142,828,413,49049,125273,50693
300153630500,30-015-36305,STOGEY BLG STATE COM 001H,2021-06-01,152,164,818,468,49213,126091,51161
300153630500,30-015-36305,STOGEY BLG STATE COM 001H,2021-07-01,153,162,713,327,49375,126804,51488
300153630500,30-015-36305,STOGEY BLG STATE COM 001H,2021-08-01,154,147,833,314,49522,127637,51802
300153630500,30-015-36305,STOGEY BLG STATE COM 001H,2021-09-01,155,146,873,347,49668,128510,52149
300153630500,30-015-36305,STOGEY BLG STATE COM 001H,2021-10-01,156,123,774,313,49791,129284,52462
300153630500,30-015-36305,STOGEY BLG STATE COM 001H,2021-11-01,157,152,984,452,49943,130268,52914
300153630500,30-015-36305,STOGEY BLG STATE COM 001H,2021-12-01,158,155,1031,393,50098,131299,53307
300153630500,30-015-36305,STOGEY BLG STATE COM 001H,2022-01-01,159,135,1039,303,50233,132338,53610
300153630500,30-015-36305,STOGEY BLG STATE COM 001H,2022-02-01,160,70,813,148,50303,133151,53758
300153630500,30-015-36305,STOGEY BLG STATE COM 001H,2022-03-01,161,110,939,168,50413,134090,53926
300153630500,30-015-36305,STOGEY BLG STATE COM 001H,2022-04-01,162,118,754,228,50531,134844,54154
300153630500,30-015-36305,STOGEY BLG STATE COM 001H,2022-05-01,163,141,821,114,50672,135665,54268
300153630500,30-015-36305,STOGEY BLG STATE COM 001H,2022-06-01,164,122,784,180,50794,136449,54448
300153630500,30-015-36305,STOGEY BLG STATE COM 001H,2022-07-01,165,128,804,193,50922,137253,54641
300153630500,30-015-36305,STOGEY BLG STATE COM 001H,2022-08-01,166,115,772,247,51037,138025,54888
300153630500,30-015-36305,STOGEY BLG STATE COM 001H,2022-09-01,167,99,716,229,51136,138741,55117
300153630500,30-015-36305,STOGEY BLG STATE COM 001H,2022-10-01,168,114,746,221,51250,139487,55338
300153630500,30-015-36305,STOGEY BLG STATE COM 001H,2022-11-01,169,111,699,145,51361,140186,55483
300153630500,30-015-36305,STOGEY BLG STATE COM 001H,2022-12-01,170,105,530,259,51466,140716,55742
300153630500,30-015-36305,STOGEY BLG STATE COM 001H,2023-01-01,171,70,321,87,51536,141037,55829
300153630500,30-015-36305,STOGEY BLG STATE COM 001H,2023-02-01,172,126,237,141,51662,141274,55970
300153630500,30-015-36305,STOGEY BLG STATE COM 001H,2023-03-01,173,141,358,98,51803,141632,56068
300153630500,30-015-36305,STOGEY BLG STATE COM 001H,2023-04-01,174,2,119,50,51805,141751,56118
300153630500,30-015-36305,STOGEY BLG STATE COM 001H,2023-05-01,175,41,343,72,51846,142094,56190
300153630500,30-015-36305,STOGEY BLG STATE COM 001H,2023-06-01,176,9,225,45,51855,142319,56235
300153630500,30-015-36305,STOGEY BLG STATE COM 001H,2023-07-01,177,18,228,0,51873,142547,56235
300154341800,30-015-43418,CHOPPER STATE 003H,2016-06-01,1,3221,6984,38177,3221,6984,38177
300154341800,30-015-43418,CHOPPER STATE 003H,2016-07-01,2,22407,43120,77052,25628,50104,115229
300154341800,30-015-43418,CHOPPER STATE 003H,2016-08-01,3,16706,31978,55771,42334,82082,171000
300154341800,30-015-43418,CHOPPER STATE 003H,2016-09-01,4,12396,25178,37226,54730,107260,208226
300154341800,30-015-43418,CHOPPER STATE 003H,2016-10-01,5,8591,17568,25112,63321,124828,233338
300154341800,30-015-43418,CHOPPER STATE 003H,2016-11-01,6,10531,27881,36240,73852,152709,269578
300154341800,30-015-43418,CHOPPER STATE 003H,2016-12-01,7,7801,19962,28522,81653,172671,298100
300154341800,30-015-43418,CHOPPER STATE 003H,2017-01-01,8,6355,14671,22500,88008,187342,320600
300154341800,30-015-43418,CHOPPER STATE 003H,2017-02-01,9,5385,13073,18836,93393,200415,339436
300154341800,30-015-43418,CHOPPER STATE 003H,2017-03-01,10,5773,16340,20635,99166,216755,360071
300154341800,30-015-43418,CHOPPER STATE 003H,2017-04-01,11,5036,14451,18510,104202,231206,378581
300154341800,30-015-43418,CHOPPER STATE 003H,2017-05-01,12,4450,12772,16760,108652,243978,395341
300154341800,30-015-43418,CHOPPER STATE 003H,2017-06-01,13,3985,10671,14478,112637,254649,409819
300154341800,30-015-43418,CHOPPER STATE 003H,2017-07-01,14,4169,11740,14217,116806,266389,424036
300154341800,30-015-43418,CHOPPER STATE 003H,2017-08-01,15,3993,11911,13416,120799,278300,437452
300154341800,30-015-43418,CHOPPER STATE 003H,2017-09-01,16,3617,9555,12691,124416,287855,450143
300154341800,30-015-43418,CHOPPER STATE 003H,2017-10-01,17,3434,8136,12547,127850,295991,462690
300154341800,30-015-43418,CHOPPER STATE 003H,2017-11-01,18,3403,10102,12879,131253,306093,475569
300154341800,30-015-43418,CHOPPER STATE 003H,2017-12-01,19,3251,7392,11642,134504,313485,487211
300154341800,30-015-43418,CHOPPER STATE 003H,2018-01-01,20,2963,7198,9949,137467,320683,497160
300154341800,30-015-43418,CHOPPER STATE 003H,2018-02-01,21,2587,6714,8469,140054,327397,505629
300154341800,30-015-43418,CHOPPER STATE 003H,2018-03-01,22,2576,6719,7970,142630,334116,513599
300154341800,30-015-43418,CHOPPER STATE 003H,2018-04-01,23,2556,6457,8262,145186,340573,521861
300154341800,30-015-43418,CHOPPER STATE 003H,2018-05-01,24,2547,6856,8884,147733,347429,530745
300154341800,30-015-43418,CHOPPER STATE 003H,2018-06-01,25,1784,4056,5234,149517,351485,535979
300154341800,30-015-43418,CHOPPER STATE 003H,2018-07-01,26,2737,7698,9445,152254,359183,545424
300154341800,30-015-43418,CHOPPER STATE 003H,2018-08-01,27,2694,8726,10266,154948,367909,555690
300154341800,30-015-43418,CHOPPER STATE 003H,2018-09-01,28,1534,3941,4554,156482,371850,560244
300154341800,30-015-43418,CHOPPER STATE 003H,2018-10-01,29,2242,8371,8218,158724,380221,568462
300154341800,30-015-43418,CHOPPER STATE 003H,2018-11-01,30,3657,18399,17486,162381,398620,585948
300154341800,30-015-43418,CHOPPER STATE 003H,2018-12-01,31,2480,11044,13669,164861,409664,599617
300154341800,30-015-43418,CHOPPER STATE 003H,2019-01-01,32,2805,12312,12596,167666,421976,612213
300154341800,30-015-43418,CHOPPER STATE 003H,2019-02-01,33,2374,12912,13560,170040,434888,625773
300154341800,30-015-43418,CHOPPER STATE 003H,2019-03-01,34,2387,13135,13234,172427,448023,639007
300154341800,30-015-43418,CHOPPER STATE 003H,2019-04-01,35,2025,10308,11832,174452,458331,650839
300154341800,30-015-43418,CHOPPER STATE 003H,2019-05-01,36,2207,10004,11449,176659,468335,662288
300154341800,30-015-43418,CHOPPER STATE 003H,2019-06-01,37,2024,9118,9998,178683,477453,672286
300154341800,30-015-43418,CHOPPER STATE 003H,2019-07-01,38,1913,8567,9377,180596,486020,681663
300154341800,30-015-43418,CHOPPER STATE 003H,2019-08-01,39,2062,9239,9767,182658,495259,691430
300154341800,30-015-43418,CHOPPER STATE 003H,2019-09-01,40,1912,8454,9715,184570,503713,701145
300154341800,30-015-43418,CHOPPER STATE 003H,2019-10-01,41,1767,7191,8647,186337,510904,709792
300154341800,30-015-43418,CHOPPER STATE 003H,2019-11-01,42,1747,7520,8066,188084,518424,717858
300154341800,30-015-43418,CHOPPER STATE 003H,2019-12-01,43,1797,7325,7754,189881,525749,725612
300154341800,30-015-43418,CHOPPER STATE 003H,2020-01-01,44,1777,6962,6960,191658,532711,732572
300154341800,30-015-43418,CHOPPER STATE 003H,2020-02-01,45,1585,5867,6649,193243,538578,739221
300154341800,30-015-43418,CHOPPER STATE 003H,2020-03-01,46,1784,7077,7481,195027,545655,746702
300154341800,30-015-43418,CHOPPER STATE 003H,2020-04-01,47,1626,6518,6932,196653,552173,753634
300154341800,30-015-43418,CHOPPER STATE 003H,2020-05-01,48,1605,6292,7322,198258,558465,760956
300154341800,30-015-43418,CHOPPER STATE 003H,2020-06-01,49,1581,6240,7128,199839,564705,768084
300154341800,30-015-43418,CHOPPER STATE 003H,2020-07-01,50,1568,4316,7165,201407,569021,775249
300154341800,30-015-43418,CHOPPER STATE 003H,2020-08-01,51,1566,6414,6947,202973,575435,782196
300154341800,30-015-43418,CHOPPER STATE 003H,2020-09-01,52,1483,5991,6653,204456,581426,788849
300154341800,30-015-43418,CHOPPER STATE 003H,2020-10-01,53,1570,6232,6777,206026,587658,795626
300154341800,30-015-43418,CHOPPER STATE 003H,2020-11-01,54,1405,5451,6330,207431,593109,801956
300154341800,30-015-43418,CHOPPER STATE 003H,2020-12-01,55,1102,3810,4796,208533,596919,806752
300154341800,30-015-43418,CHOPPER STATE 003H,2021-01-01,56,1435,4906,5634,209968,601825,812386
300154341800,30-015-43418,CHOPPER STATE 003H,2021-02-01,57,905,2866,3639,210873,604691,816025
300154341800,30-015-43418,CHOPPER STATE 003H,2021-03-01,58,3,131,8,210876,604822,816033
300154341800,30-015-43418,CHOPPER STATE 003H,2021-04-01,59,0,0,0,210876,604822,816033
300154341800,30-015-43418,CHOPPER STATE 003H,2021-05-01,60,0,0,0,210876,604822,816033
300154341800,30-015-43418,CHOPPER STATE 003H,2021-06-01,61,1286,3582,2742,212162,608404,818775
300154341800,30-015-43418,CHOPPER STATE 003H,2021-07-01,62,2025,5540,7987,214187,613944,826762
300154341800,30-015-43418,CHOPPER STATE 003H,2021-08-01,63,706,1964,4274,214893,615908,831036
300154341800,30-015-43418,CHOPPER STATE 003H,2021-09-01,64,1489,3562,8898,216382,619470,839934
300154341800,30-015-43418,CHOPPER STATE 003H,2021-10-01,65,1742,4471,8948,218124,623941,848882
300154341800,30-015-43418,CHOPPER STATE 003H,2021-11-01,66,1652,4546,8231,219776,628487,857113
300154341800,30-015-43418,CHOPPER STATE 003H,2021-12-01,67,201,522,1027,219977,629009,858140
300154341800,30-015-43418,CHOPPER STATE 003H,2022-01-01,68,834,2119,2805,220811,631128,860945
300154341800,30-015-43418,CHOPPER STATE 003H,2022-02-01,69,1767,4766,7985,222578,635894,868930
300154341800,30-015-43418,CHOPPER STATE 003H,2022-03-01,70,1540,4430,7181,224118,640324,876111
300154341800,30-015-43418,CHOPPER STATE 003H,2022-04-01,71,0,59,0,224118,640383,876111
300154341800,30-015-43418,CHOPPER STATE 003H,2022-05-01,72,0,0,0,224118,640383,876111
300154341800,30-015-43418,CHOPPER STATE 003H,2022-06-01,73,97,61,704,224215,640444,876815
300154341800,30-015-43418,CHOPPER STATE 003H,2022-07-01,74,1593,3573,4081,225808,644017,880896
300154341800,30-015-43418,CHOPPER STATE 003H,2022-08-01,75,1727,3463,7037,227535,647480,887933
300154341800,30-015-43418,CHOPPER STATE 003H,2022-09-01,76,1479,3172,6519,229014,650652,894452
300154341800,30-015-43418,CHOPPER STATE 003H,2022-10-01,77,22,19,74,229036,650671,894526
300154341800,30-015-43418,CHOPPER STATE 003H,2022-11-01,78,0,0,0,229036,650671,894526
300154341800,30-015-43418,CHOPPER STATE 003H,2022-12-01,79,1308,3042,3388,230344,653713,897914
300154341800,30-015-43418,CHOPPER STATE 003H,2023-01-01,80,1764,4783,6763,232108,658496,904677
300154341800,30-015-43418,CHOPPER STATE 003H,2023-02-01,81,1313,3778,5703,233421,662274,910380
300154341800,30-015-43418,CHOPPER STATE 003H,2023-03-01,82,609,1616,1874,234030,663890,912254
300154341800,30-015-43418,CHOPPER STATE 003H,2023-04-01,83,0,0,0,234030,663890,912254
300154341800,30-015-43418,CHOPPER STATE 003H,2023-05-01,84,1138,2846,2769,235168,666736,915023
300154341800,30-015-43418,CHOPPER STATE 003H,2023-06-01,85,1344,3921,5381,236512,670657,920404
300154152800,30-015-41528,QUIEN SABE 25 FEDERAL 001H,2014-01-01,1,2708,1365,8829,2708,1365,8829
300154152800,30-015-41528,QUIEN SABE 25 FEDERAL 001H,2014-02-01,2,7216,9077,23726,9924,10442,32555
300154152800,30-015-41528,QUIEN SABE 25 FEDERAL 001H,2014-03-01,3,5415,7791,23303,15339,18233,55858
300154152800,30-015-41528,QUIEN SABE 25 FEDERAL 001H,2014-04-01,4,2963,3621,10733,18302,21854,66591
300154152800,30-015-41528,QUIEN SABE 25 FEDERAL 001H,2014-05-01,5,3428,5963,15086,21730,27817,81677
300154152800,30-015-41528,QUIEN SABE 25 FEDERAL 001H,2014-06-01,6,2724,8216,16128,24454,36033,97805
300154152800,30-015-41528,QUIEN SABE 25 FEDERAL 001H,2014-07-01,7,2378,11044,12822,26832,47077,110627
300154152800,30-015-41528,QUIEN SABE 25 FEDERAL 001H,2014-08-01,8,2132,13658,12536,28964,60735,123163
300154152800,30-015-41528,QUIEN SABE 25 FEDERAL 001H,2014-09-01,9,913,2756,4434,29877,63491,127597
300154152800,30-015-41528,QUIEN SABE 25 FEDERAL 001H,2014-10-01,10,2054,2927,7498,31931,66418,135095
300154152800,30-015-41528,QUIEN SABE 25 FEDERAL 001H,2014-11-01,11,1733,5009,8948,33664,71427,144043
300154152800,30-015-41528,QUIEN SABE 25 FEDERAL 001H,2014-12-01,12,1563,1822,9335,35227,73249,153378
300154152800,30-015-41528,QUIEN SABE 25 FEDERAL 001H,2015-01-01,13,1511,766,6934,36738,74015,160312
300154152800,30-015-41528,QUIEN SABE 25 FEDERAL 001H,2015-02-01,14,1295,2653,5065,38033,76668,165377
300154152800,30-015-41528,QUIEN SABE 25 FEDERAL 001H,2015-03-01,15,1108,4068,10846,39141,80736,176223
300154152800,30-015-41528,QUIEN SABE 25 FEDERAL 001H,2015-04-01,16,1259,878,7305,40400,81614,183528
300154152800,30-015-41528,QUIEN SABE 25 FEDERAL 001H,2015-05-01,17,1171,3314,7837,41571,84928,191365
300154152800,30-015-41528,QUIEN SABE 25 FEDERAL 001H,2015-06-01,18,1043,4683,7038,42614,89611,198403
300154152800,30-015-41528,QUIEN SABE 25 FEDERAL 001H,2015-07-01,19,1114,2176,7821,43728,91787,206224
300154152800,30-015-41528,QUIEN SABE 25 FEDERAL 001H,2015-08-01,20,1005,1834,6465,44733,93621,212689
300154152800,30-015-41528,QUIEN SABE 25 FEDERAL 001H,2015-09-01,21,1016,2802,5310,45749,96423,217999
300154152800,30-015-41528,QUIEN SABE 25 FEDERAL 001H,2015-10-01,22,1005,4318,6691,46754,100741,224690
300154152800,30-015-41528,QUIEN SABE 25 FEDERAL 001H,2015-11-01,23,931,4251,6422,47685,104992,231112
300154152800,30-015-41528,QUIEN SABE 25 FEDERAL 001H,2015-12-01,24,735,2507,4386,48420,107499,235498
300154152800,30-015-41528,QUIEN SABE 25 FEDERAL 001H,2016-01-01,25,1049,4041,6463,49469,111540,241961
300154152800,30-015-41528,QUIEN SABE 25 FEDERAL 001H,2016-02-01,26,835,2305,6638,50304,113845,248599
300154152800,30-015-41528,QUIEN SABE 25 FEDERAL 001H,2016-03-01,27,845,4958,5753,51149,118803,254352
300154152800,30-015-41528,QUIEN SABE 25 FEDERAL 001H,2016-04-01,28,805,4528,5924,51954,123331,260276
300154152800,30-015-41528,QUIEN SABE 25 FEDERAL 001H,2016-05-01,29,784,4161,4996,52738,127492,265272
300154152800,30-015-41528,QUIEN SABE 25 FEDERAL 001H,2016-06-01,30,695,3671,3957,53433,131163,269229
300154152800,30-015-41528,QUIEN SABE 25 FEDERAL 001H,2016-07-01,31,698,3704,4029,54131,134867,273258
300154152800,30-015-41528,QUIEN SABE 25 FEDERAL 001H,2016-08-01,32,594,2991,2832,54725,137858,276090
300154152800,30-015-41528,QUIEN SABE 25 FEDERAL 001H,2016-09-01,33,566,2628,2092,55291,140486,278182
300154152800,30-015-41528,QUIEN SABE 25 FEDERAL 001H,2016-10-01,34,641,2638,2028,55932,143124,280210
300154152800,30-015-41528,QUIEN SABE 25 FEDERAL 001H,2016-11-01,35,568,2576,2469,56500,145700,282679
300154152800,30-015-41528,QUIEN SABE 25 FEDERAL 001H,2016-12-01,36,602,2454,2450,57102,148154,285129
300154152800,30-015-41528,QUIEN SABE 25 FEDERAL 001H,2017-01-01,37,609,2294,2424,57711,150448,287553
300154152800,30-015-41528,QUIEN SABE 25 FEDERAL 001H,2017-02-01,38,527,2077,2063,58238,152525,289616
300154152800,30-015-41528,QUIEN SABE 25 FEDERAL 001H,2017-03-01,39,594,2438,2369,58832,154963,291985
300154152800,30-015-41528,QUIEN SABE 25 FEDERAL 001H,2017-04-01,40,615,2351,2786,59447,157314,294771
300154152800,30-015-41528,QUIEN SABE 25 FEDERAL 001H,2017-05-01,41,684,2472,4225,60131,159786,298996
300154152800,30-015-41528,QUIEN SABE 25 FEDERAL 001H,2017-06-01,42,643,2607,4566,60774,162393,303562
300154152800,30-015-41528,QUIEN SABE 25 FEDERAL 001H,2017-07-01,43,623,2915,4595,61397,165308,308157
300154152800,30-015-41528,QUIEN SABE 25 FEDERAL 001H,2017-08-01,44,586,2989,4481,61983,168297,312638
300154152800,30-015-41528,QUIEN SABE 25 FEDERAL 001H,2017-09-01,45,583,3022,4343,62566,171319,316981
300154152800,30-015-41528,QUIEN SABE 25 FEDERAL 001H,2017-10-01,46,548,2838,3869,63114,174157,320850
300154152800,30-015-41528,QUIEN SABE 25 FEDERAL 001H,2017-11-01,47,587,3003,4630,63701,177160,325480
300154152800,30-015-41528,QUIEN SABE 25 FEDERAL 001H,2017-12-01,48,530,3109,4071,64231,180269,329551
300154152800,30-015-41528,QUIEN SABE 25 FEDERAL 001H,2018-01-01,49,515,2757,3572,64746,183026,333123
300154152800,30-015-41528,QUIEN SABE 25 FEDERAL 001H,2018-02-01,50,398,2086,2349,65144,185112,335472
300154152800,30-015-41528,QUIEN SABE 25 FEDERAL 001H,2018-03-01,51,393,2112,2978,65537,187224,338450
300154152800,30-015-41528,QUIEN SABE 25 FEDERAL 001H,2018-04-01,52,402,2359,2497,65939,189583,340947
300154152800,30-015-41528,QUIEN SABE 25 FEDERAL 001H,2018-05-01,53,369,2047,3117,66308,191630,344064
300154152800,30-015-41528,QUIEN SABE 25 FEDERAL 001H,2018-06-01,54,374,1884,2365,66682,193514,346429
300154152800,30-015-41528,QUIEN SABE 25 FEDERAL 001H,2018-07-01,55,409,1922,2077,67091,195436,348506
300154152800,30-015-41528,QUIEN SABE 25 FEDERAL 001H,2018-08-01,56,486,2283,3485,67577,197719,351991
300154152800,30-015-41528,QUIEN SABE 25 FEDERAL 001H,2018-09-01,57,621,3007,5221,68198,200726,357212
300154152800,30-015-41528,QUIEN SABE 25 FEDERAL 001H,2018-10-01,58,596,3608,5175,68794,204334,362387
300154152800,30-015-41528,QUIEN SABE 25 FEDERAL 001H,2018-11-01,59,438,2746,3668,69232,207080,366055
300154152800,30-015-41528,QUIEN SABE 25 FEDERAL 001H,2018-12-01,60,513,4032,5733,69745,211112,371788
300154152800,30-015-41528,QUIEN SABE 25 FEDERAL 001H,2019-01-01,61,446,3841,4985,70191,214953,376773
300154152800,30-015-41528,QUIEN SABE 25 FEDERAL 001H,2019-02-01,62,379,3257,3073,70570,218210,379846
300154152800,30-015-41528,QUIEN SABE 25 FEDERAL 001H,2019-03-01,63,178,1470,1685,70748,219680,381531
300154152800,30-015-41528,QUIEN SABE 25 FEDERAL 001H,2019-04-01,64,261,2600,2202,71009,222280,383733
300154152800,30-015-41528,QUIEN SABE 25 FEDERAL 001H,2019-05-01,65,474,2607,3369,71483,224887,387102
300154152800,30-015-41528,QUIEN SABE 25 FEDERAL 001H,2019-06-01,66,456,2035,3487,71939,226922,390589
300154152800,30-015-41528,QUIEN SABE 25 FEDERAL 001H,2019-07-01,67,526,3731,4815,72465,230653,395404
300154152800,30-015-41528,QUIEN SABE 25 FEDERAL 001H,2019-08-01,68,441,4093,5380,72906,234746,400784
300154152800,30-015-41528,QUIEN SABE 25 FEDERAL 001H,2019-09-01,69,221,2415,2712,73127,237161,403496
300154152800,30-015-41528,QUIEN SABE 25 FEDERAL 001H,2019-10-01,70,586,3427,3390,73713,240588,406886
300154152800,30-015-41528,QUIEN SABE 25 FEDERAL 001H,2019-11-01,71,449,3492,4014,74162,244080,410900
300154152800,30-015-41528,QUIEN SABE 25 FEDERAL 001H,2019-12-01,72,0,220,0,74162,244300,410900
300154152800,30-015-41528,QUIEN SABE 25 FEDERAL 001H,2020-01-01,73,0,43,0,74162,244343,410900
300154152800,30-015-41528,QUIEN SABE 25 FEDERAL 001H,2020-02-01,74,312,1167,251,74474,245510,411151
300154152800,30-015-41528,QUIEN SABE 25 FEDERAL 001H,2020-03-01,75,506,2064,1117,74980,247574,412268
300154152800,30-015-41528,QUIEN SABE 25 FEDERAL 001H,2020-04-01,76,381,1664,1013,75361,249238,413281
300154152800,30-015-41528,QUIEN SABE 25 FEDERAL 001H,2020-05-01,77,356,1588,1236,75717,250826,414517
300154152800,30-015-41528,QUIEN SABE 25 FEDERAL 001H,2020-06-01,78,334,1468,1137,76051,252294,415654
300154152800,30-015-41528,QUIEN SABE 25 FEDERAL 001H,2020-07-01,79,327,1532,1208,76378,253826,416862
300154152800,30-015-41528,QUIEN SABE 25 FEDERAL 001H,2020-08-01,80,334,1456,1239,76712,255282,418101
300154152800,30-015-41528,QUIEN SABE 25 FEDERAL 001H,2020-09-01,81,321,1218,1372,77033,256500,419473
300154152800,30-015-41528,QUIEN SABE 25 FEDERAL 001H,2020-10-01,82,332,1289,1366,77365,257789,420839
300154152800,30-015-41528,QUIEN SABE 25 FEDERAL 001H,2020-11-01,83,311,1333,1163,77676,259122,422002
300154152800,30-015-41528,QUIEN SABE 25 FEDERAL 001H,2020-12-01,84,323,1363,1293,77999,260485,423295
300154152800,30-015-41528,QUIEN SABE 25 FEDERAL 001H,2021-01-01,85,337,1369,1350,78336,261854,424645
300154152800,30-015-41528,QUIEN SABE 25 FEDERAL 001H,2021-02-01,86,316,1292,1300,78652,263146,425945
300154152800,30-015-41528,QUIEN SABE 25 FEDERAL 001H,2021-03-01,87,368,1531,1591,79020,264677,427536
300154152800,30-015-41528,QUIEN SABE 25 FEDERAL 001H,2021-04-01,88,335,1436,1476,79355,266113,429012
300154152800,30-015-41528,QUIEN SABE 25 FEDERAL 001H,2021-05-01,89,319,1428,1347,79674,267541,430359
300154152800,30-015-41528,QUIEN SABE 25 FEDERAL 001H,2021-06-01,90,333,1454,1497,80007,268995,431856
300154152800,30-015-41528,QUIEN SABE 25 FEDERAL 001H,2021-07-01,91,311,1207,1361,80318,270202,433217
300154152800,30-015-41528,QUIEN SABE 25 FEDERAL 001H,2021-08-01,92,333,1170,1563,80651,271372,434780
300154152800,30-015-41528,QUIEN SABE 25 FEDERAL 001H,2021-09-01,93,299,1131,1496,80950,272503,436276
300154152800,30-015-41528,QUIEN SABE 25 FEDERAL 001H,2021-10-01,94,337,1253,1724,81287,273756,438000
300154152800,30-015-41528,QUIEN SABE 25 FEDERAL 001H,2021-11-01,95,302,1168,1490,81589,274924,439490
300154152800,30-015-41528,QUIEN SABE 25 FEDERAL 001H,2021-12-01,96,321,1374,1200,81910,276298,440690
300154152800,30-015-41528,QUIEN SABE 25 FEDERAL 001H,2022-01-01,97,284,1356,1513,82194,277654,442203
300154152800,30-015-41528,QUIEN SABE 25 FEDERAL 001H,2022-02-01,98,256,1204,1328,82450,278858,443531
300154152800,30-015-41528,QUIEN SABE 25 FEDERAL 001H,2022-03-01,99,0,7,0,82450,278865,443531
300154152800,30-015-41528,QUIEN SABE 25 FEDERAL 001H,2022-04-01,100,75,437,123,82525,279302,443654
300154152800,30-015-41528,QUIEN SABE 25 FEDERAL 001H,2022-05-01,101,491,1497,1582,83016,280799,445236
300154152800,30-015-41528,QUIEN SABE 25 FEDERAL 001H,2022-06-01,102,245,1545,1516,83261,282344,446752
300154152800,30-015-41528,QUIEN SABE 25 FEDERAL 001H,2022-07-01,103,290,1247,966,83551,283591,447718
300154152800,30-015-41528,QUIEN SABE 25 FEDERAL 001H,2022-08-01,104,122,597,661,83673,284188,448379
300154152800,30-015-41528,QUIEN SABE 25 FEDERAL 001H,2022-09-01,105,0,334,0,83673,284522,448379
300154152800,30-015-41528,QUIEN SABE 25 FEDERAL 001H,2022-10-01,106,427,1860,1281,84100,286382,449660
300154152800,30-015-41528,QUIEN SABE 25 FEDERAL 001H,2022-11-01,107,342,1473,1381,84442,287855,451041
300154152800,30-015-41528,QUIEN SABE 25 FEDERAL 001H,2022-12-01,108,304,1049,1655,84746,288904,452696
300154152800,30-015-41528,QUIEN SABE 25 FEDERAL 001H,2023-01-01,109,321,1512,1566,85067,290416,454262
300154152800,30-015-41528,QUIEN SABE 25 FEDERAL 001H,2023-02-01,110,307,1316,1524,85374,291732,455786
300154152800,30-015-41528,QUIEN SABE 25 FEDERAL 001H,2023-03-01,111,318,1464,1783,85692,293196,457569
300154152800,30-015-41528,QUIEN SABE 25 FEDERAL 001H,2023-04-01,112,311,1376,1518,86003,294572,459087
300154152800,30-015-41528,QUIEN SABE 25 FEDERAL 001H,2023-05-01,113,301,1224,1678,86304,295796,460765
300154152800,30-015-41528,QUIEN SABE 25 FEDERAL 001H,2023-06-01,114,310,1085,1847,86614,296881,462612
300154152800,30-015-41528,QUIEN SABE 25 FEDERAL 001H,2023-07-01,115,268,1201,1370,86882,298082,463982
300154276900,30-015-42769,EL PRESIDENTE STATE 003H,2015-07-01,1,6181,54093,1829,6181,54093,1829
300154276900,30-015-42769,EL PRESIDENTE STATE 003H,2015-08-01,2,9507,70990,43195,15688,125083,45024
300154276900,30-015-42769,EL PRESIDENTE STATE 003H,2015-09-01,3,7710,60046,37851,23398,185129,82875
300154276900,30-015-42769,EL PRESIDENTE STATE 003H,2015-10-01,4,6489,57233,31224,29887,242362,114099
300154276900,30-015-42769,EL PRESIDENTE STATE 003H,2015-11-01,5,5019,50947,27065,34906,293309,141164
300154276900,30-015-42769,EL PRESIDENTE STATE 003H,2015-12-01,6,3916,38283,22295,38822,331592,163459
300154276900,30-015-42769,EL PRESIDENTE STATE 003H,2016-01-01,7,3873,41318,22853,42695,372910,186312
300154276900,30-015-42769,EL PRESIDENTE STATE 003H,2016-02-01,8,3174,34084,34761,45869,406994,221073
300154276900,30-015-42769,EL PRESIDENTE STATE 003H,2016-03-01,9,2930,32220,17272,48799,439214,238345
300154276900,30-015-42769,EL PRESIDENTE STATE 003H,2016-04-01,10,2879,28497,16427,51678,467711,254772
300154276900,30-015-42769,EL PRESIDENTE STATE 003H,2016-05-01,11,2678,28840,14832,54356,496551,269604
300154276900,30-015-42769,EL PRESIDENTE STATE 003H,2016-06-01,12,2358,24451,12456,56714,521002,282060
300154276900,30-015-42769,EL PRESIDENTE STATE 003H,2016-07-01,13,2304,22204,10938,59018,543206,292998
300154276900,30-015-42769,EL PRESIDENTE STATE 003H,2016-08-01,14,2091,21054,10111,61109,564260,303109
300154276900,30-015-42769,EL PRESIDENTE STATE 003H,2016-09-01,15,2207,20949,10114,63316,585209,313223
300154276900,30-015-42769,EL PRESIDENTE STATE 003H,2016-10-01,16,2329,20567,9978,65645,605776,323201
300154276900,30-015-42769,EL PRESIDENTE STATE 003H,2016-11-01,17,1994,18584,9161,67639,624360,332362
300154276900,30-015-42769,EL PRESIDENTE STATE 003H,2016-12-01,18,1733,17286,8166,69372,641646,340528
300154276900,30-015-42769,EL PRESIDENTE STATE 003H,2017-01-01,19,1778,18369,8101,71150,660015,348629
300154276900,30-015-42769,EL PRESIDENTE STATE 003H,2017-02-01,20,1634,16491,6888,72784,676506,355517
300154276900,30-015-42769,EL PRESIDENTE STATE 003H,2017-03-01,21,1783,15254,7484,74567,691760,363001
300154276900,30-015-42769,EL PRESIDENTE STATE 003H,2017-04-01,22,1511,12682,6886,76078,704442,369887
300154276900,30-015-42769,EL PRESIDENTE STATE 003H,2017-05-01,23,1639,14777,7440,77717,719219,377327
300154276900,30-015-42769,EL PRESIDENTE STATE 003H,2017-06-01,24,1538,14027,6645,79255,733246,383972
300154276900,30-015-42769,EL PRESIDENTE STATE 003H,2017-07-01,25,1582,13734,6044,80837,746980,390016
300154276900,30-015-42769,EL PRESIDENTE STATE 003H,2017-08-01,26,1510,14201,5986,82347,761181,396002
300154276900,30-015-42769,EL PRESIDENTE STATE 003H,2017-09-01,27,1139,13156,4991,83486,774337,400993
300154276900,30-015-42769,EL PRESIDENTE STATE 003H,2017-10-01,28,1713,19268,7923,85199,793605,408916
300154276900,30-015-42769,EL PRESIDENTE STATE 003H,2017-11-01,29,1408,12443,6547,86607,806048,415463
300154276900,30-015-42769,EL PRESIDENTE STATE 003H,2017-12-01,30,913,10321,3936,87520,816369,419399
300154276900,30-015-42769,EL PRESIDENTE STATE 003H,2018-01-01,31,1201,15442,5388,88721,831811,424787
300154276900,30-015-42769,EL PRESIDENTE STATE 003H,2018-02-01,32,1330,14073,6753,90051,845884,431540
300154276900,30-015-42769,EL PRESIDENTE STATE 003H,2018-03-01,33,362,5200,2018,90413,851084,433558
300154276900,30-015-42769,EL PRESIDENTE STATE 003H,2018-04-01,34,0,0,0,90413,851084,433558
300154276900,30-015-42769,EL PRESIDENTE STATE 003H,2018-05-01,35,0,0,0,90413,851084,433558
300154276900,30-015-42769,EL PRESIDENTE STATE 003H,2018-06-01,36,0,0,0,90413,851084,433558
300154276900,30-015-42769,EL PRESIDENTE STATE 003H,2018-07-01,37,138,1919,3181,90551,853003,436739
300154276900,30-015-42769,EL PRESIDENTE STATE 003H,2018-08-01,38,1059,21476,23494,91610,874479,460233
300154276900,30-015-42769,EL PRESIDENTE STATE 003H,2018-09-01,39,1046,7631,10945,92656,882110,471178
300154276900,30-015-42769,EL PRESIDENTE STATE 003H,2018-10-01,40,1283,15941,13242,93939,898051,484420
300154276900,30-015-42769,EL PRESIDENTE STATE 003H,2018-11-01,41,1586,0,177,95525,898051,484597
300154276900,30-015-42769,EL PRESIDENTE STATE 003H,2018-12-01,42,1222,1418,3257,96747,899469,487854
300154276900,30-015-42769,EL PRESIDENTE STATE 003H,2019-01-01,43,1621,8770,9915,98368,908239,497769
300154276900,30-015-42769,EL PRESIDENTE STATE 003H,2019-02-01,44,907,13504,9662,99275,921743,507431
300154276900,30-015-42769,EL PRESIDENTE STATE 003H,2019-03-01,45,1051,14266,11124,100326,936009,518555
300154276900,30-015-42769,EL PRESIDENTE STATE 003H,2019-04-01,46,1315,6771,2141,101641,942780,520696
300154276900,30-015-42769,EL PRESIDENTE STATE 003H,2019-05-01,47,1462,9699,7157,103103,952479,527853
300154276900,30-015-42769,EL PRESIDENTE STATE 003H,2019-06-01,48,798,6740,4603,103901,959219,532456
300154276900,30-015-42769,EL PRESIDENTE STATE 003H,2019-07-01,49,632,8677,2578,104533,967896,535034
300154276900,30-015-42769,EL PRESIDENTE STATE 003H,2019-08-01,50,1312,10796,7559,105845,978692,542593
300154276900,30-015-42769,EL PRESIDENTE STATE 003H,2019-09-01,51,691,8569,4286,106536,987261,546879
300154276900,30-015-42769,EL PRESIDENTE STATE 003H,2019-10-01,52,700,7598,2674,107236,994859,549553
300154276900,30-015-42769,EL PRESIDENTE STATE 003H,2019-11-01,53,349,2411,1569,107585,997270,551122
300154276900,30-015-42769,EL PRESIDENTE STATE 003H,2019-12-01,54,462,2773,1586,108047,1000043,552708
300154276900,30-015-42769,EL PRESIDENTE STATE 003H,2020-01-01,55,462,5507,624,108509,1005550,553332
300154276900,30-015-42769,EL PRESIDENTE STATE 003H,2020-02-01,56,0,10,224,108509,1005560,553556
300154276900,30-015-42769,EL PRESIDENTE STATE 003H,2020-03-01,57,700,6752,1120,109209,1012312,554676
300154276900,30-015-42769,EL PRESIDENTE STATE 003H,2020-04-01,58,1718,24831,10658,110927,1037143,565334
300154276900,30-015-42769,EL PRESIDENTE STATE 003H,2020-05-01,59,1057,10752,7376,111984,1047895,572710
300154276900,30-015-42769,EL PRESIDENTE STATE 003H,2020-06-01,60,945,10037,6792,112929,1057932,579502
300154276900,30-015-42769,EL PRESIDENTE STATE 003H,2020-07-01,61,602,7532,4421,113531,1065464,583923
300154276900,30-015-42769,EL PRESIDENTE STATE 003H,2020-08-01,62,853,9012,4895,114384,1074476,588818
300154276900,30-015-42769,EL PRESIDENTE STATE 003H,2020-09-01,63,891,8168,7207,115275,1082644,596025
300154276900,30-015-42769,EL PRESIDENTE STATE 003H,2020-10-01,64,704,6912,5464,115979,1089556,601489
300154276900,30-015-42769,EL PRESIDENTE STATE 003H,2020-11-01,65,628,11959,5996,116607,1101515,607485
300154276900,30-015-42769,EL PRESIDENTE STATE 003H,2020-12-01,66,163,6092,1729,116770,1107607,609214
300154276900,30-015-42769,EL PRESIDENTE STATE 003H,2021-01-01,67,808,9176,4563,117578,1116783,613777
300154276900,30-015-42769,EL PRESIDENTE STATE 003H,2021-02-01,68,321,2766,2292,117899,1119549,616069
300154276900,30-015-42769,EL PRESIDENTE STATE 003H,2021-03-01,69,702,8264,3360,118601,1127813,619429
300154276900,30-015-42769,EL PRESIDENTE STATE 003H,2021-04-01,70,738,7864,3978,119339,1135677,623407
300154276900,30-015-42769,EL PRESIDENTE STATE 003H,2021-05-01,71,682,8674,3932,120021,1144351,627339
300154276900,30-015-42769,EL PRESIDENTE STATE 003H,2021-06-01,72,927,9709,4704,120948,1154060,632043
300154276900,30-015-42769,EL PRESIDENTE STATE 003H,2021-07-01,73,1546,5759,880,122494,1159819,632923
300154276900,30-015-42769,EL PRESIDENTE STATE 003H,2021-08-01,74,1049,10682,6522,123543,1170501,639445
300154276900,30-015-42769,EL PRESIDENTE STATE 003H,2021-09-01,75,570,8370,4422,124113,1178871,643867
300154276900,30-015-42769,EL PRESIDENTE STATE 003H,2021-10-01,76,3,708,0,124116,1179579,643867
300154276900,30-015-42769,EL PRESIDENTE STATE 003H,2021-11-01,77,14,370,416,124130,1179949,644283
300154276900,30-015-42769,EL PRESIDENTE STATE 003H,2021-12-01,78,79,142,55,124209,1180091,644338
300154276900,30-015-42769,EL PRESIDENTE STATE 003H,2022-01-01,79,3,1001,445,124212,1181092,644783
300154276900,30-015-42769,EL PRESIDENTE STATE 003H,2022-02-01,80,0,0,57,124212,1181092,644840
300154276900,30-015-42769,EL PRESIDENTE STATE 003H,2022-03-01,81,234,4677,429,124446,1185769,645269
300154276900,30-015-42769,EL PRESIDENTE STATE 003H,2022-04-01,82,47,532,507,124493,1186301,645776
300154276900,30-015-42769,EL PRESIDENTE STATE 003H,2022-05-01,83,89,3186,116,124582,1189487,645892
300154276900,30-015-42769,EL PRESIDENTE STATE 003H,2022-06-01,84,15,544,0,124597,1190031,645892
300154276900,30-015-42769,EL PRESIDENTE STATE 003H,2022-07-01,85,315,3142,0,124912,1193173,645892
300154276900,30-015-42769,EL PRESIDENTE STATE 003H,2022-08-01,86,29,502,0,124941,1193675,645892
300154276900,30-015-42769,EL PRESIDENTE STATE 003H,2022-09-01,87,42,441,0,124983,1194116,645892
300154276900,30-015-42769,EL PRESIDENTE STATE 003H,2022-10-01,88,877,4204,3499,125860,1198320,649391
300154276900,30-015-42769,EL PRESIDENTE STATE 003H,2022-11-01,89,989,8844,7180,126849,1207164,656571
300154276900,30-015-42769,EL PRESIDENTE STATE 003H,2022-12-01,90,816,7292,6996,127665,1214456,663567
300154276900,30-015-42769,EL PRESIDENTE STATE 003H,2023-01-01,91,615,7311,6214,128280,1221767,669781
300154276900,30-015-42769,EL PRESIDENTE STATE 003H,2023-02-01,92,603,6680,5787,128883,1228447,675568
300154276900,30-015-42769,EL PRESIDENTE STATE 003H,2023-03-01,93,634,6902,5287,129517,1235349,680855
300154276900,30-015-42769,EL PRESIDENTE STATE 003H,2023-04-01,94,531,7021,6122,130048,1242370,686977
300154276900,30-015-42769,EL PRESIDENTE STATE 003H,2023-05-01,95,568,7536,6365,130616,1249906,693342
300154276900,30-015-42769,EL PRESIDENTE STATE 003H,2023-06-01,96,594,7642,6703,131210,1257548,700045
300154459700,30-015-44597,BRANTLEY STATE COM 13 24 27 RB 206H,2018-08-01,1,19292,36385,63563,19292,36385,63563
300154459700,30-015-44597,BRANTLEY STATE COM 13 24 27 RB 206H,2018-09-01,2,26515,45944,59790,45807,82329,123353
300154459700,30-015-44597,BRANTLEY STATE COM 13 24 27 RB 206H,2018-10-01,3,16722,28372,36854,62529,110701,160207
300154459700,30-015-44597,BRANTLEY STATE COM 13 24 27 RB 206H,2018-11-01,4,16808,31988,41133,79337,142689,201340
300154459700,30-015-44597,BRANTLEY STATE COM 13 24 27 RB 206H,2018-12-01,5,13956,24033,41722,93293,166722,243062
300154459700,30-015-44597,BRANTLEY STATE COM 13 24 27 RB 206H,2019-01-01,6,10304,20462,35017,103597,187184,278079
300154459700,30-015-44597,BRANTLEY STATE COM 13 24 27 RB 206H,2019-02-01,7,8546,25039,32198,112143,212223,310277
300154459700,30-015-44597,BRANTLEY STATE COM 13 24 27 RB 206H,2019-03-01,8,7519,20711,27444,119662,232934,337721
300154459700,30-015-44597,BRANTLEY STATE COM 13 24 27 RB 206H,2019-04-01,9,7231,26196,27862,126893,259130,365583
300154459700,30-015-44597,BRANTLEY STATE COM 13 24 27 RB 206H,2019-05-01,10,6850,30112,30995,133743,289242,396578
300154459700,30-015-44597,BRANTLEY STATE COM 13 24 27 RB 206H,2019-06-01,11,5549,25905,27393,139292,315147,423971
300154459700,30-015-44597,BRANTLEY STATE COM 13 24 27 RB 206H,2019-07-01,12,5279,23779,25517,144571,338926,449488
300154459700,30-015-44597,BRANTLEY STATE COM 13 24 27 RB 206H,2019-08-01,13,4572,19579,20889,149143,358505,470377
300154459700,30-015-44597,BRANTLEY STATE COM 13 24 27 RB 206H,2019-09-01,14,4496,18609,21517,153639,377114,491894
300154459700,30-015-44597,BRANTLEY STATE COM 13 24 27 RB 206H,2019-10-01,15,4134,17681,21038,157773,394795,512932
300154459700,30-015-44597,BRANTLEY STATE COM 13 24 27 RB 206H,2019-11-01,16,3934,14966,19224,161707,409761,532156
300154459700,30-015-44597,BRANTLEY STATE COM 13 24 27 RB 206H,2019-12-01,17,3731,16055,16939,165438,425816,549095
300154459700,30-015-44597,BRANTLEY STATE COM 13 24 27 RB 206H,2020-01-01,18,3435,16765,18460,168873,442581,567555
300154459700,30-015-44597,BRANTLEY STATE COM 13 24 27 RB 206H,2020-02-01,19,3112,13716,15837,171985,456297,583392
300154459700,30-015-44597,BRANTLEY STATE COM 13 24 27 RB 206H,2020-03-01,20,3126,17352,15256,175111,473649,598648
300154459700,30-015-44597,BRANTLEY STATE COM 13 24 27 RB 206H,2020-04-01,21,2955,17703,14394,178066,491352,613042
300154459700,30-015-44597,BRANTLEY STATE COM 13 24 27 RB 206H,2020-05-01,22,2758,15497,14067,180824,506849,627109
300154459700,30-015-44597,BRANTLEY STATE COM 13 24 27 RB 206H,2020-06-01,23,380,1866,2140,181204,508715,629249
300154459700,30-015-44597,BRANTLEY STATE COM 13 24 27 RB 206H,2020-07-01,24,0,0,1,181204,508715,629250
300154459700,30-015-44597,BRANTLEY STATE COM 13 24 27 RB 206H,2020-08-01,25,0,0,54,181204,508715,629304
300154459700,30-015-44597,BRANTLEY STATE COM 13 24 27 RB 206H,2020-09-01,26,4,0,3,181208,508715,629307
300154459700,30-015-44597,BRANTLEY STATE COM 13 24 27 RB 206H,2020-10-01,27,0,0,0,181208,508715,629307
300154459700,30-015-44597,BRANTLEY STATE COM 13 24 27 RB 206H,2020-11-01,28,3535,13085,11329,184743,521800,640636
300154459700,30-015-44597,BRANTLEY STATE COM 13 24 27 RB 206H,2020-12-01,29,3004,10340,12012,187747,532140,652648
300154459700,30-015-44597,BRANTLEY STATE COM 13 24 27 RB 206H,2021-01-01,30,2476,9515,10289,190223,541655,662937
300154459700,30-015-44597,BRANTLEY STATE COM 13 24 27 RB 206H,2021-02-01,31,2189,8238,8531,192412,549893,671468
300154459700,30-015-44597,BRANTLEY STATE COM 13 24 27 RB 206H,2021-03-01,32,2337,9109,10328,194749,559002,681796
300154459700,30-015-44597,BRANTLEY STATE COM 13 24 27 RB 206H,2021-04-01,33,2447,10843,11404,197196,569845,693200
300154459700,30-015-44597,BRANTLEY STATE COM 13 24 27 RB 206H,2021-05-01,34,2575,13680,11388,199771,583525,704588
300154459700,30-015-44597,BRANTLEY STATE COM 13 24 27 RB 206H,2021-06-01,35,2417,11334,11970,202188,594859,716558
300154459700,30-015-44597,BRANTLEY STATE COM 13 24 27 RB 206H,2021-07-01,36,2504,12511,13449,204692,607370,730007
300154459700,30-015-44597,BRANTLEY STATE COM 13 24 27 RB 206H,2021-08-01,37,2259,16859,11266,206951,624229,741273
300154459700,30-015-44597,BRANTLEY STATE COM 13 24 27 RB 206H,2021-09-01,38,1966,12248,9490,208917,636477,750763
300154459700,30-015-44597,BRANTLEY STATE COM 13 24 27 RB 206H,2021-10-01,39,2062,13265,10341,210979,649742,761104
300154459700,30-015-44597,BRANTLEY STATE COM 13 24 27 RB 206H,2021-11-01,40,1678,11061,10380,212657,660803,771484
300154459700,30-015-44597,BRANTLEY STATE COM 13 24 27 RB 206H,2021-12-01,41,1853,13459,11923,214510,674262,783407
300154459700,30-015-44597,BRANTLEY STATE COM 13 24 27 RB 206H,2022-01-01,42,1617,11053,10263,216127,685315,793670
300154459700,30-015-44597,BRANTLEY STATE COM 13 24 27 RB 206H,2022-02-01,43,1619,9511,8711,217746,694826,802381
300154459700,30-015-44597,BRANTLEY STATE COM 13 24 27 RB 206H,2022-03-01,44,1832,12605,9066,219578,707431,811447
300154459700,30-015-44597,BRANTLEY STATE COM 13 24 27 RB 206H,2022-04-01,45,1916,14388,9586,221494,721819,821033
300154459700,30-015-44597,BRANTLEY STATE COM 13 24 27 RB 206H,2022-05-01,46,1767,11826,9518,223261,733645,830551
300154459700,30-015-44597,BRANTLEY STATE COM 13 24 27 RB 206H,2022-06-01,47,1687,12256,8768,224948,745901,839319
300154459700,30-015-44597,BRANTLEY STATE COM 13 24 27 RB 206H,2022-07-01,48,1689,9991,8562,226637,755892,847881
300154459700,30-015-44597,BRANTLEY STATE COM 13 24 27 RB 206H,2022-08-01,49,1653,10577,9167,228290,766469,857048
300154459700,30-015-44597,BRANTLEY STATE COM 13 24 27 RB 206H,2022-09-01,50,1512,10487,9027,229802,776956,866075
300154459700,30-015-44597,BRANTLEY STATE COM 13 24 27 RB 206H,2022-10-01,51,1132,6715,6973,230934,783671,873048
300154459700,30-015-44597,BRANTLEY STATE COM 13 24 27 RB 206H,2022-11-01,52,1622,11098,8985,232556,794769,882033
300154459700,30-015-44597,BRANTLEY STATE COM 13 24 27 RB 206H,2022-12-01,53,1665,3525,8304,234221,798294,890337
300154459700,30-015-44597,BRANTLEY STATE COM 13 24 27 RB 206H,2023-01-01,54,1644,10915,10255,235865,809209,900592
300154459700,30-015-44597,BRANTLEY STATE COM 13 24 27 RB 206H,2023-02-01,55,1285,10984,8491,237150,820193,909083
300154459700,30-015-44597,BRANTLEY STATE COM 13 24 27 RB 206H,2023-03-01,56,1292,9505,7407,238442,829698,916490
300154459700,30-015-44597,BRANTLEY STATE COM 13 24 27 RB 206H,2023-04-01,57,1591,11594,9116,240033,841292,925606
300154459700,30-015-44597,BRANTLEY STATE COM 13 24 27 RB 206H,2023-05-01,58,1667,14449,9581,241700,855741,935187
300154459700,30-015-44597,BRANTLEY STATE COM 13 24 27 RB 206H,2023-06-01,59,1427,10818,8183,243127,866559,943370
300154960100,30-015-49601,TONY LA RUSSA 0310 STATE COM 226H,2022-11-01,1,5697,38703,60925,5697,38703,60925
300154960100,30-015-49601,TONY LA RUSSA 0310 STATE COM 226H,2022-12-01,2,18131,123494,123227,23828,162197,184152
300154960100,30-015-49601,TONY LA RUSSA 0310 STATE COM 226H,2023-01-01,3,14136,101264,86907,37964,263461,271059
300154960100,30-015-49601,TONY LA RUSSA 0310 STATE COM 226H,2023-02-01,4,999,5916,5698,38963,269377,276757
300154960100,30-015-49601,TONY LA RUSSA 0310 STATE COM 226H,2023-03-01,5,13020,90983,70359,51983,360360,347116
300154960100,30-015-49601,TONY LA RUSSA 0310 STATE COM 226H,2023-04-01,6,10791,80566,58451,62774,440926,405567
300154960100,30-015-49601,TONY LA RUSSA 0310 STATE COM 226H,2023-05-01,7,9363,77383,53414,72137,518309,458981
300154960100,30-015-49601,TONY LA RUSSA 0310 STATE COM 226H,2023-06-01,8,8236,75922,49966,80373,594231,508947
300153452000,30-015-34520,TAOS FEDERAL 001,2006-09-01,1,0,5038,221,0,5038,221
300153452000,30-015-34520,TAOS FEDERAL 001,2006-10-01,2,131,35450,1049,131,40488,1270
300153452000,30-015-34520,TAOS FEDERAL 001,2006-11-01,3,167,27554,599,298,68042,1869
300153452000,30-015-34520,TAOS FEDERAL 001,2006-12-01,4,187,33091,517,485,101133,2386
300153452000,30-015-34520,TAOS FEDERAL 001,2007-01-01,5,82,31793,513,567,132926,2899
300153452000,30-015-34520,TAOS FEDERAL 001,2007-02-01,6,150,31061,444,717,163987,3343
300153452000,30-015-34520,TAOS FEDERAL 001,2007-03-01,7,62,34999,422,779,198986,3765
300153452000,30-015-34520,TAOS FEDERAL 001,2007-04-01,8,149,35640,439,928,234626,4204
300153452000,30-015-34520,TAOS FEDERAL 001,2007-05-01,9,164,31858,415,1092,266484,4619
300153452000,30-015-34520,TAOS FEDERAL 001,2007-06-01,10,103,33732,327,1195,300216,4946
300153452000,30-015-34520,TAOS FEDERAL 001,2007-07-01,11,48,34837,440,1243,335053,5386
300153452000,30-015-34520,TAOS FEDERAL 001,2007-08-01,12,61,33319,353,1304,368372,5739
300153452000,30-015-34520,TAOS FEDERAL 001,2007-09-01,13,87,36747,327,1391,405119,6066
300153452000,30-015-34520,TAOS FEDERAL 001,2007-10-01,14,61,42172,473,1452,447291,6539
300153452000,30-015-34520,TAOS FEDERAL 001,2007-11-01,15,61,38621,243,1513,485912,6782
300153452000,30-015-34520,TAOS FEDERAL 001,2007-12-01,16,56,43489,199,1569,529401,6981
300153452000,30-015-34520,TAOS FEDERAL 001,2008-01-01,17,80,36738,83,1649,566139,7064
300153452000,30-015-34520,TAOS FEDERAL 001,2008-02-01,18,73,30225,128,1722,596364,7192
300153452000,30-015-34520,TAOS FEDERAL 001,2008-03-01,19,17,12887,256,1739,609251,7448
300153452000,30-015-34520,TAOS FEDERAL 001,2008-04-01,20,25,13307,300,1764,622558,7748
300153452000,30-015-34520,TAOS FEDERAL 001,2008-05-01,21,53,14846,180,1817,637404,7928
300153452000,30-015-34520,TAOS FEDERAL 001,2008-06-01,22,60,14051,106,1877,651455,8034
300153452000,30-015-34520,TAOS FEDERAL 001,2008-07-01,23,59,14955,100,1936,666410,8134
300153452000,30-015-34520,TAOS FEDERAL 001,2008-08-01,24,49,12667,280,1985,679077,8414
300153452000,30-015-34520,TAOS FEDERAL 001,2008-09-01,25,47,12389,142,2032,691466,8556
300153452000,30-015-34520,TAOS FEDERAL 001,2008-10-01,26,62,12588,172,2094,704054,8728
300153452000,30-015-34520,TAOS FEDERAL 001,2008-11-01,27,28,11976,359,2122,716030,9087
300153452000,30-015-34520,TAOS FEDERAL 001,2008-12-01,28,67,13751,262,2189,729781,9349
300153452000,30-015-34520,TAOS FEDERAL 001,2009-01-01,29,70,13711,266,2259,743492,9615
300153452000,30-015-34520,TAOS FEDERAL 001,2009-02-01,30,42,11396,239,2301,754888,9854
300153452000,30-015-34520,TAOS FEDERAL 001,2009-03-01,31,42,7641,242,2343,762529,10096
300153452000,30-015-34520,TAOS FEDERAL 001,2009-04-01,32,45,10902,222,2388,773431,10318
300153452000,30-015-34520,TAOS FEDERAL 001,2009-05-01,33,42,11269,211,2430,784700,10529
300153452000,30-015-34520,TAOS FEDERAL 001,2009-06-01,34,72,10641,201,2502,795341,10730
300153452000,30-015-34520,TAOS FEDERAL 001,2009-07-01,35,96,11004,208,2598,806345,10938
300153452000,30-015-34520,TAOS FEDERAL 001,2009-08-01,36,55,11494,206,2653,817839,11144
300153452000,30-015-34520,TAOS FEDERAL 001,2009-09-01,37,100,11055,183,2753,828894,11327
300153452000,30-015-34520,TAOS FEDERAL 001,2009-10-01,38,86,11238,389,2839,840132,11716
300153452000,30-015-34520,TAOS FEDERAL 001,2009-11-01,39,83,10711,206,2922,850843,11922
300153452000,30-015-34520,TAOS FEDERAL 001,2009-12-01,40,56,10972,195,2978,861815,12117
300153452000,30-015-34520,TAOS FEDERAL 001,2010-01-01,41,60,10860,210,3038,872675,12327
300153452000,30-015-34520,TAOS FEDERAL 001,2010-02-01,42,56,11015,198,3094,883690,12525
300153452000,30-015-34520,TAOS FEDERAL 001,2010-03-01,43,69,19284,198,3163,902974,12723
300153452000,30-015-34520,TAOS FEDERAL 001,2010-04-01,44,22,8659,686,3185,911633,13409
300153452000,30-015-34520,TAOS FEDERAL 001,2010-05-01,45,0,9287,1997,3185,920920,15406
300153452000,30-015-34520,TAOS FEDERAL 001,2010-06-01,46,28,11397,1375,3213,932317,16781
300153452000,30-015-34520,TAOS FEDERAL 001,2010-07-01,47,22,17865,1400,3235,950182,18181
300153452000,30-015-34520,TAOS FEDERAL 001,2010-08-01,48,50,19749,1089,3285,969931,19270
300153452000,30-015-34520,TAOS FEDERAL 001,2010-09-01,49,86,20073,928,3371,990004,20198
300153452000,30-015-34520,TAOS FEDERAL 001,2010-10-01,50,84,20414,797,3455,1010418,20995
300153452000,30-015-34520,TAOS FEDERAL 001,2010-11-01,51,66,20193,703,3521,1030611,21698
300153452000,30-015-34520,TAOS FEDERAL 001,2010-12-01,52,88,20749,725,3609,1051360,22423
300153452000,30-015-34520,TAOS FEDERAL 001,2011-01-01,53,105,20821,628,3714,1072181,23051
300153452000,30-015-34520,TAOS FEDERAL 001,2011-02-01,54,64,17789,614,3778,1089970,23665
300153452000,30-015-34520,TAOS FEDERAL 001,2011-03-01,55,68,19453,552,3846,1109423,24217
300153452000,30-015-34520,TAOS FEDERAL 001,2011-04-01,56,73,18504,492,3919,1127927,24709
300153452000,30-015-34520,TAOS FEDERAL 001,2011-05-01,57,64,18790,464,3983,1146717,25173
300153452000,30-015-34520,TAOS FEDERAL 001,2011-06-01,58,78,17807,433,4061,1164524,25606
300153452000,30-015-34520,TAOS FEDERAL 001,2011-07-01,59,64,18929,419,4125,1183453,26025
300153452000,30-015-34520,TAOS FEDERAL 001,2011-08-01,60,59,18081,362,4184,1201534,26387
300153452000,30-015-34520,TAOS FEDERAL 001,2011-09-01,61,50,18367,226,4234,1219901,26613
300153452000,30-015-34520,TAOS FEDERAL 001,2011-10-01,62,47,15250,170,4281,1235151,26783
300153452000,30-015-34520,TAOS FEDERAL 001,2011-11-01,63,42,14202,219,4323,1249353,27002
300153452000,30-015-34520,TAOS FEDERAL 001,2011-12-01,64,2,14569,156,4325,1263922,27158
300153452000,30-015-34520,TAOS FEDERAL 001,2012-01-01,65,0,13725,301,4325,1277647,27459
300153452000,30-015-34520,TAOS FEDERAL 001,2012-02-01,66,131,12427,156,4456,1290074,27615
300153452000,30-015-34520,TAOS FEDERAL 001,2012-03-01,67,47,17353,163,4503,1307427,27778
300153452000,30-015-34520,TAOS FEDERAL 001,2012-04-01,68,41,17174,433,4544,1324601,28211
300153452000,30-015-34520,TAOS FEDERAL 001,2012-05-01,69,36,17501,158,4580,1342102,28369
300153452000,30-015-34520,TAOS FEDERAL 001,2012-06-01,70,16,16603,276,4596,1358705,28645
300153452000,30-015-34520,TAOS FEDERAL 001,2012-07-01,71,20,9493,213,4616,1368198,28858
300153452000,30-015-34520,TAOS FEDERAL 001,2012-08-01,72,50,16469,96,4666,1384667,28954
300153452000,30-015-34520,TAOS FEDERAL 001,2012-09-01,73,64,15329,19,4730,1399996,28973
300153452000,30-015-34520,TAOS FEDERAL 001,2012-10-01,74,22,15429,156,4752,1415425,29129
300153452000,30-015-34520,TAOS FEDERAL 001,2012-11-01,75,22,14914,137,4774,1430339,29266
300153452000,30-015-34520,TAOS FEDERAL 001,2012-12-01,76,0,15355,179,4774,1445694,29445
300153452000,30-015-34520,TAOS FEDERAL 001,2013-01-01,77,14,14615,246,4788,1460309,29691
300153452000,30-015-34520,TAOS FEDERAL 001,2013-02-01,78,58,13178,281,4846,1473487,29972
300153452000,30-015-34520,TAOS FEDERAL 001,2013-03-01,79,25,14967,267,4871,1488454,30239
300153452000,30-015-34520,TAOS FEDERAL 001,2013-04-01,80,0,14512,339,4871,1502966,30578
300153452000,30-015-34520,TAOS FEDERAL 001,2013-05-01,81,39,14233,200,4910,1517199,30778
300153452000,30-015-34520,TAOS FEDERAL 001,2013-06-01,82,2,13846,285,4912,1531045,31063
300153452000,30-015-34520,TAOS FEDERAL 001,2013-07-01,83,0,14362,339,4912,1545407,31402
300153452000,30-015-34520,TAOS FEDERAL 001,2013-08-01,84,31,14078,253,4943,1559485,31655
300153452000,30-015-34520,TAOS FEDERAL 001,2013-09-01,85,8,13349,253,4951,1572834,31908
300153452000,30-015-34520,TAOS FEDERAL 001,2013-10-01,86,25,12616,269,4976,1585450,32177
300153452000,30-015-34520,TAOS FEDERAL 001,2013-11-01,87,20,12595,244,4996,1598045,32421
300153452000,30-015-34520,TAOS FEDERAL 001,2013-12-01,88,41,13063,248,5037,1611108,32669
300153452000,30-015-34520,TAOS FEDERAL 001,2014-01-01,89,28,13105,262,5065,1624213,32931
300153452000,30-015-34520,TAOS FEDERAL 001,2014-02-01,90,22,10174,211,5087,1634387,33142
300153452000,30-015-34520,TAOS FEDERAL 001,2014-03-01,91,22,12324,255,5109,1646711,33397
300153452000,30-015-34520,TAOS FEDERAL 001,2014-04-01,92,22,11157,236,5131,1657868,33633
300153452000,30-015-34520,TAOS FEDERAL 001,2014-05-01,93,22,11860,296,5153,1669728,33929
300153452000,30-015-34520,TAOS FEDERAL 001,2014-06-01,94,6,9627,170,5159,1679355,34099
300153452000,30-015-34520,TAOS FEDERAL 001,2014-07-01,95,17,11850,316,5176,1691205,34415
300153452000,30-015-34520,TAOS FEDERAL 001,2014-08-01,96,22,11884,253,5198,1703089,34668
300153452000,30-015-34520,TAOS FEDERAL 001,2014-09-01,97,0,9856,143,5198,1712945,34811
300153452000,30-015-34520,TAOS FEDERAL 001,2014-10-01,98,17,10283,187,5215,1723228,34998
300153452000,30-015-34520,TAOS FEDERAL 001,2014-11-01,99,16,11129,234,5231,1734357,35232
300153452000,30-015-34520,TAOS FEDERAL 001,2014-12-01,100,28,10453,231,5259,1744810,35463
300153452000,30-015-34520,TAOS FEDERAL 001,2015-01-01,101,13,3208,19,5272,1748018,35482
300153452000,30-015-34520,TAOS FEDERAL 001,2015-02-01,102,36,6853,190,5308,1754871,35672
300153452000,30-015-34520,TAOS FEDERAL 001,2015-03-01,103,11,7710,234,5319,1762581,35906
300153452000,30-015-34520,TAOS FEDERAL 001,2015-04-01,104,22,10794,235,5341,1773375,36141
300153452000,30-015-34520,TAOS FEDERAL 001,2015-05-01,105,20,12692,267,5361,1786067,36408
300153452000,30-015-34520,TAOS FEDERAL 001,2015-06-01,106,8,11732,204,5369,1797799,36612
300153452000,30-015-34520,TAOS FEDERAL 001,2015-07-01,107,8,7776,169,5377,1805575,36781
300153452000,30-015-34520,TAOS FEDERAL 001,2015-08-01,108,9,10456,240,5386,1816031,37021
300153452000,30-015-34520,TAOS FEDERAL 001,2015-09-01,109,7,10013,233,5393,1826044,37254
300153452000,30-015-34520,TAOS FEDERAL 001,2015-10-01,110,22,12291,227,5415,1838335,37481
300153452000,30-015-34520,TAOS FEDERAL 001,2015-11-01,111,3,11552,217,5418,1849887,37698
300153452000,30-015-34520,TAOS FEDERAL 001,2015-12-01,112,3,9948,189,5421,1859835,37887
300153452000,30-015-34520,TAOS FEDERAL 001,2016-01-01,113,0,6690,258,5421,1866525,38145
300153452000,30-015-34520,TAOS FEDERAL 001,2016-02-01,114,17,8169,232,5438,1874694,38377
300153452000,30-015-34520,TAOS FEDERAL 001,2016-03-01,115,14,7934,156,5452,1882628,38533
300153452000,30-015-34520,TAOS FEDERAL 001,2016-04-01,116,16,9877,245,5468,1892505,38778
300153452000,30-015-34520,TAOS FEDERAL 001,2016-05-01,117,14,10826,225,5482,1903331,39003
300153452000,30-015-34520,TAOS FEDERAL 001,2016-06-01,118,17,8262,141,5499,1911593,39144
300153452000,30-015-34520,TAOS FEDERAL 001,2016-07-01,119,3,10547,237,5502,1922140,39381
300153452000,30-015-34520,TAOS FEDERAL 001,2016-08-01,120,19,10334,208,5521,1932474,39589
300153452000,30-015-34520,TAOS FEDERAL 001,2016-09-01,121,14,9993,187,5535,1942467,39776
300153452000,30-015-34520,TAOS FEDERAL 001,2016-10-01,122,8,10200,200,5543,1952667,39976
300153452000,30-015-34520,TAOS FEDERAL 001,2016-11-01,123,25,9721,176,5568,1962388,40152
300153452000,30-015-34520,TAOS FEDERAL 001,2016-12-01,124,4,9879,189,5572,1972267,40341
300153452000,30-015-34520,TAOS FEDERAL 001,2017-01-01,125,6,9674,242,5578,1981941,40583
300153452000,30-015-34520,TAOS FEDERAL 001,2017-02-01,126,30,8771,197,5608,1990712,40780
300153452000,30-015-34520,TAOS FEDERAL 001,2017-03-01,127,9,9507,183,5617,2000219,40963
300153452000,30-015-34520,TAOS FEDERAL 001,2017-04-01,128,44,9097,118,5661,2009316,41081
300153452000,30-015-34520,TAOS FEDERAL 001,2017-05-01,129,0,9351,224,5661,2018667,41305
300153452000,30-015-34520,TAOS FEDERAL 001,2017-06-01,130,14,7600,158,5675,2026267,41463
300153452000,30-015-34520,TAOS FEDERAL 001,2017-07-01,131,8,8872,253,5683,2035139,41716
300153452000,30-015-34520,TAOS FEDERAL 001,2017-08-01,132,6,9055,195,5689,2044194,41911
300153452000,30-015-34520,TAOS FEDERAL 001,2017-09-01,133,0,8284,174,5689,2052478,42085
300153452000,30-015-34520,TAOS FEDERAL 001,2017-10-01,134,0,9036,214,5689,2061514,42299
300153452000,30-015-34520,TAOS FEDERAL 001,2017-11-01,135,0,8581,188,5689,2070095,42487
300153452000,30-015-34520,TAOS FEDERAL 001,2017-12-01,136,0,8939,203,5689,2079034,42690
300153452000,30-015-34520,TAOS FEDERAL 001,2018-01-01,137,31,8815,167,5720,2087849,42857
300153452000,30-015-34520,TAOS FEDERAL 001,2018-02-01,138,11,7749,167,5731,2095598,43024
300153452000,30-015-34520,TAOS FEDERAL 001,2018-03-01,139,0,9427,253,5731,2105025,43277
300153452000,30-015-34520,TAOS FEDERAL 001,2018-04-01,140,0,8309,161,5731,2113334,43438
300153452000,30-015-34520,TAOS FEDERAL 001,2018-05-01,141,2,8096,203,5733,2121430,43641
300153452000,30-015-34520,TAOS FEDERAL 001,2018-06-01,142,3,6759,126,5736,2128189,43767
300153452000,30-015-34520,TAOS FEDERAL 001,2018-07-01,143,5,8375,194,5741,2136564,43961
300153452000,30-015-34520,TAOS FEDERAL 001,2018-08-01,144,4,8539,172,5745,2145103,44133
300153452000,30-015-34520,TAOS FEDERAL 001,2018-09-01,145,5,7660,219,5750,2152763,44352
300153452000,30-015-34520,TAOS FEDERAL 001,2018-10-01,146,5,7025,217,5755,2159788,44569
300153452000,30-015-34520,TAOS FEDERAL 001,2018-11-01,147,7,5296,181,5762,2165084,44750
300153452000,30-015-34520,TAOS FEDERAL 001,2018-12-01,148,22,6290,226,5784,2171374,44976
300153452000,30-015-34520,TAOS FEDERAL 001,2019-01-01,149,44,5397,211,5828,2176771,45187
300153452000,30-015-34520,TAOS FEDERAL 001,2019-02-01,150,40,5514,181,5868,2182285,45368
300153452000,30-015-34520,TAOS FEDERAL 001,2019-03-01,151,63,5736,181,5931,2188021,45549
300153452000,30-015-34520,TAOS FEDERAL 001,2019-04-01,152,5,6838,251,5936,2194859,45800
300153452000,30-015-34520,TAOS FEDERAL 001,2019-05-01,153,2,6696,167,5938,2201555,45967
300153452000,30-015-34520,TAOS FEDERAL 001,2019-06-01,154,2,6622,163,5940,2208177,46130
300153452000,30-015-34520,TAOS FEDERAL 001,2019-07-01,155,1,7607,242,5941,2215784,46372
300153452000,30-015-34520,TAOS FEDERAL 001,2019-08-01,156,3,7691,216,5944,2223475,46588
300153452000,30-015-34520,TAOS FEDERAL 001,2019-09-01,157,2,7254,191,5946,2230729,46779
300153452000,30-015-34520,TAOS FEDERAL 001,2019-10-01,158,3,7216,183,5949,2237945,46962
300153452000,30-015-34520,TAOS FEDERAL 001,2019-11-01,159,1,7084,178,5950,2245029,47140
300153452000,30-015-34520,TAOS FEDERAL 001,2019-12-01,160,2,5376,167,5952,2250405,47307
300153452000,30-015-34520,TAOS FEDERAL 001,2020-01-01,161,4,6929,178,5956,2257334,47485
300153452000,30-015-34520,TAOS FEDERAL 001,2020-02-01,162,2,5722,150,5958,2263056,47635
300153452000,30-015-34520,TAOS FEDERAL 001,2020-03-01,163,20,5629,237,5978,2268685,47872
300153452000,30-015-34520,TAOS FEDERAL 001,2020-04-01,164,6,622,6,5984,2269307,47878
300153452000,30-015-34520,TAOS FEDERAL 001,2020-05-01,165,10,367,0,5994,2269674,47878
300153452000,30-015-34520,TAOS FEDERAL 001,2020-06-01,166,14,2915,201,6008,2272589,48079
300153452000,30-015-34520,TAOS FEDERAL 001,2020-07-01,167,8,5180,291,6016,2277769,48370
300153452000,30-015-34520,TAOS FEDERAL 001,2020-08-01,168,0,7023,224,6016,2284792,48594
300153452000,30-015-34520,TAOS FEDERAL 001,2020-09-01,169,6,7172,263,6022,2291964,48857
300153452000,30-015-34520,TAOS FEDERAL 001,2020-10-01,170,1,8595,151,6023,2300559,49008
300153452000,30-015-34520,TAOS FEDERAL 001,2020-11-01,171,3,8431,218,6026,2308990,49226
300153452000,30-015-34520,TAOS FEDERAL 001,2020-12-01,172,3,8574,235,6029,2317564,49461
300153452000,30-015-34520,TAOS FEDERAL 001,2021-01-01,173,15,8461,197,6044,2326025,49658
300153452000,30-015-34520,TAOS FEDERAL 001,2021-02-01,174,13,7147,148,6057,2333172,49806
300153452000,30-015-34520,TAOS FEDERAL 001,2021-03-01,175,11,8387,208,6068,2341559,50014
300153452000,30-015-34520,TAOS FEDERAL 001,2021-04-01,176,3,8060,191,6071,2349619,50205
300153452000,30-015-34520,TAOS FEDERAL 001,2021-05-01,177,0,8350,183,6071,2357969,50388
300153452000,30-015-34520,TAOS FEDERAL 001,2021-06-01,178,0,7353,134,6071,2365322,50522
300153452000,30-015-34520,TAOS FEDERAL 001,2021-07-01,179,0,8608,165,6071,2373930,50687
300153452000,30-015-34520,TAOS FEDERAL 001,2021-08-01,180,14,3561,78,6085,2377491,50765
300153452000,30-015-34520,TAOS FEDERAL 001,2021-09-01,181,11,8615,217,6096,2386106,50982
300153452000,30-015-34520,TAOS FEDERAL 001,2021-10-01,182,0,7907,197,6096,2394013,51179
300153452000,30-015-34520,TAOS FEDERAL 001,2021-11-01,183,0,7563,200,6096,2401576,51379
300153452000,30-015-34520,TAOS FEDERAL 001,2021-12-01,184,0,7842,173,6096,2409418,51552
300153452000,30-015-34520,TAOS FEDERAL 001,2022-01-01,185,0,6724,134,6096,2416142,51686
300153452000,30-015-34520,TAOS FEDERAL 001,2022-02-01,186,0,2589,39,6096,2418731,51725
300153452000,30-015-34520,TAOS FEDERAL 001,2022-03-01,187,21,1344,12,6117,2420075,51737
300153452000,30-015-34520,TAOS FEDERAL 001,2022-04-01,188,11,2841,312,6128,2422916,52049
300153452000,30-015-34520,TAOS FEDERAL 001,2022-05-01,189,18,3936,258,6146,2426852,52307
300153452000,30-015-34520,TAOS FEDERAL 001,2022-06-01,190,5,7951,296,6151,2434803,52603
300153452000,30-015-34520,TAOS FEDERAL 001,2022-07-01,191,2,7152,217,6153,2441955,52820
300153452000,30-015-34520,TAOS FEDERAL 001,2022-08-01,192,2,9626,213,6155,2451581,53033
300153452000,30-015-34520,TAOS FEDERAL 001,2022-09-01,193,5,10664,121,6160,2462245,53154
300153452000,30-015-34520,TAOS FEDERAL 001,2022-10-01,194,11,11925,214,6171,2474170,53368
300153452000,30-015-34520,TAOS FEDERAL 001,2022-11-01,195,12,8566,173,6183,2482736,53541
300153452000,30-015-34520,TAOS FEDERAL 001,2022-12-01,196,2,8179,173,6185,2490915,53714
300153452000,30-015-34520,TAOS FEDERAL 001,2023-01-01,197,8,8081,158,6193,2498996,53872
300153452000,30-015-34520,TAOS FEDERAL 001,2023-02-01,198,3,7221,156,6196,2506217,54028
300153452000,30-015-34520,TAOS FEDERAL 001,2023-03-01,199,7,8252,225,6203,2514469,54253
300153452000,30-015-34520,TAOS FEDERAL 001,2023-04-01,200,6,8052,162,6209,2522521,54415
300153452000,30-015-34520,TAOS FEDERAL 001,2023-05-01,201,3,8351,203,6212,2530872,54618
300153452000,30-015-34520,TAOS FEDERAL 001,2023-06-01,202,10,7456,160,6222,2538328,54778
300153583800,30-015-35838,GURKHA BKG STATE COM 001,2008-03-01,1,0,6220,159,0,6220,159
300153583800,30-015-35838,GURKHA BKG STATE COM 001,2008-04-01,2,0,11468,195,0,17688,354
300153583800,30-015-35838,GURKHA BKG STATE COM 001,2008-05-01,3,0,8046,135,0,25734,489
300153583800,30-015-35838,GURKHA BKG STATE COM 001,2008-06-01,4,0,5599,80,0,31333,569
300153583800,30-015-35838,GURKHA BKG STATE COM 001,2008-07-01,5,0,5896,116,0,37229,685
300153583800,30-015-35838,GURKHA BKG STATE COM 001,2008-08-01,6,0,5081,86,0,42310,771
300153583800,30-015-35838,GURKHA BKG STATE COM 001,2008-09-01,7,0,4483,108,0,46793,879
300153583800,30-015-35838,GURKHA BKG STATE COM 001,2008-10-01,8,0,3560,21,0,50353,900
300153583800,30-015-35838,GURKHA BKG STATE COM 001,2008-11-01,9,0,3531,0,0,53884,900
300153583800,30-015-35838,GURKHA BKG STATE COM 001,2008-12-01,10,0,3725,0,0,57609,900
300153583800,30-015-35838,GURKHA BKG STATE COM 001,2009-01-01,11,0,3484,0,0,61093,900
300153583800,30-015-35838,GURKHA BKG STATE COM 001,2009-02-01,12,0,3129,0,0,64222,900
300153583800,30-015-35838,GURKHA BKG STATE COM 001,2009-03-01,13,0,3373,0,0,67595,900
300153583800,30-015-35838,GURKHA BKG STATE COM 001,2009-04-01,14,0,3168,0,0,70763,900
300153583800,30-015-35838,GURKHA BKG STATE COM 001,2009-05-01,15,0,3198,3,0,73961,903
300153583800,30-015-35838,GURKHA BKG STATE COM 001,2009-06-01,16,0,3012,0,0,76973,903
300153583800,30-015-35838,GURKHA BKG STATE COM 001,2009-07-01,17,0,3076,0,0,80049,903
300153583800,30-015-35838,GURKHA BKG STATE COM 001,2009-08-01,18,0,2846,0,0,82895,903
300153583800,30-015-35838,GURKHA BKG STATE COM 001,2009-09-01,19,0,2659,0,0,85554,903
300153583800,30-015-35838,GURKHA BKG STATE COM 001,2009-10-01,20,0,2690,0,0,88244,903
300153583800,30-015-35838,GURKHA BKG STATE COM 001,2009-11-01,21,0,2681,0,0,90925,903
300153583800,30-015-35838,GURKHA BKG STATE COM 001,2009-12-01,22,0,2744,0,0,93669,903
300153583800,30-015-35838,GURKHA BKG STATE COM 001,2010-01-01,23,0,2705,0,0,96374,903
300153583800,30-015-35838,GURKHA BKG STATE COM 001,2010-02-01,24,0,2401,0,0,98775,903
300153583800,30-015-35838,GURKHA BKG STATE COM 001,2010-03-01,25,0,2631,0,0,101406,903
300153583800,30-015-35838,GURKHA BKG STATE COM 001,2010-04-01,26,0,2525,0,0,103931,903
300153583800,30-015-35838,GURKHA BKG STATE COM 001,2010-05-01,27,0,2540,0,0,106471,903
300153583800,30-015-35838,GURKHA BKG STATE COM 001,2010-06-01,28,0,2364,0,0,108835,903
300153583800,30-015-35838,GURKHA BKG STATE COM 001,2010-07-01,29,0,2463,0,0,111298,903
300153583800,30-015-35838,GURKHA BKG STATE COM 001,2010-08-01,30,0,2496,0,0,113794,903
300153583800,30-015-35838,GURKHA BKG STATE COM 001,2010-09-01,31,0,2446,0,0,116240,903
300153583800,30-015-35838,GURKHA BKG STATE COM 001,2010-10-01,32,0,2771,0,0,119011,903
300153583800,30-015-35838,GURKHA BKG STATE COM 001,2010-11-01,33,0,2620,0,0,121631,903
300153583800,30-015-35838,GURKHA BKG STATE COM 001,2010-12-01,34,0,2894,0,0,124525,903
300153583800,30-015-35838,GURKHA BKG STATE COM 001,2011-01-01,35,0,2828,0,0,127353,903
300153583800,30-015-35838,GURKHA BKG STATE COM 001,2011-02-01,36,0,2609,0,0,129962,903
300153583800,30-015-35838,GURKHA BKG STATE COM 001,2011-03-01,37,0,2922,0,0,132884,903
300153583800,30-015-35838,GURKHA BKG STATE COM 001,2011-04-01,38,0,3011,287,0,135895,1190
300153583800,30-015-35838,GURKHA BKG STATE COM 001,2011-05-01,39,0,3140,51,0,139035,1241
300153583800,30-015-35838,GURKHA BKG STATE COM 001,2011-06-01,40,0,2928,8,0,141963,1249
300153583800,30-015-35838,GURKHA BKG STATE COM 001,2011-07-01,41,0,3039,3,0,145002,1252
300153583800,30-015-35838,GURKHA BKG STATE COM 001,2011-08-01,42,0,2933,0,0,147935,1252
300153583800,30-015-35838,GURKHA BKG STATE COM 001,2011-09-01,43,0,2903,111,0,150838,1363
300153583800,30-015-35838,GURKHA BKG STATE COM 001,2011-10-01,44,0,3021,20,0,153859,1383
300153583800,30-015-35838,GURKHA BKG STATE COM 001,2011-11-01,45,0,2862,45,0,156721,1428
300153583800,30-015-35838,GURKHA BKG STATE COM 001,2011-12-01,46,0,2975,3,0,159696,1431
300153583800,30-015-35838,GURKHA BKG STATE COM 001,2012-01-01,47,0,2769,48,0,162465,1479
300153583800,30-015-35838,GURKHA BKG STATE COM 001,2012-02-01,48,0,2695,18,0,165160,1497
300153583800,30-015-35838,GURKHA BKG STATE COM 001,2012-03-01,49,0,2828,0,0,167988,1497
300153583800,30-015-35838,GURKHA BKG STATE COM 001,2012-04-01,50,0,2676,0,0,170664,1497
300153583800,30-015-35838,GURKHA BKG STATE COM 001,2012-05-01,51,0,2691,0,0,173355,1497
300153583800,30-015-35838,GURKHA BKG STATE COM 001,2012-06-01,52,0,2580,26,0,175935,1523
300153583800,30-015-35838,GURKHA BKG STATE COM 001,2012-07-01,53,0,2574,0,0,178509,1523
300153583800,30-015-35838,GURKHA BKG STATE COM 001,2012-08-01,54,0,2651,16,0,181160,1539
300153583800,30-015-35838,GURKHA BKG STATE COM 001,2012-09-01,55,0,2423,53,0,183583,1592
300153583800,30-015-35838,GURKHA BKG STATE COM 001,2012-10-01,56,0,2366,0,0,185949,1592
300153583800,30-015-35838,GURKHA BKG STATE COM 001,2012-11-01,57,0,2282,0,0,188231,1592
300153583800,30-015-35838,GURKHA BKG STATE COM 001,2012-12-01,58,0,2462,0,0,190693,1592
300153583800,30-015-35838,GURKHA BKG STATE COM 001,2013-01-01,59,0,2472,0,0,193165,1592
300153583800,30-015-35838,GURKHA BKG STATE COM 001,2013-02-01,60,0,1580,0,0,194745,1592
300153583800,30-015-35838,GURKHA BKG STATE COM 001,2013-03-01,61,0,2309,0,0,197054,1592
300153583800,30-015-35838,GURKHA BKG STATE COM 001,2013-04-01,62,0,2189,0,0,199243,1592
300153583800,30-015-35838,GURKHA BKG STATE COM 001,2013-05-01,63,0,2210,0,0,201453,1592
300153583800,30-015-35838,GURKHA BKG STATE COM 001,2013-06-01,64,0,2111,0,0,203564,1592
300153583800,30-015-35838,GURKHA BKG STATE COM 001,2013-07-01,65,0,1915,0,0,205479,1592
300153583800,30-015-35838,GURKHA BKG STATE COM 001,2013-08-01,66,0,2136,0,0,207615,1592
300153583800,30-015-35838,GURKHA BKG STATE COM 001,2013-09-01,67,0,2105,0,0,209720,1592
300153583800,30-015-35838,GURKHA BKG STATE COM 001,2013-10-01,68,0,2072,3,0,211792,1595
300153583800,30-015-35838,GURKHA BKG STATE COM 001,2013-11-01,69,0,2005,33,0,213797,1628
300153583800,30-015-35838,GURKHA BKG STATE COM 001,2013-12-01,70,0,1925,0,0,215722,1628
300153583800,30-015-35838,GURKHA BKG STATE COM 001,2014-01-01,71,0,1899,0,0,217621,1628
300153583800,30-015-35838,GURKHA BKG STATE COM 001,2014-02-01,72,0,1761,6,0,219382,1634
300153583800,30-015-35838,GURKHA BKG STATE COM 001,2014-03-01,73,0,1584,0,0,220966,1634
300153583800,30-015-35838,GURKHA BKG STATE COM 001,2014-04-01,74,0,1711,0,0,222677,1634
300153583800,30-015-35838,GURKHA BKG STATE COM 001,2014-05-01,75,0,1834,0,0,224511,1634
300153583800,30-015-35838,GURKHA BKG STATE COM 001,2014-06-01,76,0,1781,0,0,226292,1634
300153583800,30-015-35838,GURKHA BKG STATE COM 001,2014-07-01,77,0,1803,0,0,228095,1634
300153583800,30-015-35838,GURKHA BKG STATE COM 001,2014-08-01,78,0,1790,0,0,229885,1634
300153583800,30-015-35838,GURKHA BKG STATE COM 001,2014-09-01,79,0,1668,0,0,231553,1634
300153583800,30-015-35838,GURKHA BKG STATE COM 001,2014-10-01,80,0,1488,0,0,233041,1634
300153583800,30-015-35838,GURKHA BKG STATE COM 001,2014-11-01,81,0,1515,0,0,234556,1634
300153583800,30-015-35838,GURKHA BKG STATE COM 001,2014-12-01,82,0,1723,0,0,236279,1634
300153583800,30-015-35838,GURKHA BKG STATE COM 001,2015-01-01,83,0,1662,0,0,237941,1634
300153583800,30-015-35838,GURKHA BKG STATE COM 001,2015-02-01,84,0,1631,0,0,239572,1634
300153583800,30-015-35838,GURKHA BKG STATE COM 001,2015-03-01,85,0,1785,0,0,241357,1634
300153583800,30-015-35838,GURKHA BKG STATE COM 001,2015-04-01,86,0,1713,0,0,243070,1634
300153583800,30-015-35838,GURKHA BKG STATE COM 001,2015-05-01,87,0,1732,0,0,244802,1634
300153583800,30-015-35838,GURKHA BKG STATE COM 001,2015-06-01,88,0,1628,0,0,246430,1634
300153583800,30-015-35838,GURKHA BKG STATE COM 001,2015-07-01,89,0,1502,0,0,247932,1634
300153583800,30-015-35838,GURKHA BKG STATE COM 001,2015-08-01,90,0,1663,0,0,249595,1634
300153583800,30-015-35838,GURKHA BKG STATE COM 001,2015-09-01,91,0,1562,0,0,251157,1634
300153583800,30-015-35838,GURKHA BKG STATE COM 001,2015-10-01,92,0,1591,0,0,252748,1634
300153583800,30-015-35838,GURKHA BKG STATE COM 001,2015-11-01,93,0,1536,0,0,254284,1634
300153583800,30-015-35838,GURKHA BKG STATE COM 001,2015-12-01,94,0,1430,0,0,255714,1634
300153583800,30-015-35838,GURKHA BKG STATE COM 001,2016-01-01,95,0,1468,0,0,257182,1634
300153583800,30-015-35838,GURKHA BKG STATE COM 001,2016-02-01,96,0,1389,0,0,258571,1634
300153583800,30-015-35838,GURKHA BKG STATE COM 001,2016-03-01,97,0,1393,0,0,259964,1634
300153583800,30-015-35838,GURKHA BKG STATE COM 001,2016-04-01,98,0,1338,0,0,261302,1634
300153583800,30-015-35838,GURKHA BKG STATE COM 001,2016-05-01,99,0,1340,0,0,262642,1634
300153583800,30-015-35838,GURKHA BKG STATE COM 001,2016-06-01,100,0,1257,0,0,263899,1634
300153583800,30-015-35838,GURKHA BKG STATE COM 001,2016-07-01,101,0,1259,0,0,265158,1634
300153583800,30-015-35838,GURKHA BKG STATE COM 001,2016-08-01,102,0,1246,0,0,266404,1634
300153583800,30-015-35838,GURKHA BKG STATE COM 001,2016-09-01,103,0,652,0,0,267056,1634
300153583800,30-015-35838,GURKHA BKG STATE COM 001,2016-10-01,104,0,259,0,0,267315,1634
300153583800,30-015-35838,GURKHA BKG STATE COM 001,2016-11-01,105,0,420,0,0,267735,1634
300153583800,30-015-35838,GURKHA BKG STATE COM 001,2016-12-01,106,0,193,0,0,267928,1634
300153583800,30-015-35838,GURKHA BKG STATE COM 001,2017-01-01,107,0,398,0,0,268326,1634
300153583800,30-015-35838,GURKHA BKG STATE COM 001,2017-02-01,108,0,290,0,0,268616,1634
300153583800,30-015-35838,GURKHA BKG STATE COM 001,2017-03-01,109,0,628,0,0,269244,1634
300153583800,30-015-35838,GURKHA BKG STATE COM 001,2017-04-01,110,0,2158,178,0,271402,1812
300153583800,30-015-35838,GURKHA BKG STATE COM 001,2017-05-01,111,0,2239,12,0,273641,1824
300153583800,30-015-35838,GURKHA BKG STATE COM 001,2017-06-01,112,0,1749,0,0,275390,1824
300153583800,30-015-35838,GURKHA BKG STATE COM 001,2017-07-01,113,0,1630,0,0,277020,1824
300153583800,30-015-35838,GURKHA BKG STATE COM 001,2017-08-01,114,0,1586,0,0,278606,1824
300153583800,30-015-35838,GURKHA BKG STATE COM 001,2017-09-01,115,0,1673,0,0,280279,1824
300153583800,30-015-35838,GURKHA BKG STATE COM 001,2017-10-01,116,0,1737,0,0,282016,1824
300153583800,30-015-35838,GURKHA BKG STATE COM 001,2017-11-01,117,0,1596,0,0,283612,1824
300153583800,30-015-35838,GURKHA BKG STATE COM 001,2017-12-01,118,0,1589,0,0,285201,1824
300153583800,30-015-35838,GURKHA BKG STATE COM 001,2018-01-01,119,0,1542,6,0,286743,1830
300153583800,30-015-35838,GURKHA BKG STATE COM 001,2018-02-01,120,0,1377,0,0,288120,1830
300153583800,30-015-35838,GURKHA BKG STATE COM 001,2018-03-01,121,0,1487,0,0,289607,1830
300153583800,30-015-35838,GURKHA BKG STATE COM 001,2018-04-01,122,0,1406,0,0,291013,1830
300153583800,30-015-35838,GURKHA BKG STATE COM 001,2018-05-01,123,0,1406,0,0,292419,1830
300153583800,30-015-35838,GURKHA BKG STATE COM 001,2018-06-01,124,0,1300,0,0,293719,1830
300153583800,30-015-35838,GURKHA BKG STATE COM 001,2018-07-01,125,0,1312,0,0,295031,1830
300153583800,30-015-35838,GURKHA BKG STATE COM 001,2018-08-01,126,0,1287,0,0,296318,1830
300153583800,30-015-35838,GURKHA BKG STATE COM 001,2018-09-01,127,0,1202,0,0,297520,1830
300153583800,30-015-35838,GURKHA BKG STATE COM 001,2018-10-01,128,0,1201,0,0,298721,1830
300153583800,30-015-35838,GURKHA BKG STATE COM 001,2018-11-01,129,0,1148,0,0,299869,1830
300153583800,30-015-35838,GURKHA BKG STATE COM 001,2018-12-01,130,0,1185,0,0,301054,1830
300153583800,30-015-35838,GURKHA BKG STATE COM 001,2019-01-01,131,0,1180,0,0,302234,1830
300153583800,30-015-35838,GURKHA BKG STATE COM 001,2019-02-01,132,0,1049,0,0,303283,1830
300153583800,30-015-35838,GURKHA BKG STATE COM 001,2019-03-01,133,0,1137,0,0,304420,1830
300153583800,30-015-35838,GURKHA BKG STATE COM 001,2019-04-01,134,0,1075,0,0,305495,1830
300153583800,30-015-35838,GURKHA BKG STATE COM 001,2019-05-01,135,0,1014,0,0,306509,1830
300153583800,30-015-35838,GURKHA BKG STATE COM 001,2019-06-01,136,0,1051,0,0,307560,1830
300153583800,30-015-35838,GURKHA BKG STATE COM 001,2019-07-01,137,0,1069,0,0,308629,1830
300153583800,30-015-35838,GURKHA BKG STATE COM 001,2019-08-01,138,0,1037,0,0,309666,1830
300153583800,30-015-35838,GURKHA BKG STATE COM 001,2019-09-01,139,0,1027,0,0,310693,1830
300153583800,30-015-35838,GURKHA BKG STATE COM 001,2019-10-01,140,0,1055,0,0,311748,1830
300153583800,30-015-35838,GURKHA BKG STATE COM 001,2019-11-01,141,0,1025,0,0,312773,1830
300153583800,30-015-35838,GURKHA BKG STATE COM 001,2019-12-01,142,0,1044,0,0,313817,1830
300153583800,30-015-35838,GURKHA BKG STATE COM 001,2020-01-01,143,0,1035,0,0,314852,1830
300153583800,30-015-35838,GURKHA BKG STATE COM 001,2020-02-01,144,0,958,0,0,315810,1830
300153583800,30-015-35838,GURKHA BKG STATE COM 001,2020-03-01,145,0,1003,0,0,316813,1830
300153583800,30-015-35838,GURKHA BKG STATE COM 001,2020-04-01,146,0,8,0,0,316821,1830
300153583800,30-015-35838,GURKHA BKG STATE COM 001,2020-05-01,147,0,0,0,0,316821,1830
300153583800,30-015-35838,GURKHA BKG STATE COM 001,2020-06-01,148,0,0,0,0,316821,1830
300153583800,30-015-35838,GURKHA BKG STATE COM 001,2020-07-01,149,0,0,0,0,316821,1830
300153583800,30-015-35838,GURKHA BKG STATE COM 001,2020-08-01,150,0,5,0,0,316826,1830
300153583800,30-015-35838,GURKHA BKG STATE COM 001,2020-09-01,151,0,3,0,0,316829,1830
300153583800,30-015-35838,GURKHA BKG STATE COM 001,2020-10-01,152,0,3,0,0,316832,1830
300153583800,30-015-35838,GURKHA BKG STATE COM 001,2020-11-01,153,0,2,0,0,316834,1830
300153583800,30-015-35838,GURKHA BKG STATE COM 001,2020-12-01,154,0,0,0,0,316834,1830
300153583800,30-015-35838,GURKHA BKG STATE COM 001,2021-01-01,155,0,0,0,0,316834,1830
300153583800,30-015-35838,GURKHA BKG STATE COM 001,2021-02-01,156,0,0,0,0,316834,1830
300153583800,30-015-35838,GURKHA BKG STATE COM 001,2021-03-01,157,0,1199,0,0,318033,1830
300153583800,30-015-35838,GURKHA BKG STATE COM 001,2021-04-01,158,0,1371,0,0,319404,1830
300153583800,30-015-35838,GURKHA BKG STATE COM 001,2021-05-01,159,0,1046,0,0,320450,1830
300153583800,30-015-35838,GURKHA BKG STATE COM 001,2021-06-01,160,0,835,0,0,321285,1830
300153583800,30-015-35838,GURKHA BKG STATE COM 001,2021-07-01,161,0,963,0,0,322248,1830
300153583800,30-015-35838,GURKHA BKG STATE COM 001,2021-08-01,162,0,763,0,0,323011,1830
300153583800,30-015-35838,GURKHA BKG STATE COM 001,2021-09-01,163,0,601,0,0,323612,1830
300153583800,30-015-35838,GURKHA BKG STATE COM 001,2021-10-01,164,0,560,0,0,324172,1830
300153583800,30-015-35838,GURKHA BKG STATE COM 001,2021-11-01,165,0,497,0,0,324669,1830
300153583800,30-015-35838,GURKHA BKG STATE COM 001,2021-12-01,166,0,472,0,0,325141,1830
300153583800,30-015-35838,GURKHA BKG STATE COM 001,2022-01-01,167,0,463,0,0,325604,1830
300153583800,30-015-35838,GURKHA BKG STATE COM 001,2022-02-01,168,0,403,0,0,326007,1830
300153583800,30-015-35838,GURKHA BKG STATE COM 001,2022-03-01,169,0,450,0,0,326457,1830
300153583800,30-015-35838,GURKHA BKG STATE COM 001,2022-04-01,170,0,502,0,0,326959,1830
300153583800,30-015-35838,GURKHA BKG STATE COM 001,2022-05-01,171,0,544,0,0,327503,1830
300153583800,30-015-35838,GURKHA BKG STATE COM 001,2022-06-01,172,0,508,0,0,328011,1830
300153583800,30-015-35838,GURKHA BKG STATE COM 001,2022-07-01,173,0,508,0,0,328519,1830
300153583800,30-015-35838,GURKHA BKG STATE COM 001,2022-08-01,174,0,508,0,0,329027,1830
300153583800,30-015-35838,GURKHA BKG STATE COM 001,2022-09-01,175,0,467,0,0,329494,1830
300153583800,30-015-35838,GURKHA BKG STATE COM 001,2022-10-01,176,0,510,0,0,330004,1830
300153583800,30-015-35838,GURKHA BKG STATE COM 001,2022-11-01,177,0,519,0,0,330523,1830
300153583800,30-015-35838,GURKHA BKG STATE COM 001,2022-12-01,178,0,526,0,0,331049,1830
300153583800,30-015-35838,GURKHA BKG STATE COM 001,2023-01-01,179,0,549,0,0,331598,1830
300153583800,30-015-35838,GURKHA BKG STATE COM 001,2023-02-01,180,0,508,0,0,332106,1830
300153583800,30-015-35838,GURKHA BKG STATE COM 001,2023-03-01,181,0,540,0,0,332646,1830
300153583800,30-015-35838,GURKHA BKG STATE COM 001,2023-04-01,182,0,536,0,0,333182,1830
300153583800,30-015-35838,GURKHA BKG STATE COM 001,2023-05-01,183,0,515,0,0,333697,1830
300153583800,30-015-35838,GURKHA BKG STATE COM 001,2023-06-01,184,0,423,0,0,334120,1830
300153583800,30-015-35838,GURKHA BKG STATE COM 001,2023-07-01,185,0,463,0,0,334583,1830
300152372900,30-015-23729,LOVING 1 STATE 001,1981-11-01,1,0,10193,164,0,10193,164
300152372900,30-015-23729,LOVING 1 STATE 001,1981-12-01,2,0,19527,378,0,29720,542
300152372900,30-015-23729,LOVING 1 STATE 001,1982-01-01,3,0,0,0,0,29720,542
300152372900,30-015-23729,LOVING 1 STATE 001,1982-02-01,4,0,59440,761,0,89160,1303
300152372900,30-015-23729,LOVING 1 STATE 001,1982-03-01,5,30,99674,1042,30,188834,2345
300152372900,30-015-23729,LOVING 1 STATE 001,1982-04-01,6,4,99529,879,34,288363,3224
300152372900,30-015-23729,LOVING 1 STATE 001,1982-05-01,7,2,104620,927,36,392983,4151
300152372900,30-015-23729,LOVING 1 STATE 001,1982-06-01,8,0,96091,812,36,489074,4963
300152372900,30-015-23729,LOVING 1 STATE 001,1982-07-01,9,14,95847,783,50,584921,5746
300152372900,30-015-23729,LOVING 1 STATE 001,1982-08-01,10,6,102987,795,56,687908,6541
300152372900,30-015-23729,LOVING 1 STATE 001,1982-09-01,11,0,91992,690,56,779900,7231
300152372900,30-015-23729,LOVING 1 STATE 001,1982-10-01,12,3,100157,755,59,880057,7986
300152372900,30-015-23729,LOVING 1 STATE 001,1982-11-01,13,0,59306,724,59,939363,8710
300152372900,30-015-23729,LOVING 1 STATE 001,1982-12-01,14,16,100172,689,75,1039535,9399
300152372900,30-015-23729,LOVING 1 STATE 001,1983-01-01,15,0,97876,711,75,1137411,10110
300152372900,30-015-23729,LOVING 1 STATE 001,1983-02-01,16,8,78169,609,83,1215580,10719
300152372900,30-015-23729,LOVING 1 STATE 001,1983-03-01,17,9,94433,753,92,1310013,11472
300152372900,30-015-23729,LOVING 1 STATE 001,1983-04-01,18,6,96168,696,98,1406181,12168
300152372900,30-015-23729,LOVING 1 STATE 001,1983-05-01,19,3,101881,736,101,1508062,12904
300152372900,30-015-23729,LOVING 1 STATE 001,1983-06-01,20,11,94410,652,112,1602472,13556
300152372900,30-015-23729,LOVING 1 STATE 001,1983-07-01,21,0,17227,427,112,1619699,13983
300152372900,30-015-23729,LOVING 1 STATE 001,1983-08-01,22,0,31776,942,112,1651475,14925
300152372900,30-015-23729,LOVING 1 STATE 001,1983-09-01,23,0,54264,853,112,1705739,15778
300152372900,30-015-23729,LOVING 1 STATE 001,1983-10-01,24,0,70055,895,112,1775794,16673
300152372900,30-015-23729,LOVING 1 STATE 001,1983-11-01,25,0,75483,755,112,1851277,17428
300152372900,30-015-23729,LOVING 1 STATE 001,1983-12-01,26,0,83792,828,112,1935069,18256
300152372900,30-015-23729,LOVING 1 STATE 001,1984-01-01,27,0,78026,763,112,2013095,19019
300152372900,30-015-23729,LOVING 1 STATE 001,1984-02-01,28,0,95491,947,112,2108586,19966
300152372900,30-015-23729,LOVING 1 STATE 001,1984-03-01,29,8,100792,876,120,2209378,20842
300152372900,30-015-23729,LOVING 1 STATE 001,1984-04-01,30,11,99015,805,131,2308393,21647
300152372900,30-015-23729,LOVING 1 STATE 001,1984-05-01,31,6,102045,781,137,2410438,22428
300152372900,30-015-23729,LOVING 1 STATE 001,1984-06-01,32,3,53832,487,140,2464270,22915
300152372900,30-015-23729,LOVING 1 STATE 001,1984-07-01,33,17,55570,441,157,2519840,23356
300152372900,30-015-23729,LOVING 1 STATE 001,1984-08-01,34,11,48099,382,168,2567939,23738
300152372900,30-015-23729,LOVING 1 STATE 001,1984-09-01,35,5,38466,282,173,2606405,24020
300152372900,30-015-23729,LOVING 1 STATE 001,1984-10-01,36,3,87233,794,176,2693638,24814
300152372900,30-015-23729,LOVING 1 STATE 001,1984-11-01,37,8,63977,448,184,2757615,25262
300152372900,30-015-23729,LOVING 1 STATE 001,1984-12-01,38,12,100390,674,196,2858005,25936
300152372900,30-015-23729,LOVING 1 STATE 001,1985-01-01,39,16,101697,684,212,2959702,26620
300152372900,30-015-23729,LOVING 1 STATE 001,1985-02-01,40,9,88623,621,221,3048325,27241
300152372900,30-015-23729,LOVING 1 STATE 001,1985-03-01,41,11,76060,593,232,3124385,27834
300152372900,30-015-23729,LOVING 1 STATE 001,1985-04-01,42,8,98279,681,240,3222664,28515
300152372900,30-015-23729,LOVING 1 STATE 001,1985-05-01,43,5,102679,726,245,3325343,29241
300152372900,30-015-23729,LOVING 1 STATE 001,1985-06-01,44,9,130099,690,254,3455442,29931
300152372900,30-015-23729,LOVING 1 STATE 001,1985-07-01,45,16,70071,592,270,3525513,30523
300152372900,30-015-23729,LOVING 1 STATE 001,1985-08-01,46,5,82497,649,275,3608010,31172
300152372900,30-015-23729,LOVING 1 STATE 001,1985-09-01,47,7,80475,633,282,3688485,31805
300152372900,30-015-23729,LOVING 1 STATE 001,1985-10-01,48,5,84095,643,287,3772580,32448
300152372900,30-015-23729,LOVING 1 STATE 001,1985-11-01,49,12,67434,577,299,3840014,33025
300152372900,30-015-23729,LOVING 1 STATE 001,1985-12-01,50,8,99041,789,307,3939055,33814
300152372900,30-015-23729,LOVING 1 STATE 001,1986-01-01,51,9,97563,750,316,4036618,34564
300152372900,30-015-23729,LOVING 1 STATE 001,1986-02-01,52,10,85983,691,326,4122601,35255
300152372900,30-015-23729,LOVING 1 STATE 001,1986-03-01,53,8,72192,690,334,4194793,35945
300152372900,30-015-23729,LOVING 1 STATE 001,1986-04-01,54,5,89375,815,339,4284168,36760
300152372900,30-015-23729,LOVING 1 STATE 001,1986-05-01,55,7,94981,776,346,4379149,37536
300152372900,30-015-23729,LOVING 1 STATE 001,1986-06-01,56,11,91866,772,357,4471015,38308
300152372900,30-015-23729,LOVING 1 STATE 001,1986-07-01,57,3,94299,803,360,4565314,39111
300152372900,30-015-23729,LOVING 1 STATE 001,1986-08-01,58,8,93035,786,368,4658349,39897
300152372900,30-015-23729,LOVING 1 STATE 001,1986-09-01,59,5,72420,732,373,4730769,40629
300152372900,30-015-23729,LOVING 1 STATE 001,1986-10-01,60,7,79557,732,380,4810326,41361
300152372900,30-015-23729,LOVING 1 STATE 001,1986-11-01,61,9,82376,683,389,4892702,42044
300152372900,30-015-23729,LOVING 1 STATE 001,1986-12-01,62,8,81494,730,397,4974196,42774
300152372900,30-015-23729,LOVING 1 STATE 001,1987-01-01,63,7,81618,741,404,5055814,43515
300152372900,30-015-23729,LOVING 1 STATE 001,1987-02-01,64,7,73308,675,411,5129122,44190
300152372900,30-015-23729,LOVING 1 STATE 001,1987-03-01,65,8,81567,751,419,5210689,44941
300152372900,30-015-23729,LOVING 1 STATE 001,1987-04-01,66,8,84526,777,427,5295215,45718
300152372900,30-015-23729,LOVING 1 STATE 001,1987-05-01,67,6,87178,795,433,5382393,46513
300152372900,30-015-23729,LOVING 1 STATE 001,1987-06-01,68,7,84413,786,440,5466806,47299
300152372900,30-015-23729,LOVING 1 STATE 001,1987-07-01,69,8,86477,800,448,5553283,48099
300152372900,30-015-23729,LOVING 1 STATE 001,1987-08-01,70,7,80984,828,455,5634267,48927
300152372900,30-015-23729,LOVING 1 STATE 001,1987-09-01,71,5,81097,802,460,5715364,49729
300152372900,30-015-23729,LOVING 1 STATE 001,1987-10-01,72,6,8686,817,466,5724050,50546
300152372900,30-015-23729,LOVING 1 STATE 001,1987-11-01,73,7,81107,782,473,5805157,51328
300152372900,30-015-23729,LOVING 1 STATE 001,1987-12-01,74,6,81750,790,479,5886907,52118
300152372900,30-015-23729,LOVING 1 STATE 001,1988-01-01,75,6,80728,789,485,5967635,52907
300152372900,30-015-23729,LOVING 1 STATE 001,1988-02-01,76,10,74646,717,495,6042281,53624
300152372900,30-015-23729,LOVING 1 STATE 001,1988-03-01,77,7,78470,780,502,6120751,54404
300152372900,30-015-23729,LOVING 1 STATE 001,1988-04-01,78,2,76190,762,504,6196941,55166
300152372900,30-015-23729,LOVING 1 STATE 001,1988-05-01,79,7,78013,785,511,6274954,55951
300152372900,30-015-23729,LOVING 1 STATE 001,1988-06-01,80,6,74299,756,517,6349253,56707
300152372900,30-015-23729,LOVING 1 STATE 001,1988-07-01,81,6,75895,762,523,6425148,57469
300152372900,30-015-23729,LOVING 1 STATE 001,1988-08-01,82,7,74218,947,530,6499366,58416
300152372900,30-015-23729,LOVING 1 STATE 001,1988-09-01,83,6,71508,753,536,6570874,59169
300152372900,30-015-23729,LOVING 1 STATE 001,1988-10-01,84,6,73801,747,542,6644675,59916
300152372900,30-015-23729,LOVING 1 STATE 001,1988-11-01,85,1,70606,746,543,6715281,60662
300152372900,30-015-23729,LOVING 1 STATE 001,1988-12-01,86,4,71669,688,547,6786950,61350
300152372900,30-015-23729,LOVING 1 STATE 001,1989-01-01,87,5,70799,718,552,6857749,62068
300152372900,30-015-23729,LOVING 1 STATE 001,1989-02-01,88,9,59641,691,561,6917390,62759
300152372900,30-015-23729,LOVING 1 STATE 001,1989-03-01,89,2,64480,783,563,6981870,63542
300152372900,30-015-23729,LOVING 1 STATE 001,1989-04-01,90,0,63008,722,563,7044878,64264
300152372900,30-015-23729,LOVING 1 STATE 001,1989-05-01,91,8,68351,775,571,7113229,65039
300152372900,30-015-23729,LOVING 1 STATE 001,1989-06-01,92,2,62105,706,573,7175334,65745
300152372900,30-015-23729,LOVING 1 STATE 001,1989-07-01,93,0,59987,719,573,7235321,66464
300152372900,30-015-23729,LOVING 1 STATE 001,1989-08-01,94,12,51934,712,585,7287255,67176
300152372900,30-015-23729,LOVING 1 STATE 001,1989-09-01,95,5,58686,705,590,7345941,67881
300152372900,30-015-23729,LOVING 1 STATE 001,1989-10-01,96,3,62504,711,593,7408445,68592
300152372900,30-015-23729,LOVING 1 STATE 001,1989-11-01,97,5,60254,665,598,7468699,69257
300152372900,30-015-23729,LOVING 1 STATE 001,1989-12-01,98,3,62072,711,601,7530771,69968
300152372900,30-015-23729,LOVING 1 STATE 001,1990-01-01,99,7,63973,700,608,7594744,70668
300152372900,30-015-23729,LOVING 1 STATE 001,1990-02-01,100,7,55161,614,615,7649905,71282
300152372900,30-015-23729,LOVING 1 STATE 001,1990-03-01,101,6,62182,674,621,7712087,71956
300152372900,30-015-23729,LOVING 1 STATE 001,1990-04-01,102,9,58180,645,630,7770267,72601
300152372900,30-015-23729,LOVING 1 STATE 001,1990-05-01,103,4,60872,686,634,7831139,73287
300152372900,30-015-23729,LOVING 1 STATE 001,1990-06-01,104,0,58503,653,634,7889642,73940
300152372900,30-015-23729,LOVING 1 STATE 001,1990-07-01,105,5,61328,632,639,7950970,74572
300152372900,30-015-23729,LOVING 1 STATE 001,1990-08-01,106,8,58997,658,647,8009967,75230
300152372900,30-015-23729,LOVING 1 STATE 001,1990-09-01,107,3,57517,552,650,8067484,75782
300152372900,30-015-23729,LOVING 1 STATE 001,1990-10-01,108,1,61713,558,651,8129197,76340
300152372900,30-015-23729,LOVING 1 STATE 001,1990-11-01,109,2,53181,450,653,8182378,76790
300152372900,30-015-23729,LOVING 1 STATE 001,1990-12-01,110,7,57629,310,660,8240007,77100
300152372900,30-015-23729,LOVING 1 STATE 001,1991-01-01,111,4,58336,496,664,8298343,77596
300152372900,30-015-23729,LOVING 1 STATE 001,1991-02-01,112,3,49208,448,667,8347551,78044
300152372900,30-015-23729,LOVING 1 STATE 001,1991-03-01,113,11,57287,465,678,8404838,78509
300152372900,30-015-23729,LOVING 1 STATE 001,1991-04-01,114,2,51675,420,680,8456513,78929
300152372900,30-015-23729,LOVING 1 STATE 001,1991-05-01,115,0,51062,496,680,8507575,79425
300152372900,30-015-23729,LOVING 1 STATE 001,1991-06-01,116,5,49663,690,685,8557238,80115
300152372900,30-015-23729,LOVING 1 STATE 001,1991-07-01,117,5,51484,620,690,8608722,80735
300152372900,30-015-23729,LOVING 1 STATE 001,1991-08-01,118,0,49136,480,690,8657858,81215
300152372900,30-015-23729,LOVING 1 STATE 001,1991-09-01,119,0,43922,648,690,8701780,81863
300152372900,30-015-23729,LOVING 1 STATE 001,1991-10-01,120,0,34779,496,690,8736559,82359
300152372900,30-015-23729,LOVING 1 STATE 001,1991-11-01,121,0,37036,677,690,8773595,83036
300152372900,30-015-23729,LOVING 1 STATE 001,1991-12-01,122,0,33273,592,690,8806868,83628
300152372900,30-015-23729,LOVING 1 STATE 001,1992-01-01,123,0,44984,705,690,8851852,84333
300152372900,30-015-23729,LOVING 1 STATE 001,1992-02-01,124,0,41021,623,690,8892873,84956
300152372900,30-015-23729,LOVING 1 STATE 001,1992-03-01,125,9,47428,655,699,8940301,85611
300152372900,30-015-23729,LOVING 1 STATE 001,1992-04-01,126,13,45244,612,712,8985545,86223
300152372900,30-015-23729,LOVING 1 STATE 001,1992-05-01,127,13,46102,647,725,9031647,86870
300152372900,30-015-23729,LOVING 1 STATE 001,1992-06-01,128,0,42683,579,725,9074330,87449
300152372900,30-015-23729,LOVING 1 STATE 001,1992-07-01,129,0,48331,620,725,9122661,88069
300152372900,30-015-23729,LOVING 1 STATE 001,1992-08-01,130,0,50480,656,725,9173141,88725
300152372900,30-015-23729,LOVING 1 STATE 001,1992-09-01,131,0,48185,669,725,9221326,89394
300152372900,30-015-23729,LOVING 1 STATE 001,1992-10-01,132,0,47397,596,725,9268723,89990
300152372900,30-015-23729,LOVING 1 STATE 001,1992-11-01,133,0,44653,588,725,9313376,90578
300152372900,30-015-23729,LOVING 1 STATE 001,1992-12-01,134,0,42819,535,725,9356195,91113
300152372900,30-015-23729,LOVING 1 STATE 001,1993-01-01,135,0,32190,503,725,9388385,91616
300152372900,30-015-23729,LOVING 1 STATE 001,1993-02-01,136,0,22159,488,725,9410544,92104
300152372900,30-015-23729,LOVING 1 STATE 001,1993-03-01,137,0,33820,540,725,9444364,92644
300152372900,30-015-23729,LOVING 1 STATE 001,1993-04-01,138,77,31115,462,802,9475479,93106
300152372900,30-015-23729,LOVING 1 STATE 001,1993-05-01,139,5,35876,565,807,9511355,93671
300152372900,30-015-23729,LOVING 1 STATE 001,1993-06-01,140,0,34454,516,807,9545809,94187
300152372900,30-015-23729,LOVING 1 STATE 001,1993-07-01,141,12,40547,600,819,9586356,94787
300152372900,30-015-23729,LOVING 1 STATE 001,1993-08-01,142,4,40533,562,823,9626889,95349
300152372900,30-015-23729,LOVING 1 STATE 001,1993-09-01,143,7,35095,531,830,9661984,95880
300152372900,30-015-23729,LOVING 1 STATE 001,1993-10-01,144,7,29568,492,837,9691552,96372
300152372900,30-015-23729,LOVING 1 STATE 001,1993-11-01,145,6,27453,484,843,9719005,96856
300152372900,30-015-23729,LOVING 1 STATE 001,1993-12-01,146,1,29529,505,844,9748534,97361
300152372900,30-015-23729,LOVING 1 STATE 001,1994-01-01,147,0,29821,522,844,9778355,97883
300152372900,30-015-23729,LOVING 1 STATE 001,1994-02-01,148,5,31221,503,849,9809576,98386
300152372900,30-015-23729,LOVING 1 STATE 001,1994-03-01,149,1,31242,494,850,9840818,98880
300152372900,30-015-23729,LOVING 1 STATE 001,1994-04-01,150,0,35621,579,850,9876439,99459
300152372900,30-015-23729,LOVING 1 STATE 001,1994-05-01,151,0,36408,624,850,9912847,100083
300152372900,30-015-23729,LOVING 1 STATE 001,1994-06-01,152,2,28959,457,852,9941806,100540
300152372900,30-015-23729,LOVING 1 STATE 001,1994-07-01,153,1,29929,526,853,9971735,101066
300152372900,30-015-23729,LOVING 1 STATE 001,1994-08-01,154,0,37678,554,853,10009413,101620
300152372900,30-015-23729,LOVING 1 STATE 001,1994-09-01,155,0,0,0,853,10009413,101620
300152372900,30-015-23729,LOVING 1 STATE 001,1994-10-01,156,0,34802,577,853,10044215,102197
300152372900,30-015-23729,LOVING 1 STATE 001,1994-11-01,157,0,40563,555,853,10084778,102752
300152372900,30-015-23729,LOVING 1 STATE 001,1994-12-01,158,0,40563,555,853,10125341,103307
300152372900,30-015-23729,LOVING 1 STATE 001,1995-01-01,159,0,40563,555,853,10165904,103862
300152372900,30-015-23729,LOVING 1 STATE 001,1995-02-01,160,10,36423,540,863,10202327,104402
300152372900,30-015-23729,LOVING 1 STATE 001,1995-03-01,161,0,41226,543,863,10243553,104945
300152372900,30-015-23729,LOVING 1 STATE 001,1995-04-01,162,12,37142,554,875,10280695,105499
300152372900,30-015-23729,LOVING 1 STATE 001,1995-05-01,163,2,35817,560,877,10316512,106059
300152372900,30-015-23729,LOVING 1 STATE 001,1995-06-01,164,2,33265,506,879,10349777,106565
300152372900,30-015-23729,LOVING 1 STATE 001,1995-07-01,165,2,36772,547,881,10386549,107112
300152372900,30-015-23729,LOVING 1 STATE 001,1995-08-01,166,0,37008,535,881,10423557,107647
300152372900,30-015-23729,LOVING 1 STATE 001,1995-09-01,167,26,28709,581,907,10452266,108228
300152372900,30-015-23729,LOVING 1 STATE 001,1995-10-01,168,2,37361,591,909,10489627,108819
300152372900,30-015-23729,LOVING 1 STATE 001,1995-11-01,169,2,35893,591,911,10525520,109410
300152372900,30-015-23729,LOVING 1 STATE 001,1995-12-01,170,0,0,0,911,10525520,109410
300152372900,30-015-23729,LOVING 1 STATE 001,1996-01-01,171,5,36830,531,916,10562350,109941
300152372900,30-015-23729,LOVING 1 STATE 001,1996-02-01,172,1,32281,462,917,10594631,110403
300152372900,30-015-23729,LOVING 1 STATE 001,1996-03-01,173,0,33535,534,917,10628166,110937
300152372900,30-015-23729,LOVING 1 STATE 001,1996-04-01,174,1,34156,513,918,10662322,111450
300152372900,30-015-23729,LOVING 1 STATE 001,1996-05-01,175,0,28508,423,918,10690830,111873
300152372900,30-015-23729,LOVING 1 STATE 001,1996-06-01,176,0,28454,447,918,10719284,112320
300152372900,30-015-23729,LOVING 1 STATE 001,1996-07-01,177,5,28339,573,923,10747623,112893
300152372900,30-015-23729,LOVING 1 STATE 001,1996-08-01,178,8,27556,531,931,10775179,113424
300152372900,30-015-23729,LOVING 1 STATE 001,1996-09-01,179,2,25942,492,933,10801121,113916
300152372900,30-015-23729,LOVING 1 STATE 001,1996-10-01,180,107,24620,633,1040,10825741,114549
300152372900,30-015-23729,LOVING 1 STATE 001,1996-11-01,181,121,24758,861,1161,10850499,115410
300152372900,30-015-23729,LOVING 1 STATE 001,1996-12-01,182,73,25528,772,1234,10876027,116182
300152372900,30-015-23729,LOVING 1 STATE 001,1997-01-01,183,41,24167,738,1275,10900194,116920
300152372900,30-015-23729,LOVING 1 STATE 001,1997-02-01,184,23,22090,660,1298,10922284,117580
300152372900,30-015-23729,LOVING 1 STATE 001,1997-03-01,185,7,24017,714,1305,10946301,118294
300152372900,30-015-23729,LOVING 1 STATE 001,1997-04-01,186,9,24435,718,1314,10970736,119012
300152372900,30-015-23729,LOVING 1 STATE 001,1997-05-01,187,85,25394,666,1399,10996130,119678
300152372900,30-015-23729,LOVING 1 STATE 001,1997-06-01,188,20,24081,666,1419,11020211,120344
300152372900,30-015-23729,LOVING 1 STATE 001,1997-07-01,189,27,22988,600,1446,11043199,120944
300152372900,30-015-23729,LOVING 1 STATE 001,1997-08-01,190,20,24350,666,1466,11067549,121610
300152372900,30-015-23729,LOVING 1 STATE 001,1997-09-01,191,19,22948,666,1485,11090497,122276
300152372900,30-015-23729,LOVING 1 STATE 001,1997-10-01,192,13,23205,568,1498,11113702,122844
300152372900,30-015-23729,LOVING 1 STATE 001,1997-11-01,193,12,23760,338,1510,11137462,123182
300152372900,30-015-23729,LOVING 1 STATE 001,1997-12-01,194,20,23575,94,1530,11161037,123276
300152372900,30-015-23729,LOVING 1 STATE 001,1998-01-01,195,13,22849,517,1543,11183886,123793
300152372900,30-015-23729,LOVING 1 STATE 001,1998-02-01,196,21,22211,498,1564,11206097,124291
300152372900,30-015-23729,LOVING 1 STATE 001,1998-03-01,197,11,0,528,1575,11206097,124819
300152372900,30-015-23729,LOVING 1 STATE 001,1998-04-01,198,50,22536,513,1625,11228633,125332
300152372900,30-015-23729,LOVING 1 STATE 001,1998-05-01,199,9,27231,438,1634,11255864,125770
300152372900,30-015-23729,LOVING 1 STATE 001,1998-06-01,200,10,24772,376,1644,11280636,126146
300152372900,30-015-23729,LOVING 1 STATE 001,1998-07-01,201,54,24840,356,1698,11305476,126502
300152372900,30-015-23729,LOVING 1 STATE 001,1998-08-01,202,12,25155,0,1710,11330631,126502
300152372900,30-015-23729,LOVING 1 STATE 001,1998-09-01,203,17,22385,288,1727,11353016,126790
300152372900,30-015-23729,LOVING 1 STATE 001,1998-10-01,204,21,23372,303,1748,11376388,127093
300152372900,30-015-23729,LOVING 1 STATE 001,1998-11-01,205,14,23152,260,1762,11399540,127353
300152372900,30-015-23729,LOVING 1 STATE 001,1998-12-01,206,6,23174,240,1768,11422714,127593
300152372900,30-015-23729,LOVING 1 STATE 001,1999-01-01,207,7,22498,310,1775,11445212,127903
300152372900,30-015-23729,LOVING 1 STATE 001,1999-02-01,208,10,20372,234,1785,11465584,128137
300152372900,30-015-23729,LOVING 1 STATE 001,1999-03-01,209,11,13998,572,1796,11479582,128709
300152372900,30-015-23729,LOVING 1 STATE 001,1999-04-01,210,10,228120,263,1806,11707702,128972
300152372900,30-015-23729,LOVING 1 STATE 001,1999-05-01,211,8,22288,49,1814,11729990,129021
300152372900,30-015-23729,LOVING 1 STATE 001,1999-06-01,212,21,22140,262,1835,11752130,129283
300152372900,30-015-23729,LOVING 1 STATE 001,1999-07-01,213,38,18385,183,1873,11770515,129466
300152372900,30-015-23729,LOVING 1 STATE 001,1999-08-01,214,11,21732,348,1884,11792247,129814
300152372900,30-015-23729,LOVING 1 STATE 001,1999-09-01,215,9,17883,273,1893,11810130,130087
300152372900,30-015-23729,LOVING 1 STATE 001,1999-10-01,216,14,18374,369,1907,11828504,130456
300152372900,30-015-23729,LOVING 1 STATE 001,1999-11-01,217,12,17934,345,1919,11846438,130801
300152372900,30-015-23729,LOVING 1 STATE 001,1999-12-01,218,13,17890,369,1932,11864328,131170
300152372900,30-015-23729,LOVING 1 STATE 001,2000-01-01,219,35,17391,333,1967,11881719,131503
300152372900,30-015-23729,LOVING 1 STATE 001,2000-02-01,220,34,16790,337,2001,11898509,131840
300152372900,30-015-23729,LOVING 1 STATE 001,2000-03-01,221,32,18599,360,2033,11917108,132200
300152372900,30-015-23729,LOVING 1 STATE 001,2000-04-01,222,0,17755,381,2033,11934863,132581
300152372900,30-015-23729,LOVING 1 STATE 001,2000-05-01,223,0,17929,140,2033,11952792,132721
300152372900,30-015-23729,LOVING 1 STATE 001,2000-06-01,224,0,14998,150,2033,11967790,132871
300152372900,30-015-23729,LOVING 1 STATE 001,2000-07-01,225,0,14885,300,2033,11982675,133171
300152372900,30-015-23729,LOVING 1 STATE 001,2000-08-01,226,28,18291,432,2061,12000966,133603
300152372900,30-015-23729,LOVING 1 STATE 001,2000-09-01,227,2,12829,288,2063,12013795,133891
300152372900,30-015-23729,LOVING 1 STATE 001,2000-10-01,228,25,16310,414,2088,12030105,134305
300152372900,30-015-23729,LOVING 1 STATE 001,2000-11-01,229,9,16209,441,2097,12046314,134746
300152372900,30-015-23729,LOVING 1 STATE 001,2000-12-01,230,2,15650,318,2099,12061964,135064
300152372900,30-015-23729,LOVING 1 STATE 001,2001-01-01,231,24,15909,312,2123,12077873,135376
300152372900,30-015-23729,LOVING 1 STATE 001,2001-02-01,232,23,13426,135,2146,12091299,135511
300152372900,30-015-23729,LOVING 1 STATE 001,2001-03-01,233,16,14849,132,2162,12106148,135643
300152372900,30-015-23729,LOVING 1 STATE 001,2001-04-01,234,32,13070,75,2194,12119218,135718
300152372900,30-015-23729,LOVING 1 STATE 001,2001-05-01,235,27,14143,54,2221,12133361,135772
300152372900,30-015-23729,LOVING 1 STATE 001,2001-06-01,236,0,6955,129,2221,12140316,135901
300152372900,30-015-23729,LOVING 1 STATE 001,2001-07-01,237,30,15700,231,2251,12156016,136132
300152372900,30-015-23729,LOVING 1 STATE 001,2001-08-01,238,3,14695,162,2254,12170711,136294
300152372900,30-015-23729,LOVING 1 STATE 001,2001-09-01,239,6,13671,186,2260,12184382,136480
300152372900,30-015-23729,LOVING 1 STATE 001,2001-10-01,240,21,11371,168,2281,12195753,136648
300152372900,30-015-23729,LOVING 1 STATE 001,2001-11-01,241,0,384,0,2281,12196137,136648
300152372900,30-015-23729,LOVING 1 STATE 001,2001-12-01,242,0,6041,327,2281,12202178,136975
300152372900,30-015-23729,LOVING 1 STATE 001,2002-01-01,243,0,14764,685,2281,12216942,137660
300152372900,30-015-23729,LOVING 1 STATE 001,2002-02-01,244,0,15635,687,2281,12232577,138347
300152372900,30-015-23729,LOVING 1 STATE 001,2002-03-01,245,0,17643,681,2281,12250220,139028
300152372900,30-015-23729,LOVING 1 STATE 001,2002-04-01,246,0,17617,610,2281,12267837,139638
300152372900,30-015-23729,LOVING 1 STATE 001,2002-05-01,247,0,17930,583,2281,12285767,140221
300152372900,30-015-23729,LOVING 1 STATE 001,2002-06-01,248,0,16069,501,2281,12301836,140722
300152372900,30-015-23729,LOVING 1 STATE 001,2002-07-01,249,0,13027,495,2281,12314863,141217
300152372900,30-015-23729,LOVING 1 STATE 001,2002-08-01,250,1,14026,621,2282,12328889,141838
300152372900,30-015-23729,LOVING 1 STATE 001,2002-09-01,251,1,12148,579,2283,12341037,142417
300152372900,30-015-23729,LOVING 1 STATE 001,2002-10-01,252,0,11846,538,2283,12352883,142955
300152372900,30-015-23729,LOVING 1 STATE 001,2002-11-01,253,0,6520,439,2283,12359403,143394
300152372900,30-015-23729,LOVING 1 STATE 001,2002-12-01,254,0,1851,481,2283,12361254,143875
300152372900,30-015-23729,LOVING 1 STATE 001,2003-01-01,255,0,193,3,2283,12361447,143878
300152372900,30-015-23729,LOVING 1 STATE 001,2003-02-01,256,0,107,257,2283,12361554,144135
300152372900,30-015-23729,LOVING 1 STATE 001,2003-03-01,257,0,0,0,2283,12361554,144135
300152372900,30-015-23729,LOVING 1 STATE 001,2003-04-01,258,0,0,0,2283,12361554,144135
300152372900,30-015-23729,LOVING 1 STATE 001,2003-05-01,259,0,498,27,2283,12362052,144162
300152372900,30-015-23729,LOVING 1 STATE 001,2003-06-01,260,0,287,0,2283,12362339,144162
300152372900,30-015-23729,LOVING 1 STATE 001,2003-07-01,261,0,284,0,2283,12362623,144162
300152372900,30-015-23729,LOVING 1 STATE 001,2003-08-01,262,0,100,0,2283,12362723,144162
300152372900,30-015-23729,LOVING 1 STATE 001,2003-09-01,263,0,0,0,2283,12362723,144162
300152372900,30-015-23729,LOVING 1 STATE 001,2003-10-01,264,0,0,0,2283,12362723,144162
300152372900,30-015-23729,LOVING 1 STATE 001,2003-11-01,265,0,0,0,2283,12362723,144162
300152372900,30-015-23729,LOVING 1 STATE 001,2003-12-01,266,0,0,0,2283,12362723,144162
300152372900,30-015-23729,LOVING 1 STATE 001,2004-01-01,267,0,6,0,2283,12362729,144162
300152372900,30-015-23729,LOVING 1 STATE 001,2004-02-01,268,0,0,0,2283,12362729,144162
300152372900,30-015-23729,LOVING 1 STATE 001,2004-03-01,269,0,0,0,2283,12362729,144162
300152372900,30-015-23729,LOVING 1 STATE 001,2004-04-01,270,0,0,0,2283,12362729,144162
300152372900,30-015-23729,LOVING 1 STATE 001,2004-05-01,271,0,0,0,2283,12362729,144162
300152372900,30-015-23729,LOVING 1 STATE 001,2004-06-01,272,0,0,0,2283,12362729,144162
300152372900,30-015-23729,LOVING 1 STATE 001,2004-07-01,273,0,0,0,2283,12362729,144162
300152372900,30-015-23729,LOVING 1 STATE 001,2004-08-01,274,0,0,0,2283,12362729,144162
300152372900,30-015-23729,LOVING 1 STATE 001,2004-09-01,275,0,0,0,2283,12362729,144162
300152372900,30-015-23729,LOVING 1 STATE 001,2004-10-01,276,0,0,0,2283,12362729,144162
300152372900,30-015-23729,LOVING 1 STATE 001,2004-11-01,277,0,0,0,2283,12362729,144162
300152372900,30-015-23729,LOVING 1 STATE 001,2004-12-01,278,0,0,0,2283,12362729,144162
300152372900,30-015-23729,LOVING 1 STATE 001,2005-01-01,279,0,0,0,2283,12362729,144162
300152372900,30-015-23729,LOVING 1 STATE 001,2005-02-01,280,0,0,0,2283,12362729,144162
300152372900,30-015-23729,LOVING 1 STATE 001,2005-03-01,281,0,0,0,2283,12362729,144162
300152372900,30-015-23729,LOVING 1 STATE 001,2005-04-01,282,0,0,0,2283,12362729,144162
300152372900,30-015-23729,LOVING 1 STATE 001,2005-05-01,283,0,0,0,2283,12362729,144162
300152372900,30-015-23729,LOVING 1 STATE 001,2005-06-01,284,0,0,0,2283,12362729,144162
300152372900,30-015-23729,LOVING 1 STATE 001,2005-07-01,285,0,0,0,2283,12362729,144162
300152372900,30-015-23729,LOVING 1 STATE 001,2005-08-01,286,0,0,0,2283,12362729,144162
300152372900,30-015-23729,LOVING 1 STATE 001,2005-09-01,287,0,0,0,2283,12362729,144162
300152372900,30-015-23729,LOVING 1 STATE 001,2005-10-01,288,0,0,0,2283,12362729,144162
300152372900,30-015-23729,LOVING 1 STATE 001,2005-11-01,289,0,0,0,2283,12362729,144162
300152372900,30-015-23729,LOVING 1 STATE 001,2005-12-01,290,0,0,0,2283,12362729,144162
300152372900,30-015-23729,LOVING 1 STATE 001,2006-01-01,291,0,0,0,2283,12362729,144162
300152372900,30-015-23729,LOVING 1 STATE 001,2006-02-01,292,0,0,0,2283,12362729,144162
300152372900,30-015-23729,LOVING 1 STATE 001,2006-03-01,293,0,0,0,2283,12362729,144162
300152372900,30-015-23729,LOVING 1 STATE 001,2006-04-01,294,0,0,0,2283,12362729,144162
300152372900,30-015-23729,LOVING 1 STATE 001,2006-05-01,295,81,7000,373,2364,12369729,144535
300154453200,30-015-44532,ANNABELLE 18 13 W2P0 FEDERAL COM 001H,2018-03-01,1,2845,28359,59347,2845,28359,59347
300154453200,30-015-44532,ANNABELLE 18 13 W2P0 FEDERAL COM 001H,2018-04-01,2,16181,146582,99210,19026,174941,158557
300154453200,30-015-44532,ANNABELLE 18 13 W2P0 FEDERAL COM 001H,2018-05-01,3,16503,176874,85217,35529,351815,243774
300154453200,30-015-44532,ANNABELLE 18 13 W2P0 FEDERAL COM 001H,2018-06-01,4,11534,145895,60606,47063,497710,304380
300154453200,30-015-44532,ANNABELLE 18 13 W2P0 FEDERAL COM 001H,2018-07-01,5,8888,120410,47798,55951,618120,352178
300154453200,30-015-44532,ANNABELLE 18 13 W2P0 FEDERAL COM 001H,2018-08-01,6,5826,79011,31548,61777,697131,383726
300154453200,30-015-44532,ANNABELLE 18 13 W2P0 FEDERAL COM 001H,2018-09-01,7,4114,48508,20385,65891,745639,404111
300154453200,30-015-44532,ANNABELLE 18 13 W2P0 FEDERAL COM 001H,2018-10-01,8,2090,25927,12414,67981,771566,416525
300154453200,30-015-44532,ANNABELLE 18 13 W2P0 FEDERAL COM 001H,2018-11-01,9,3355,34892,15258,71336,806458,431783
300154453200,30-015-44532,ANNABELLE 18 13 W2P0 FEDERAL COM 001H,2018-12-01,10,4359,52882,24076,75695,859340,455859
300154453200,30-015-44532,ANNABELLE 18 13 W2P0 FEDERAL COM 001H,2019-01-01,11,4651,56564,23867,80346,915904,479726
300154453200,30-015-44532,ANNABELLE 18 13 W2P0 FEDERAL COM 001H,2019-02-01,12,3817,44727,21931,84163,960631,501657
300154453200,30-015-44532,ANNABELLE 18 13 W2P0 FEDERAL COM 001H,2019-03-01,13,4147,46342,23040,88310,1006973,524697
300154453200,30-015-44532,ANNABELLE 18 13 W2P0 FEDERAL COM 001H,2019-04-01,14,4027,42811,20552,92337,1049784,545249
300154453200,30-015-44532,ANNABELLE 18 13 W2P0 FEDERAL COM 001H,2019-05-01,15,3928,40761,21500,96265,1090545,566749
300154453200,30-015-44532,ANNABELLE 18 13 W2P0 FEDERAL COM 001H,2019-06-01,16,4101,39742,19534,100366,1130287,586283
300154453200,30-015-44532,ANNABELLE 18 13 W2P0 FEDERAL COM 001H,2019-07-01,17,3179,44585,21386,103545,1174872,607669
300154453200,30-015-44532,ANNABELLE 18 13 W2P0 FEDERAL COM 001H,2019-08-01,18,2675,32269,15432,106220,1207141,623101
300154453200,30-015-44532,ANNABELLE 18 13 W2P0 FEDERAL COM 001H,2019-09-01,19,2902,36561,18869,109122,1243702,641970
300154453200,30-015-44532,ANNABELLE 18 13 W2P0 FEDERAL COM 001H,2019-10-01,20,3114,37630,17187,112236,1281332,659157
300154453200,30-015-44532,ANNABELLE 18 13 W2P0 FEDERAL COM 001H,2019-11-01,21,3194,34651,15790,115430,1315983,674947
300154453200,30-015-44532,ANNABELLE 18 13 W2P0 FEDERAL COM 001H,2019-12-01,22,2471,29975,12354,117901,1345958,687301
300154453200,30-015-44532,ANNABELLE 18 13 W2P0 FEDERAL COM 001H,2020-01-01,23,2640,30929,14936,120541,1376887,702237
300154453200,30-015-44532,ANNABELLE 18 13 W2P0 FEDERAL COM 001H,2020-02-01,24,2108,25728,11783,122649,1402615,714020
300154453200,30-015-44532,ANNABELLE 18 13 W2P0 FEDERAL COM 001H,2020-03-01,25,2882,35886,15205,125531,1438501,729225
300154453200,30-015-44532,ANNABELLE 18 13 W2P0 FEDERAL COM 001H,2020-04-01,26,564,4348,2498,126095,1442849,731723
300154453200,30-015-44532,ANNABELLE 18 13 W2P0 FEDERAL COM 001H,2020-05-01,27,372,5061,421,126467,1447910,732144
300154453200,30-015-44532,ANNABELLE 18 13 W2P0 FEDERAL COM 001H,2020-06-01,28,2212,27851,11289,128679,1475761,743433
300154453200,30-015-44532,ANNABELLE 18 13 W2P0 FEDERAL COM 001H,2020-07-01,29,3528,53896,25188,132207,1529657,768621
300154453200,30-015-44532,ANNABELLE 18 13 W2P0 FEDERAL COM 001H,2020-08-01,30,2978,44356,18215,135185,1574013,786836
300154453200,30-015-44532,ANNABELLE 18 13 W2P0 FEDERAL COM 001H,2020-09-01,31,2541,39783,15761,137726,1613796,802597
300154453200,30-015-44532,ANNABELLE 18 13 W2P0 FEDERAL COM 001H,2020-10-01,32,2477,37520,15238,140203,1651316,817835
300154453200,30-015-44532,ANNABELLE 18 13 W2P0 FEDERAL COM 001H,2020-11-01,33,2396,34423,15261,142599,1685739,833096
300154453200,30-015-44532,ANNABELLE 18 13 W2P0 FEDERAL COM 001H,2020-12-01,34,2389,34943,14551,144988,1720682,847647
300154453200,30-015-44532,ANNABELLE 18 13 W2P0 FEDERAL COM 001H,2021-01-01,35,2310,32732,13538,147298,1753414,861185
300154453200,30-015-44532,ANNABELLE 18 13 W2P0 FEDERAL COM 001H,2021-02-01,36,1828,26093,11327,149126,1779507,872512
300154453200,30-015-44532,ANNABELLE 18 13 W2P0 FEDERAL COM 001H,2021-03-01,37,2282,31244,14647,151408,1810751,887159
300154453200,30-015-44532,ANNABELLE 18 13 W2P0 FEDERAL COM 001H,2021-04-01,38,1989,28608,13583,153397,1839359,900742
300154453200,30-015-44532,ANNABELLE 18 13 W2P0 FEDERAL COM 001H,2021-05-01,39,2114,28115,13557,155511,1867474,914299
300154453200,30-015-44532,ANNABELLE 18 13 W2P0 FEDERAL COM 001H,2021-06-01,40,1907,25862,12211,157418,1893336,926510
300154453200,30-015-44532,ANNABELLE 18 13 W2P0 FEDERAL COM 001H,2021-07-01,41,1906,26573,13291,159324,1919909,939801
300154453200,30-015-44532,ANNABELLE 18 13 W2P0 FEDERAL COM 001H,2021-08-01,42,1847,25198,12420,161171,1945107,952221
300154453200,30-015-44532,ANNABELLE 18 13 W2P0 FEDERAL COM 001H,2021-09-01,43,1739,24810,11425,162910,1969917,963646
300154453200,30-015-44532,ANNABELLE 18 13 W2P0 FEDERAL COM 001H,2021-10-01,44,1819,28523,11636,164729,1998440,975282
300154453200,30-015-44532,ANNABELLE 18 13 W2P0 FEDERAL COM 001H,2021-11-01,45,1893,25799,10545,166622,2024239,985827
300154453200,30-015-44532,ANNABELLE 18 13 W2P0 FEDERAL COM 001H,2021-12-01,46,1729,26480,10841,168351,2050719,996668
300154453200,30-015-44532,ANNABELLE 18 13 W2P0 FEDERAL COM 001H,2022-01-01,47,1610,23025,10100,169961,2073744,1006768
300154453200,30-015-44532,ANNABELLE 18 13 W2P0 FEDERAL COM 001H,2022-02-01,48,1412,21450,8489,171373,2095194,1015257
300154453200,30-015-44532,ANNABELLE 18 13 W2P0 FEDERAL COM 001H,2022-03-01,49,1715,27198,11892,173088,2122392,1027149
300154453200,30-015-44532,ANNABELLE 18 13 W2P0 FEDERAL COM 001H,2022-04-01,50,1623,24752,9422,174711,2147144,1036571
300154453200,30-015-44532,ANNABELLE 18 13 W2P0 FEDERAL COM 001H,2022-05-01,51,1761,25131,10071,176472,2172275,1046642
300154453200,30-015-44532,ANNABELLE 18 13 W2P0 FEDERAL COM 001H,2022-06-01,52,1563,28689,10866,178035,2200964,1057508
300154453200,30-015-44532,ANNABELLE 18 13 W2P0 FEDERAL COM 001H,2022-07-01,53,1339,22166,7713,179374,2223130,1065221
300154453200,30-015-44532,ANNABELLE 18 13 W2P0 FEDERAL COM 001H,2022-08-01,54,1567,25536,13008,180941,2248666,1078229
300154453200,30-015-44532,ANNABELLE 18 13 W2P0 FEDERAL COM 001H,2022-09-01,55,1549,24154,11101,182490,2272820,1089330
300154453200,30-015-44532,ANNABELLE 18 13 W2P0 FEDERAL COM 001H,2022-10-01,56,1516,25125,9031,184006,2297945,1098361
300154453200,30-015-44532,ANNABELLE 18 13 W2P0 FEDERAL COM 001H,2022-11-01,57,1483,22779,9256,185489,2320724,1107617
300154453200,30-015-44532,ANNABELLE 18 13 W2P0 FEDERAL COM 001H,2022-12-01,58,1137,17196,6808,186626,2337920,1114425
300154453200,30-015-44532,ANNABELLE 18 13 W2P0 FEDERAL COM 001H,2023-01-01,59,153,3533,995,186779,2341453,1115420
300154453200,30-015-44532,ANNABELLE 18 13 W2P0 FEDERAL COM 001H,2023-02-01,60,1340,22249,6930,188119,2363702,1122350
300154453200,30-015-44532,ANNABELLE 18 13 W2P0 FEDERAL COM 001H,2023-03-01,61,1352,26221,12443,189471,2389923,1134793
300154453200,30-015-44532,ANNABELLE 18 13 W2P0 FEDERAL COM 001H,2023-04-01,62,1097,19356,10476,190568,2409279,1145269
300154453200,30-015-44532,ANNABELLE 18 13 W2P0 FEDERAL COM 001H,2023-05-01,63,1273,21829,10452,191841,2431108,1155721
300154453200,30-015-44532,ANNABELLE 18 13 W2P0 FEDERAL COM 001H,2023-06-01,64,1350,21713,8861,193191,2452821,1164582
300154453200,30-015-44532,ANNABELLE 18 13 W2P0 FEDERAL COM 001H,2023-07-01,65,1157,18740,8396,194348,2471561,1172978
300152372900,30-015-23729,LOVING 1 STATE 001,2006-06-01,1,0,6966,939,2364,12376695,145474
300152372900,30-015-23729,LOVING 1 STATE 001,2006-07-01,2,0,10142,991,2364,12386837,146465
300152372900,30-015-23729,LOVING 1 STATE 001,2006-08-01,3,36,6245,498,2400,12393082,146963
300152372900,30-015-23729,LOVING 1 STATE 001,2006-09-01,4,9,4771,300,2409,12397853,147263
300152372900,30-015-23729,LOVING 1 STATE 001,2006-10-01,5,1,3434,231,2410,12401287,147494
300152372900,30-015-23729,LOVING 1 STATE 001,2006-11-01,6,2,3627,234,2412,12404914,147728
300152372900,30-015-23729,LOVING 1 STATE 001,2006-12-01,7,44,3087,201,2456,12408001,147929
300152372900,30-015-23729,LOVING 1 STATE 001,2007-01-01,8,18,2851,258,2474,12410852,148187
300152372900,30-015-23729,LOVING 1 STATE 001,2007-02-01,9,0,2412,207,2474,12413264,148394
300152372900,30-015-23729,LOVING 1 STATE 001,2007-03-01,10,17,2637,171,2491,12415901,148565
300152372900,30-015-23729,LOVING 1 STATE 001,2007-04-01,11,42,2387,180,2533,12418288,148745
300152372900,30-015-23729,LOVING 1 STATE 001,2007-05-01,12,16,2227,111,2549,12420515,148856
300152372900,30-015-23729,LOVING 1 STATE 001,2007-06-01,13,23,1554,102,2572,12422069,148958
300152372900,30-015-23729,LOVING 1 STATE 001,2007-07-01,14,51,1631,201,2623,12423700,149159
300152372900,30-015-23729,LOVING 1 STATE 001,2007-08-01,15,41,1810,222,2664,12425510,149381
300152372900,30-015-23729,LOVING 1 STATE 001,2007-09-01,16,34,1992,203,2698,12427502,149584
300152372900,30-015-23729,LOVING 1 STATE 001,2007-10-01,17,13,1565,173,2711,12429067,149757
300152372900,30-015-23729,LOVING 1 STATE 001,2007-11-01,18,24,1606,126,2735,12430673,149883
300152372900,30-015-23729,LOVING 1 STATE 001,2007-12-01,19,26,1726,150,2761,12432399,150033
300152372900,30-015-23729,LOVING 1 STATE 001,2008-01-01,20,32,1542,158,2793,12433941,150191
300152372900,30-015-23729,LOVING 1 STATE 001,2008-02-01,21,37,1354,162,2830,12435295,150353
300152372900,30-015-23729,LOVING 1 STATE 001,2008-03-01,22,25,1035,144,2855,12436330,150497
300152372900,30-015-23729,LOVING 1 STATE 001,2008-04-01,23,27,1828,235,2882,12438158,150732
300152372900,30-015-23729,LOVING 1 STATE 001,2008-05-01,24,29,1847,206,2911,12440005,150938
300152372900,30-015-23729,LOVING 1 STATE 001,2008-06-01,25,22,1280,149,2933,12441285,151087
300152372900,30-015-23729,LOVING 1 STATE 001,2008-07-01,26,37,1184,187,2970,12442469,151274
300152372900,30-015-23729,LOVING 1 STATE 001,2008-08-01,27,31,1165,162,3001,12443634,151436
300152372900,30-015-23729,LOVING 1 STATE 001,2008-09-01,28,18,1149,167,3019,12444783,151603
300152372900,30-015-23729,LOVING 1 STATE 001,2008-10-01,29,4,1270,233,3023,12446053,151836
300152372900,30-015-23729,LOVING 1 STATE 001,2008-11-01,30,18,1065,179,3041,12447118,152015
300152372900,30-015-23729,LOVING 1 STATE 001,2008-12-01,31,27,1034,160,3068,12448152,152175
300152372900,30-015-23729,LOVING 1 STATE 001,2009-01-01,32,26,947,153,3094,12449099,152328
300152372900,30-015-23729,LOVING 1 STATE 001,2009-02-01,33,33,948,135,3127,12450047,152463
300152372900,30-015-23729,LOVING 1 STATE 001,2009-03-01,34,29,1001,173,3156,12451048,152636
300152372900,30-015-23729,LOVING 1 STATE 001,2009-04-01,35,31,970,152,3187,12452018,152788
300152372900,30-015-23729,LOVING 1 STATE 001,2009-05-01,36,23,993,150,3210,12453011,152938
300152372900,30-015-23729,LOVING 1 STATE 001,2009-06-01,37,25,882,185,3235,12453893,153123
300152372900,30-015-23729,LOVING 1 STATE 001,2009-07-01,38,20,841,156,3255,12454734,153279
300152372900,30-015-23729,LOVING 1 STATE 001,2009-08-01,39,19,1011,200,3274,12455745,153479
300152372900,30-015-23729,LOVING 1 STATE 001,2009-09-01,40,19,851,156,3293,12456596,153635
300152372900,30-015-23729,LOVING 1 STATE 001,2009-10-01,41,18,887,165,3311,12457483,153800
300152372900,30-015-23729,LOVING 1 STATE 001,2009-11-01,42,33,979,171,3344,12458462,153971
300152372900,30-015-23729,LOVING 1 STATE 001,2009-12-01,43,30,631,126,3374,12459093,154097
300152372900,30-015-23729,LOVING 1 STATE 001,2010-01-01,44,2,175,9,3376,12459268,154106
300152372900,30-015-23729,LOVING 1 STATE 001,2010-02-01,45,30,1064,321,3406,12460332,154427
300152372900,30-015-23729,LOVING 1 STATE 001,2010-03-01,46,33,1266,243,3439,12461598,154670
300152372900,30-015-23729,LOVING 1 STATE 001,2010-04-01,47,26,1058,147,3465,12462656,154817
300152372900,30-015-23729,LOVING 1 STATE 001,2010-05-01,48,29,849,138,3494,12463505,154955
300152372900,30-015-23729,LOVING 1 STATE 001,2010-06-01,49,17,417,96,3511,12463922,155051
300152372900,30-015-23729,LOVING 1 STATE 001,2010-07-01,50,6,289,197,3517,12464211,155248
300152372900,30-015-23729,LOVING 1 STATE 001,2010-08-01,51,22,1604,344,3539,12465815,155592
300152372900,30-015-23729,LOVING 1 STATE 001,2010-09-01,52,14,1264,219,3553,12467079,155811
300152372900,30-015-23729,LOVING 1 STATE 001,2010-10-01,53,0,228,6,3553,12467307,155817
300152372900,30-015-23729,LOVING 1 STATE 001,2010-11-01,54,28,616,140,3581,12467923,155957
300152372900,30-015-23729,LOVING 1 STATE 001,2010-12-01,55,0,18,0,3581,12467941,155957
300152372900,30-015-23729,LOVING 1 STATE 001,2011-01-01,56,12,13,138,3593,12467954,156095
300152372900,30-015-23729,LOVING 1 STATE 001,2011-02-01,57,27,2053,207,3620,12470007,156302
300152372900,30-015-23729,LOVING 1 STATE 001,2011-03-01,58,9,2644,89,3629,12472651,156391
300152372900,30-015-23729,LOVING 1 STATE 001,2011-04-01,59,11,2305,0,3640,12474956,156391
300152372900,30-015-23729,LOVING 1 STATE 001,2011-05-01,60,0,1900,0,3640,12476856,156391
300152372900,30-015-23729,LOVING 1 STATE 001,2011-06-01,61,0,1017,6,3640,12477873,156397
300152372900,30-015-23729,LOVING 1 STATE 001,2011-07-01,62,31,1301,269,3671,12479174,156666
300152372900,30-015-23729,LOVING 1 STATE 001,2011-08-01,63,60,810,362,3731,12479984,157028
300152372900,30-015-23729,LOVING 1 STATE 001,2011-09-01,64,37,1463,237,3768,12481447,157265
300152372900,30-015-23729,LOVING 1 STATE 001,2011-10-01,65,20,1083,228,3788,12482530,157493
300152372900,30-015-23729,LOVING 1 STATE 001,2011-11-01,66,24,400,110,3812,12482930,157603
300152372900,30-015-23729,LOVING 1 STATE 001,2011-12-01,67,0,245,66,3812,12483175,157669
300152372900,30-015-23729,LOVING 1 STATE 001,2012-01-01,68,22,936,241,3834,12484111,157910
300152372900,30-015-23729,LOVING 1 STATE 001,2012-02-01,69,12,558,114,3846,12484669,158024
300152372900,30-015-23729,LOVING 1 STATE 001,2012-03-01,70,43,836,156,3889,12485505,158180
300152372900,30-015-23729,LOVING 1 STATE 001,2012-04-01,71,0,3,0,3889,12485508,158180
300152372900,30-015-23729,LOVING 1 STATE 001,2012-05-01,72,0,210,0,3889,12485718,158180
300152372900,30-015-23729,LOVING 1 STATE 001,2012-06-01,73,0,255,0,3889,12485973,158180
300152372900,30-015-23729,LOVING 1 STATE 001,2012-07-01,74,0,260,0,3889,12486233,158180
300152372900,30-015-23729,LOVING 1 STATE 001,2012-08-01,75,0,244,0,3889,12486477,158180
300152372900,30-015-23729,LOVING 1 STATE 001,2012-09-01,76,0,25,0,3889,12486502,158180
300152372900,30-015-23729,LOVING 1 STATE 001,2012-10-01,77,0,0,0,3889,12486502,158180
300152372900,30-015-23729,LOVING 1 STATE 001,2012-11-01,78,0,0,0,3889,12486502,158180
300152372900,30-015-23729,LOVING 1 STATE 001,2012-12-01,79,0,0,0,3889,12486502,158180
300152372900,30-015-23729,LOVING 1 STATE 001,2013-01-01,80,0,0,0,3889,12486502,158180
300152372900,30-015-23729,LOVING 1 STATE 001,2013-02-01,81,0,0,0,3889,12486502,158180
300152372900,30-015-23729,LOVING 1 STATE 001,2013-03-01,82,0,0,0,3889,12486502,158180
300152372900,30-015-23729,LOVING 1 STATE 001,2013-04-01,83,0,0,0,3889,12486502,158180
300152372900,30-015-23729,LOVING 1 STATE 001,2013-05-01,84,0,0,0,3889,12486502,158180
300152372900,30-015-23729,LOVING 1 STATE 001,2013-06-01,85,0,0,0,3889,12486502,158180
300152372900,30-015-23729,LOVING 1 STATE 001,2013-07-01,86,140,3042,568,4029,12489544,158748
300152372900,30-015-23729,LOVING 1 STATE 001,2013-08-01,87,33,1754,400,4062,12491298,159148
300152372900,30-015-23729,LOVING 1 STATE 001,2013-09-01,88,28,723,221,4090,12492021,159369
300152372900,30-015-23729,LOVING 1 STATE 001,2013-10-01,89,0,0,6,4090,12492021,159375
300152372900,30-015-23729,LOVING 1 STATE 001,2013-11-01,90,0,0,0,4090,12492021,159375
300152372900,30-015-23729,LOVING 1 STATE 001,2013-12-01,91,0,0,0,4090,12492021,159375
300152372900,30-015-23729,LOVING 1 STATE 001,2014-01-01,92,0,74,14,4090,12492095,159389
300152372900,30-015-23729,LOVING 1 STATE 001,2014-02-01,93,78,1834,566,4168,12493929,159955
300152372900,30-015-23729,LOVING 1 STATE 001,2014-03-01,94,46,1101,242,4214,12495030,160197
300152372900,30-015-23729,LOVING 1 STATE 001,2014-04-01,95,0,3,408,4214,12495033,160605
300152372900,30-015-23729,LOVING 1 STATE 001,2014-05-01,96,0,0,172,4214,12495033,160777
300152372900,30-015-23729,LOVING 1 STATE 001,2014-06-01,97,0,56,254,4214,12495089,161031
300152372900,30-015-23729,LOVING 1 STATE 001,2014-07-01,98,52,666,198,4266,12495755,161229
300152372900,30-015-23729,LOVING 1 STATE 001,2014-08-01,99,26,879,118,4292,12496634,161347
300152372900,30-015-23729,LOVING 1 STATE 001,2014-09-01,100,0,0,0,4292,12496634,161347
300152372900,30-015-23729,LOVING 1 STATE 001,2014-10-01,101,0,0,0,4292,12496634,161347
300152372900,30-015-23729,LOVING 1 STATE 001,2014-11-01,102,0,9,5,4292,12496643,161352
300152372900,30-015-23729,LOVING 1 STATE 001,2014-12-01,103,0,0,0,4292,12496643,161352
300152372900,30-015-23729,LOVING 1 STATE 001,2015-01-01,104,0,0,0,4292,12496643,161352
300152372900,30-015-23729,LOVING 1 STATE 001,2015-02-01,105,0,0,0,4292,12496643,161352
300152372900,30-015-23729,LOVING 1 STATE 001,2015-03-01,106,0,0,0,4292,12496643,161352
300152372900,30-015-23729,LOVING 1 STATE 001,2015-04-01,107,0,0,0,4292,12496643,161352
300152372900,30-015-23729,LOVING 1 STATE 001,2015-05-01,108,0,0,0,4292,12496643,161352
300152372900,30-015-23729,LOVING 1 STATE 001,2015-06-01,109,0,0,0,4292,12496643,161352
300152372900,30-015-23729,LOVING 1 STATE 001,2015-07-01,110,0,0,0,4292,12496643,161352
300152372900,30-015-23729,LOVING 1 STATE 001,2015-08-01,111,0,0,0,4292,12496643,161352
300152372900,30-015-23729,LOVING 1 STATE 001,2015-09-01,112,0,0,0,4292,12496643,161352
300152372900,30-015-23729,LOVING 1 STATE 001,2015-10-01,113,0,0,3,4292,12496643,161355
300152372900,30-015-23729,LOVING 1 STATE 001,2015-11-01,114,0,0,0,4292,12496643,161355
300152372900,30-015-23729,LOVING 1 STATE 001,2015-12-01,115,0,0,0,4292,12496643,161355
300152372900,30-015-23729,LOVING 1 STATE 001,2016-01-01,116,0,0,0,4292,12496643,161355
300152372900,30-015-23729,LOVING 1 STATE 001,2016-02-01,117,63,523,0,4355,12497166,161355
300152372900,30-015-23729,LOVING 1 STATE 001,2016-03-01,118,19,2014,260,4374,12499180,161615
300152372900,30-015-23729,LOVING 1 STATE 001,2016-04-01,119,0,553,0,4374,12499733,161615
300152372900,30-015-23729,LOVING 1 STATE 001,2016-05-01,120,0,134,0,4374,12499867,161615
300153470100,30-015-34701,RED BAT FEE 001,2007-03-01,1,0,1928,0,0,1928,0
300153470100,30-015-34701,RED BAT FEE 001,2007-04-01,2,0,3202,0,0,5130,0
300153470100,30-015-34701,RED BAT FEE 001,2007-05-01,3,0,3445,0,0,8575,0
300153470100,30-015-34701,RED BAT FEE 001,2007-06-01,4,0,2476,0,0,11051,0
300153470100,30-015-34701,RED BAT FEE 001,2007-07-01,5,0,7123,0,0,18174,0
300153470100,30-015-34701,RED BAT FEE 001,2007-08-01,6,0,12136,0,0,30310,0
300153470100,30-015-34701,RED BAT FEE 001,2007-09-01,7,0,382,0,0,30692,0
300153470100,30-015-34701,RED BAT FEE 001,2007-10-01,8,0,1275,0,0,31967,0
300153470100,30-015-34701,RED BAT FEE 001,2007-11-01,9,0,0,0,0,31967,0
300153470100,30-015-34701,RED BAT FEE 001,2007-12-01,10,0,0,0,0,31967,0
300153470100,30-015-34701,RED BAT FEE 001,2008-01-01,11,0,0,0,0,31967,0
300153470100,30-015-34701,RED BAT FEE 001,2008-02-01,12,0,848,0,0,32815,0
300153470100,30-015-34701,RED BAT FEE 001,2008-03-01,13,0,2758,0,0,35573,0
300153470100,30-015-34701,RED BAT FEE 001,2008-04-01,14,0,5234,0,0,40807,0
300153470100,30-015-34701,RED BAT FEE 001,2008-05-01,15,0,4946,0,0,45753,0
300153470100,30-015-34701,RED BAT FEE 001,2008-06-01,16,0,4598,0,0,50351,0
300153470100,30-015-34701,RED BAT FEE 001,2008-07-01,17,0,4227,0,0,54578,0
300153470100,30-015-34701,RED BAT FEE 001,2008-08-01,18,0,3794,0,0,58372,0
300153470100,30-015-34701,RED BAT FEE 001,2008-09-01,19,0,3779,0,0,62151,0
300153470100,30-015-34701,RED BAT FEE 001,2008-10-01,20,0,3484,0,0,65635,0
300153470100,30-015-34701,RED BAT FEE 001,2008-11-01,21,0,3015,0,0,68650,0
300153470100,30-015-34701,RED BAT FEE 001,2008-12-01,22,0,3015,0,0,71665,0
300153470100,30-015-34701,RED BAT FEE 001,2009-01-01,23,0,1098,0,0,72763,0
300153470100,30-015-34701,RED BAT FEE 001,2009-02-01,24,0,1092,0,0,73855,0
300153470100,30-015-34701,RED BAT FEE 001,2009-03-01,25,0,1033,0,0,74888,0
300153470100,30-015-34701,RED BAT FEE 001,2009-04-01,26,0,675,0,0,75563,0
300153470100,30-015-34701,RED BAT FEE 001,2009-05-01,27,0,617,0,0,76180,0
300153470100,30-015-34701,RED BAT FEE 001,2009-06-01,28,0,962,0,0,77142,0
300153470100,30-015-34701,RED BAT FEE 001,2009-07-01,29,0,699,0,0,77841,0
300153470100,30-015-34701,RED BAT FEE 001,2009-08-01,30,0,461,0,0,78302,0
300153470100,30-015-34701,RED BAT FEE 001,2009-09-01,31,0,705,0,0,79007,0
300153470100,30-015-34701,RED BAT FEE 001,2009-10-01,32,0,167,0,0,79174,0
300153470100,30-015-34701,RED BAT FEE 001,2009-11-01,33,0,644,0,0,79818,0
300153470100,30-015-34701,RED BAT FEE 001,2009-12-01,34,0,891,0,0,80709,0
300153470100,30-015-34701,RED BAT FEE 001,2010-01-01,35,0,799,0,0,81508,0
300153470100,30-015-34701,RED BAT FEE 001,2010-02-01,36,0,334,0,0,81842,0
300153470100,30-015-34701,RED BAT FEE 001,2010-03-01,37,0,308,0,0,82150,0
300153470100,30-015-34701,RED BAT FEE 001,2010-04-01,38,0,172,0,0,82322,0
300153470100,30-015-34701,RED BAT FEE 001,2010-05-01,39,0,487,0,0,82809,0
300153470100,30-015-34701,RED BAT FEE 001,2010-06-01,40,0,751,0,0,83560,0
300153470100,30-015-34701,RED BAT FEE 001,2010-07-01,41,0,1143,0,0,84703,0
300153470100,30-015-34701,RED BAT FEE 001,2010-08-01,42,0,1129,0,0,85832,0
300153470100,30-015-34701,RED BAT FEE 001,2010-09-01,43,0,1203,0,0,87035,0
300153470100,30-015-34701,RED BAT FEE 001,2010-10-01,44,0,748,0,0,87783,0
300153470100,30-015-34701,RED BAT FEE 001,2010-11-01,45,0,327,0,0,88110,0
300153470100,30-015-34701,RED BAT FEE 001,2010-12-01,46,0,389,0,0,88499,0
300153470100,30-015-34701,RED BAT FEE 001,2011-01-01,47,0,196,0,0,88695,0
300153470100,30-015-34701,RED BAT FEE 001,2011-02-01,48,0,790,0,0,89485,0
300153470100,30-015-34701,RED BAT FEE 001,2011-03-01,49,0,660,0,0,90145,0
300153470100,30-015-34701,RED BAT FEE 001,2011-04-01,50,0,649,0,0,90794,0
300153470100,30-015-34701,RED BAT FEE 001,2011-05-01,51,0,966,0,0,91760,0
300153470100,30-015-34701,RED BAT FEE 001,2011-06-01,52,0,1185,0,0,92945,0
300153470100,30-015-34701,RED BAT FEE 001,2011-07-01,53,0,1051,0,0,93996,0
300153470100,30-015-34701,RED BAT FEE 001,2011-08-01,54,0,982,0,0,94978,0
300153470100,30-015-34701,RED BAT FEE 001,2011-09-01,55,0,0,0,0,94978,0
300153470100,30-015-34701,RED BAT FEE 001,2011-10-01,56,0,251,0,0,95229,0
300153470100,30-015-34701,RED BAT FEE 001,2011-11-01,57,0,393,0,0,95622,0
300153470100,30-015-34701,RED BAT FEE 001,2011-12-01,58,0,561,0,0,96183,0
300153470100,30-015-34701,RED BAT FEE 001,2012-01-01,59,0,542,0,0,96725,0
300153470100,30-015-34701,RED BAT FEE 001,2012-02-01,60,0,126,0,0,96851,0
300153470100,30-015-34701,RED BAT FEE 001,2012-03-01,61,0,421,0,0,97272,0
300153470100,30-015-34701,RED BAT FEE 001,2012-04-01,62,0,556,0,0,97828,0
300153470100,30-015-34701,RED BAT FEE 001,2012-05-01,63,0,485,0,0,98313,0
300153470100,30-015-34701,RED BAT FEE 001,2012-06-01,64,0,651,0,0,98964,0
300153470100,30-015-34701,RED BAT FEE 001,2012-07-01,65,0,577,0,0,99541,0
300153470100,30-015-34701,RED BAT FEE 001,2012-08-01,66,0,700,0,0,100241,0
300153470100,30-015-34701,RED BAT FEE 001,2012-09-01,67,0,531,0,0,100772,0
300153470100,30-015-34701,RED BAT FEE 001,2012-10-01,68,0,645,0,0,101417,0
300153470100,30-015-34701,RED BAT FEE 001,2012-11-01,69,0,615,0,0,102032,0
300153470100,30-015-34701,RED BAT FEE 001,2012-12-01,70,0,254,0,0,102286,0
300153470100,30-015-34701,RED BAT FEE 001,2013-01-01,71,0,303,0,0,102589,0
300153470100,30-015-34701,RED BAT FEE 001,2013-02-01,72,0,428,0,0,103017,0
300153470100,30-015-34701,RED BAT FEE 001,2013-03-01,73,0,461,0,0,103478,0
300153470100,30-015-34701,RED BAT FEE 001,2013-04-01,74,0,535,0,0,104013,0
300153470100,30-015-34701,RED BAT FEE 001,2013-05-01,75,0,310,0,0,104323,0
300153470100,30-015-34701,RED BAT FEE 001,2013-06-01,76,0,292,0,0,104615,0
300153470100,30-015-34701,RED BAT FEE 001,2013-07-01,77,0,212,0,0,104827,0
300153470100,30-015-34701,RED BAT FEE 001,2013-08-01,78,0,200,0,0,105027,0
300153470100,30-015-34701,RED BAT FEE 001,2013-09-01,79,0,201,0,0,105228,0
300153470100,30-015-34701,RED BAT FEE 001,2013-10-01,80,0,217,0,0,105445,0
300153470100,30-015-34701,RED BAT FEE 001,2013-11-01,81,0,100,0,0,105545,0
300153470100,30-015-34701,RED BAT FEE 001,2013-12-01,82,0,228,0,0,105773,0
300153470100,30-015-34701,RED BAT FEE 001,2014-01-01,83,0,738,0,0,106511,0
300153470100,30-015-34701,RED BAT FEE 001,2014-02-01,84,0,431,0,0,106942,0
300153470100,30-015-34701,RED BAT FEE 001,2014-03-01,85,0,773,0,0,107715,0
300153470100,30-015-34701,RED BAT FEE 001,2014-04-01,86,0,480,0,0,108195,0
300153470100,30-015-34701,RED BAT FEE 001,2014-05-01,87,0,173,0,0,108368,0
300153470100,30-015-34701,RED BAT FEE 001,2014-06-01,88,0,88,0,0,108456,0
300153470100,30-015-34701,RED BAT FEE 001,2014-07-01,89,0,145,0,0,108601,0
300153470100,30-015-34701,RED BAT FEE 001,2014-08-01,90,0,143,0,0,108744,0
300153470100,30-015-34701,RED BAT FEE 001,2014-09-01,91,0,89,0,0,108833,0
300153470100,30-015-34701,RED BAT FEE 001,2014-10-01,92,0,156,0,0,108989,0
300153470100,30-015-34701,RED BAT FEE 001,2014-11-01,93,0,205,0,0,109194,0
300153470100,30-015-34701,RED BAT FEE 001,2014-12-01,94,0,747,0,0,109941,0
300153470100,30-015-34701,RED BAT FEE 001,2015-01-01,95,0,271,0,0,110212,0
300153470100,30-015-34701,RED BAT FEE 001,2015-02-01,96,0,818,0,0,111030,0
300153470100,30-015-34701,RED BAT FEE 001,2015-03-01,97,0,687,0,0,111717,0
300153470100,30-015-34701,RED BAT FEE 001,2015-04-01,98,0,175,0,0,111892,0
300153470100,30-015-34701,RED BAT FEE 001,2015-05-01,99,0,524,0,0,112416,0
300153470100,30-015-34701,RED BAT FEE 001,2015-06-01,100,0,7,0,0,112423,0
300153470100,30-015-34701,RED BAT FEE 001,2015-07-01,101,0,27,0,0,112450,0
300153470100,30-015-34701,RED BAT FEE 001,2015-08-01,102,0,0,0,0,112450,0
300153470100,30-015-34701,RED BAT FEE 001,2015-09-01,103,0,288,0,0,112738,0
300153470100,30-015-34701,RED BAT FEE 001,2015-10-01,104,0,584,0,0,113322,0
300153470100,30-015-34701,RED BAT FEE 001,2015-11-01,105,0,836,0,0,114158,0
300153470100,30-015-34701,RED BAT FEE 001,2015-12-01,106,0,147,0,0,114305,0
300153470100,30-015-34701,RED BAT FEE 001,2016-01-01,107,0,706,0,0,115011,0
300153470100,30-015-34701,RED BAT FEE 001,2016-02-01,108,0,682,0,0,115693,0
300153470100,30-015-34701,RED BAT FEE 001,2016-03-01,109,0,53,0,0,115746,0
300153470100,30-015-34701,RED BAT FEE 001,2016-04-01,110,0,76,0,0,115822,0
300153470100,30-015-34701,RED BAT FEE 001,2016-05-01,111,0,104,0,0,115926,0
300153470100,30-015-34701,RED BAT FEE 001,2016-06-01,112,0,176,0,0,116102,0
300153470100,30-015-34701,RED BAT FEE 001,2016-07-01,113,0,187,0,0,116289,0
300153470100,30-015-34701,RED BAT FEE 001,2016-08-01,114,0,92,0,0,116381,0
300153470100,30-015-34701,RED BAT FEE 001,2016-09-01,115,0,102,0,0,116483,0
300153470100,30-015-34701,RED BAT FEE 001,2016-10-01,116,0,56,0,0,116539,0
300153470100,30-015-34701,RED BAT FEE 001,2016-11-01,117,0,83,0,0,116622,0
300153470100,30-015-34701,RED BAT FEE 001,2016-12-01,118,0,674,0,0,117296,0
300153470100,30-015-34701,RED BAT FEE 001,2017-01-01,119,0,380,0,0,117676,0
300153470100,30-015-34701,RED BAT FEE 001,2017-02-01,120,0,145,0,0,117821,0
300153470100,30-015-34701,RED BAT FEE 001,2017-03-01,121,0,76,0,0,117897,0
300153470100,30-015-34701,RED BAT FEE 001,2017-04-01,122,0,476,0,0,118373,0
300153470100,30-015-34701,RED BAT FEE 001,2017-05-01,123,0,478,0,0,118851,0
300153470100,30-015-34701,RED BAT FEE 001,2017-06-01,124,0,243,0,0,119094,0
300153470100,30-015-34701,RED BAT FEE 001,2017-07-01,125,0,313,0,0,119407,0
300153470100,30-015-34701,RED BAT FEE 001,2017-08-01,126,0,308,0,0,119715,0
300153470100,30-015-34701,RED BAT FEE 001,2017-09-01,127,0,293,0,0,120008,0
300153470100,30-015-34701,RED BAT FEE 001,2017-10-01,128,0,949,0,0,120957,0
300153470100,30-015-34701,RED BAT FEE 001,2017-11-01,129,0,726,0,0,121683,0
300153470100,30-015-34701,RED BAT FEE 001,2017-12-01,130,0,561,0,0,122244,0
300153470100,30-015-34701,RED BAT FEE 001,2018-01-01,131,0,1220,0,0,123464,0
300153470100,30-015-34701,RED BAT FEE 001,2018-02-01,132,0,523,0,0,123987,0
300153470100,30-015-34701,RED BAT FEE 001,2018-03-01,133,0,669,0,0,124656,0
300153470100,30-015-34701,RED BAT FEE 001,2018-04-01,134,0,405,0,0,125061,0
300153470100,30-015-34701,RED BAT FEE 001,2018-05-01,135,0,230,0,0,125291,0
300153470100,30-015-34701,RED BAT FEE 001,2018-06-01,136,0,276,0,0,125567,0
300153470100,30-015-34701,RED BAT FEE 001,2018-07-01,137,0,253,0,0,125820,0
300153470100,30-015-34701,RED BAT FEE 001,2018-08-01,138,0,136,0,0,125956,0
300153470100,30-015-34701,RED BAT FEE 001,2018-09-01,139,0,162,9,0,126118,9
300153470100,30-015-34701,RED BAT FEE 001,2018-10-01,140,0,113,0,0,126231,9
300153470100,30-015-34701,RED BAT FEE 001,2018-11-01,141,0,87,0,0,126318,9
300153470100,30-015-34701,RED BAT FEE 001,2018-12-01,142,0,146,0,0,126464,9
300153470100,30-015-34701,RED BAT FEE 001,2019-01-01,143,0,181,0,0,126645,9
300153470100,30-015-34701,RED BAT FEE 001,2019-02-01,144,0,89,0,0,126734,9
300153470100,30-015-34701,RED BAT FEE 001,2019-03-01,145,0,97,0,0,126831,9
300153470100,30-015-34701,RED BAT FEE 001,2019-04-01,146,0,0,0,0,126831,9
300153470100,30-015-34701,RED BAT FEE 001,2019-05-01,147,0,218,0,0,127049,9
300153470100,30-015-34701,RED BAT FEE 001,2019-06-01,148,0,14,0,0,127063,9
300153470100,30-015-34701,RED BAT FEE 001,2019-07-01,149,0,23,0,0,127086,9
300153470100,30-015-34701,RED BAT FEE 001,2019-08-01,150,0,76,0,0,127162,9
300153470100,30-015-34701,RED BAT FEE 001,2019-09-01,151,0,55,0,0,127217,9
300153470100,30-015-34701,RED BAT FEE 001,2019-10-01,152,0,44,0,0,127261,9
300153470100,30-015-34701,RED BAT FEE 001,2019-11-01,153,0,161,0,0,127422,9
300153470100,30-015-34701,RED BAT FEE 001,2019-12-01,154,0,91,0,0,127513,9
300153470100,30-015-34701,RED BAT FEE 001,2020-01-01,155,0,108,0,0,127621,9
300153470100,30-015-34701,RED BAT FEE 001,2020-02-01,156,0,151,0,0,127772,9
300153470100,30-015-34701,RED BAT FEE 001,2020-03-01,157,0,101,0,0,127873,9
300153470100,30-015-34701,RED BAT FEE 001,2020-04-01,158,0,79,0,0,127952,9
300153470100,30-015-34701,RED BAT FEE 001,2020-05-01,159,0,44,0,0,127996,9
300153470100,30-015-34701,RED BAT FEE 001,2020-06-01,160,0,113,0,0,128109,9
300153470100,30-015-34701,RED BAT FEE 001,2020-07-01,161,0,81,0,0,128190,9
300153470100,30-015-34701,RED BAT FEE 001,2020-08-01,162,0,21,0,0,128211,9
300153470100,30-015-34701,RED BAT FEE 001,2020-09-01,163,0,18,0,0,128229,9
300153470100,30-015-34701,RED BAT FEE 001,2020-10-01,164,0,7,0,0,128236,9
300153470100,30-015-34701,RED BAT FEE 001,2020-11-01,165,0,3,0,0,128239,9
300153470100,30-015-34701,RED BAT FEE 001,2020-12-01,166,0,5,0,0,128244,9
300153470100,30-015-34701,RED BAT FEE 001,2021-01-01,167,0,14,0,0,128258,9
300153470100,30-015-34701,RED BAT FEE 001,2021-02-01,168,0,181,0,0,128439,9
300153470100,30-015-34701,RED BAT FEE 001,2021-03-01,169,0,21,0,0,128460,9
300153470100,30-015-34701,RED BAT FEE 001,2021-04-01,170,0,527,0,0,128987,9
300153470100,30-015-34701,RED BAT FEE 001,2021-05-01,171,0,102,0,0,129089,9
300153470100,30-015-34701,RED BAT FEE 001,2021-06-01,172,0,85,33,0,129174,42
300153470100,30-015-34701,RED BAT FEE 001,2021-07-01,173,0,26,20,0,129200,62
300153470100,30-015-34701,RED BAT FEE 001,2021-08-01,174,0,50,0,0,129250,62
300153470100,30-015-34701,RED BAT FEE 001,2021-09-01,175,0,71,0,0,129321,62
300153470100,30-015-34701,RED BAT FEE 001,2021-10-01,176,0,55,0,0,129376,62
300153470100,30-015-34701,RED BAT FEE 001,2021-11-01,177,0,34,0,0,129410,62
300153470100,30-015-34701,RED BAT FEE 001,2021-12-01,178,0,5,0,0,129415,62
300153470100,30-015-34701,RED BAT FEE 001,2022-01-01,179,0,2,0,0,129417,62
300153470100,30-015-34701,RED BAT FEE 001,2022-02-01,180,0,7,0,0,129424,62
300153470100,30-015-34701,RED BAT FEE 001,2022-03-01,181,0,16,0,0,129440,62
300153470100,30-015-34701,RED BAT FEE 001,2022-04-01,182,0,2,0,0,129442,62
300153470100,30-015-34701,RED BAT FEE 001,2022-05-01,183,0,9,0,0,129451,62
300153470100,30-015-34701,RED BAT FEE 001,2022-06-01,184,0,7,0,0,129458,62
300153470100,30-015-34701,RED BAT FEE 001,2022-07-01,185,0,4,0,0,129462,62
300153470100,30-015-34701,RED BAT FEE 001,2022-08-01,186,0,14,0,0,129476,62
300153470100,30-015-34701,RED BAT FEE 001,2022-09-01,187,0,115,0,0,129591,62
300153470100,30-015-34701,RED BAT FEE 001,2022-10-01,188,0,18,0,0,129609,62
300153470100,30-015-34701,RED BAT FEE 001,2022-11-01,189,0,46,0,0,129655,62
300153470100,30-015-34701,RED BAT FEE 001,2022-12-01,190,0,9,0,0,129664,62
300153470100,30-015-34701,RED BAT FEE 001,2023-01-01,191,0,12,0,0,129676,62
300153470100,30-015-34701,RED BAT FEE 001,2023-02-01,192,0,16,0,0,129692,62
300153470100,30-015-34701,RED BAT FEE 001,2023-03-01,193,0,4,0,0,129696,62
300153470100,30-015-34701,RED BAT FEE 001,2023-04-01,194,0,14,0,0,129710,62
300153470100,30-015-34701,RED BAT FEE 001,2023-05-01,195,0,4,0,0,129714,62
300153470100,30-015-34701,RED BAT FEE 001,2023-06-01,196,0,19,0,0,129733,62
300153470100,30-015-34701,RED BAT FEE 001,2023-07-01,197,0,77,0,0,129810,62
300152389800,30-015-23898,SMITH 11 COM 001,1982-02-01,1,0,22293,39,0,22293,39
300152389800,30-015-23898,SMITH 11 COM 001,1982-03-01,2,0,48943,52,0,71236,91
300152389800,30-015-23898,SMITH 11 COM 001,1982-04-01,3,0,30653,11,0,101889,102
300152389800,30-015-23898,SMITH 11 COM 001,1982-05-01,4,0,29906,18,0,131795,120
300152389800,30-015-23898,SMITH 11 COM 001,1982-06-01,5,0,25675,21,0,157470,141
300152389800,30-015-23898,SMITH 11 COM 001,1982-07-01,6,142,22854,18,142,180324,159
300152389800,30-015-23898,SMITH 11 COM 001,1982-08-01,7,13,19876,15,155,200200,174
300152389800,30-015-23898,SMITH 11 COM 001,1982-09-01,8,12,16823,15,167,217023,189
300152389800,30-015-23898,SMITH 11 COM 001,1982-10-01,9,8,14976,6,175,231999,195
300152389800,30-015-23898,SMITH 11 COM 001,1982-11-01,10,3,9031,3,178,241030,198
300152389800,30-015-23898,SMITH 11 COM 001,1982-12-01,11,0,11272,17,178,252302,215
300152389800,30-015-23898,SMITH 11 COM 001,1983-01-01,12,0,8993,14,178,261295,229
300152389800,30-015-23898,SMITH 11 COM 001,1983-02-01,13,11,8348,0,189,269643,229
300152389800,30-015-23898,SMITH 11 COM 001,1983-03-01,14,0,5449,3,189,275092,232
300152389800,30-015-23898,SMITH 11 COM 001,1983-04-01,15,19,7932,11,208,283024,243
300152389800,30-015-23898,SMITH 11 COM 001,1983-05-01,16,0,2373,0,208,285397,243
300152389800,30-015-23898,SMITH 11 COM 001,1983-06-01,17,3,2867,0,211,288264,243
300152389800,30-015-23898,SMITH 11 COM 001,1983-07-01,18,3,4670,6,214,292934,249
300152389800,30-015-23898,SMITH 11 COM 001,1983-08-01,19,0,2692,0,214,295626,249
300152389800,30-015-23898,SMITH 11 COM 001,1983-09-01,20,0,3284,3,214,298910,252
300152389800,30-015-23898,SMITH 11 COM 001,1983-10-01,21,0,6155,6,214,305065,258
300152389800,30-015-23898,SMITH 11 COM 001,1983-11-01,22,19,3272,9,233,308337,267
300152389800,30-015-23898,SMITH 11 COM 001,1983-12-01,23,3,3862,0,236,312199,267
300152389800,30-015-23898,SMITH 11 COM 001,1984-01-01,24,6,5313,9,242,317512,276
300152389800,30-015-23898,SMITH 11 COM 001,1984-02-01,25,0,1094,0,242,318606,276
300152389800,30-015-23898,SMITH 11 COM 001,1984-03-01,26,0,0,0,242,318606,276
300152389800,30-015-23898,SMITH 11 COM 001,1984-04-01,27,5,11442,9,247,330048,285
300152389800,30-015-23898,SMITH 11 COM 001,1984-05-01,28,0,3098,0,247,333146,285
300152389800,30-015-23898,SMITH 11 COM 001,1984-06-01,29,0,0,0,247,333146,285
300152389800,30-015-23898,SMITH 11 COM 001,1984-07-01,30,9,7243,22,256,340389,307
300152389800,30-015-23898,SMITH 11 COM 001,1984-08-01,31,0,4037,0,256,344426,307
300152389800,30-015-23898,SMITH 11 COM 001,1984-09-01,32,11,3787,9,267,348213,316
300152389800,30-015-23898,SMITH 11 COM 001,1984-10-01,33,3,6314,3,270,354527,319
300152389800,30-015-23898,SMITH 11 COM 001,1984-11-01,34,0,3536,0,270,358063,319
300152389800,30-015-23898,SMITH 11 COM 001,1984-12-01,35,0,5652,0,270,363715,319
300152389800,30-015-23898,SMITH 11 COM 001,1985-01-01,36,0,3750,0,270,367465,319
300152389800,30-015-23898,SMITH 11 COM 001,1985-02-01,37,0,4253,8,270,371718,327
300152389800,30-015-23898,SMITH 11 COM 001,1985-03-01,38,0,4403,0,270,376121,327
300152389800,30-015-23898,SMITH 11 COM 001,1985-04-01,39,2,5320,6,272,381441,333
300152389800,30-015-23898,SMITH 11 COM 001,1985-05-01,40,0,5025,5,272,386466,338
300152389800,30-015-23898,SMITH 11 COM 001,1985-06-01,41,0,3835,13,272,390301,351
300152389800,30-015-23898,SMITH 11 COM 001,1985-07-01,42,0,4778,5,272,395079,356
300152389800,30-015-23898,SMITH 11 COM 001,1985-08-01,43,0,4809,5,272,399888,361
300152389800,30-015-23898,SMITH 11 COM 001,1985-09-01,44,0,4654,3,272,404542,364
300152389800,30-015-23898,SMITH 11 COM 001,1985-10-01,45,0,337,0,272,404879,364
300152389800,30-015-23898,SMITH 11 COM 001,1985-11-01,46,0,345,0,272,405224,364
300152389800,30-015-23898,SMITH 11 COM 001,1985-12-01,47,0,3374,0,272,408598,364
300152389800,30-015-23898,SMITH 11 COM 001,1986-01-01,48,5,5228,3,277,413826,367
300152389800,30-015-23898,SMITH 11 COM 001,1986-02-01,49,4,3966,11,281,417792,378
300152389800,30-015-23898,SMITH 11 COM 001,1986-03-01,50,0,1043,0,281,418835,378
300152389800,30-015-23898,SMITH 11 COM 001,1986-04-01,51,0,3404,11,281,422239,389
300152389800,30-015-23898,SMITH 11 COM 001,1986-05-01,52,4,5228,3,285,427467,392
300152389800,30-015-23898,SMITH 11 COM 001,1986-06-01,53,0,4113,5,285,431580,397
300152389800,30-015-23898,SMITH 11 COM 001,1986-07-01,54,0,3678,5,285,435258,402
300152389800,30-015-23898,SMITH 11 COM 001,1986-08-01,55,0,3310,6,285,438568,408
300152389800,30-015-23898,SMITH 11 COM 001,1986-09-01,56,0,2819,0,285,441387,408
300152389800,30-015-23898,SMITH 11 COM 001,1986-10-01,57,0,2992,0,285,444379,408
300152389800,30-015-23898,SMITH 11 COM 001,1986-11-01,58,0,2437,0,285,446816,408
300152389800,30-015-23898,SMITH 11 COM 001,1986-12-01,59,0,2933,0,285,449749,408
300152389800,30-015-23898,SMITH 11 COM 001,1987-01-01,60,0,2234,0,285,451983,408
300152389800,30-015-23898,SMITH 11 COM 001,1987-02-01,61,0,2856,0,285,454839,408
300152389800,30-015-23898,SMITH 11 COM 001,1987-03-01,62,0,2247,0,285,457086,408
300152389800,30-015-23898,SMITH 11 COM 001,1987-04-01,63,0,0,0,285,457086,408
300152389800,30-015-23898,SMITH 11 COM 001,1987-05-01,64,0,0,0,285,457086,408
300152389800,30-015-23898,SMITH 11 COM 001,1987-06-01,65,0,0,0,285,457086,408
300152389800,30-015-23898,SMITH 11 COM 001,1987-07-01,66,0,474,0,285,457560,408
300152389800,30-015-23898,SMITH 11 COM 001,1987-08-01,67,0,4511,0,285,462071,408
300152389800,30-015-23898,SMITH 11 COM 001,1987-09-01,68,0,1241,0,285,463312,408
300152389800,30-015-23898,SMITH 11 COM 001,1987-10-01,69,0,0,0,285,463312,408
300152389800,30-015-23898,SMITH 11 COM 001,1987-11-01,70,0,0,0,285,463312,408
300152389800,30-015-23898,SMITH 11 COM 001,1987-12-01,71,0,0,0,285,463312,408
300152389800,30-015-23898,SMITH 11 COM 001,1988-01-01,72,0,0,0,285,463312,408
300152389800,30-015-23898,SMITH 11 COM 001,1988-02-01,73,0,0,0,285,463312,408
300152389800,30-015-23898,SMITH 11 COM 001,1988-03-01,74,0,0,0,285,463312,408
300152389800,30-015-23898,SMITH 11 COM 001,1988-04-01,75,0,0,0,285,463312,408
300152389800,30-015-23898,SMITH 11 COM 001,1988-05-01,76,0,0,0,285,463312,408
300152389800,30-015-23898,SMITH 11 COM 001,1988-06-01,77,0,0,0,285,463312,408
300152389800,30-015-23898,SMITH 11 COM 001,1988-07-01,78,0,0,0,285,463312,408
300152389800,30-015-23898,SMITH 11 COM 001,1988-08-01,79,0,0,0,285,463312,408
300152389800,30-015-23898,SMITH 11 COM 001,1988-09-01,80,0,0,0,285,463312,408
300152389800,30-015-23898,SMITH 11 COM 001,1988-10-01,81,0,0,0,285,463312,408
300152389800,30-015-23898,SMITH 11 COM 001,1988-11-01,82,0,0,0,285,463312,408
300152389800,30-015-23898,SMITH 11 COM 001,1988-12-01,83,0,0,0,285,463312,408
300152389800,30-015-23898,SMITH 11 COM 001,1989-01-01,84,0,0,0,285,463312,408
300152389800,30-015-23898,SMITH 11 COM 001,1989-02-01,85,0,0,0,285,463312,408
300152389800,30-015-23898,SMITH 11 COM 001,1989-03-01,86,0,0,0,285,463312,408
300152389800,30-015-23898,SMITH 11 COM 001,1989-04-01,87,0,4966,0,285,468278,408
300152389800,30-015-23898,SMITH 11 COM 001,1989-05-01,88,0,3147,8,285,471425,416
300152389800,30-015-23898,SMITH 11 COM 001,1989-06-01,89,0,3328,16,285,474753,432
300152389800,30-015-23898,SMITH 11 COM 001,1989-07-01,90,0,4338,0,285,479091,432
300152389800,30-015-23898,SMITH 11 COM 001,1989-08-01,91,0,3233,5,285,482324,437
300152389800,30-015-23898,SMITH 11 COM 001,1989-09-01,92,0,3283,3,285,485607,440
300152389800,30-015-23898,SMITH 11 COM 001,1989-10-01,93,0,3176,8,285,488783,448
300152389800,30-015-23898,SMITH 11 COM 001,1989-11-01,94,0,7944,8,285,496727,456
300152389800,30-015-23898,SMITH 11 COM 001,1989-12-01,95,0,2206,3,285,498933,459
300152389800,30-015-23898,SMITH 11 COM 001,1990-01-01,96,0,1155,6,285,500088,465
300152389800,30-015-23898,SMITH 11 COM 001,1990-02-01,97,0,937,0,285,501025,465
300152389800,30-015-23898,SMITH 11 COM 001,1990-03-01,98,0,2492,0,285,503517,465
300152389800,30-015-23898,SMITH 11 COM 001,1990-04-01,99,0,1513,3,285,505030,468
300152389800,30-015-23898,SMITH 11 COM 001,1990-05-01,100,0,1746,0,285,506776,468
300152389800,30-015-23898,SMITH 11 COM 001,1990-06-01,101,0,1959,0,285,508735,468
300152389800,30-015-23898,SMITH 11 COM 001,1990-07-01,102,0,809,3,285,509544,471
300152389800,30-015-23898,SMITH 11 COM 001,1990-08-01,103,0,1058,0,285,510602,471
300152389800,30-015-23898,SMITH 11 COM 001,1990-09-01,104,0,758,0,285,511360,471
300152389800,30-015-23898,SMITH 11 COM 001,1990-10-01,105,0,758,0,285,512118,471
300152389800,30-015-23898,SMITH 11 COM 001,1990-11-01,106,0,1405,0,285,513523,471
300152389800,30-015-23898,SMITH 11 COM 001,1990-12-01,107,0,448,0,285,513971,471
300152389800,30-015-23898,SMITH 11 COM 001,1991-01-01,108,0,199,0,285,514170,471
300152389800,30-015-23898,SMITH 11 COM 001,1991-02-01,109,0,929,0,285,515099,471
300152389800,30-015-23898,SMITH 11 COM 001,1991-03-01,110,0,1512,0,285,516611,471
300152389800,30-015-23898,SMITH 11 COM 001,1991-04-01,111,0,1096,0,285,517707,471
300152389800,30-015-23898,SMITH 11 COM 001,1991-05-01,112,0,869,0,285,518576,471
300152389800,30-015-23898,SMITH 11 COM 001,1991-06-01,113,0,431,0,285,519007,471
300152389800,30-015-23898,SMITH 11 COM 001,1991-07-01,114,0,0,0,285,519007,471
300152389800,30-015-23898,SMITH 11 COM 001,1991-08-01,115,0,423,0,285,519430,471
300152389800,30-015-23898,SMITH 11 COM 001,1991-09-01,116,0,309,0,285,519739,471
300152389800,30-015-23898,SMITH 11 COM 001,1991-10-01,117,0,7,0,285,519746,471
300152389800,30-015-23898,SMITH 11 COM 001,1991-11-01,118,0,7,0,285,519753,471
300152389800,30-015-23898,SMITH 11 COM 001,1991-12-01,119,0,0,0,285,519753,471
300152389800,30-015-23898,SMITH 11 COM 001,1992-01-01,120,0,89,0,285,519842,471
300152389800,30-015-23898,SMITH 11 COM 001,1992-02-01,121,0,95,0,285,519937,471
300152389800,30-015-23898,SMITH 11 COM 001,1992-03-01,122,0,452,0,285,520389,471
300152389800,30-015-23898,SMITH 11 COM 001,1992-04-01,123,0,610,0,285,520999,471
300152389800,30-015-23898,SMITH 11 COM 001,1992-05-01,124,0,430,0,285,521429,471
300152389800,30-015-23898,SMITH 11 COM 001,1992-06-01,125,0,62,0,285,521491,471
300152389800,30-015-23898,SMITH 11 COM 001,1992-07-01,126,0,165,0,285,521656,471
300152389800,30-015-23898,SMITH 11 COM 001,1992-08-01,127,0,240,0,285,521896,471
300152389800,30-015-23898,SMITH 11 COM 001,1992-09-01,128,0,139,0,285,522035,471
300152389800,30-015-23898,SMITH 11 COM 001,1992-10-01,129,0,125,0,285,522160,471
300152389800,30-015-23898,SMITH 11 COM 001,1992-11-01,130,0,7,0,285,522167,471
300152389800,30-015-23898,SMITH 11 COM 001,1992-12-01,131,0,28,0,285,522195,471
300152389800,30-015-23898,SMITH 11 COM 001,1993-01-01,132,0,106,0,285,522301,471
300152389800,30-015-23898,SMITH 11 COM 001,1993-02-01,133,0,183,0,285,522484,471
300152389800,30-015-23898,SMITH 11 COM 001,1993-03-01,134,0,334,0,285,522818,471
300152389800,30-015-23898,SMITH 11 COM 001,1993-04-01,135,0,261,0,285,523079,471
300152389800,30-015-23898,SMITH 11 COM 001,1993-05-01,136,0,16,0,285,523095,471
300152389800,30-015-23898,SMITH 11 COM 001,1993-06-01,137,0,25,0,285,523120,471
300152389800,30-015-23898,SMITH 11 COM 001,1993-07-01,138,0,1,0,285,523121,471
300152389800,30-015-23898,SMITH 11 COM 001,1993-08-01,139,0,7,0,285,523128,471
300152389800,30-015-23898,SMITH 11 COM 001,1993-09-01,140,0,0,0,285,523128,471
300152389800,30-015-23898,SMITH 11 COM 001,1993-10-01,141,0,0,0,285,523128,471
300152389800,30-015-23898,SMITH 11 COM 001,1993-11-01,142,0,20,0,285,523148,471
300152389800,30-015-23898,SMITH 11 COM 001,1993-12-01,143,0,49,0,285,523197,471
300152389800,30-015-23898,SMITH 11 COM 001,1994-01-01,144,0,51,0,285,523248,471
300152389800,30-015-23898,SMITH 11 COM 001,1994-02-01,145,0,124,0,285,523372,471
300152389800,30-015-23898,SMITH 11 COM 001,1994-03-01,146,0,1001,0,285,524373,471
300152389800,30-015-23898,SMITH 11 COM 001,1994-04-01,147,0,3345,6,285,527718,477
300152389800,30-015-23898,SMITH 11 COM 001,1994-05-01,148,0,3016,0,285,530734,477
300152389800,30-015-23898,SMITH 11 COM 001,1994-06-01,149,0,2176,9,285,532910,486
300152389800,30-015-23898,SMITH 11 COM 001,1994-07-01,150,0,1995,3,285,534905,489
300152389800,30-015-23898,SMITH 11 COM 001,1994-08-01,151,0,1706,6,285,536611,495
300152389800,30-015-23898,SMITH 11 COM 001,1994-09-01,152,0,0,0,285,536611,495
300152389800,30-015-23898,SMITH 11 COM 001,1994-10-01,153,0,2308,3,285,538919,498
300152389800,30-015-23898,SMITH 11 COM 001,1994-11-01,154,0,1607,0,285,540526,498
300152389800,30-015-23898,SMITH 11 COM 001,1994-12-01,155,0,1975,0,285,542501,498
300152389800,30-015-23898,SMITH 11 COM 001,1995-01-01,156,0,2181,0,285,544682,498
300152389800,30-015-23898,SMITH 11 COM 001,1995-02-01,157,26,1836,0,311,546518,498
300152389800,30-015-23898,SMITH 11 COM 001,1995-03-01,158,26,1504,0,337,548022,498
300152389800,30-015-23898,SMITH 11 COM 001,1995-04-01,159,26,914,0,363,548936,498
300152389800,30-015-23898,SMITH 11 COM 001,1995-05-01,160,26,735,0,389,549671,498
300152389800,30-015-23898,SMITH 11 COM 001,1995-06-01,161,0,1916,0,389,551587,498
300152389800,30-015-23898,SMITH 11 COM 001,1995-07-01,162,0,1030,0,389,552617,498
300152389800,30-015-23898,SMITH 11 COM 001,1995-08-01,163,0,989,21,389,553606,519
300152389800,30-015-23898,SMITH 11 COM 001,1995-09-01,164,0,986,6,389,554592,525
300152389800,30-015-23898,SMITH 11 COM 001,1995-10-01,165,0,641,0,389,555233,525
300152389800,30-015-23898,SMITH 11 COM 001,1995-11-01,166,0,419,0,389,555652,525
300152389800,30-015-23898,SMITH 11 COM 001,1995-12-01,167,0,0,0,389,555652,525
300152389800,30-015-23898,SMITH 11 COM 001,1996-01-01,168,0,678,12,389,556330,537
300152389800,30-015-23898,SMITH 11 COM 001,1996-02-01,169,0,1543,6,389,557873,543
300152389800,30-015-23898,SMITH 11 COM 001,1996-03-01,170,0,1959,6,389,559832,549
300152389800,30-015-23898,SMITH 11 COM 001,1996-04-01,171,0,1031,0,389,560863,549
300152389800,30-015-23898,SMITH 11 COM 001,1996-05-01,172,0,1031,0,389,561894,549
300152389800,30-015-23898,SMITH 11 COM 001,1996-06-01,173,0,1223,3,389,563117,552
300152389800,30-015-23898,SMITH 11 COM 001,1996-07-01,174,0,1223,0,389,564340,552
300152389800,30-015-23898,SMITH 11 COM 001,1996-08-01,175,0,1249,0,389,565589,552
300152389800,30-015-23898,SMITH 11 COM 001,1996-09-01,176,0,1202,0,389,566791,552
300152389800,30-015-23898,SMITH 11 COM 001,1996-10-01,177,0,4736,14,389,571527,566
300152389800,30-015-23898,SMITH 11 COM 001,1996-11-01,178,0,2644,3,389,574171,569
300152389800,30-015-23898,SMITH 11 COM 001,1996-12-01,179,19,3663,12,408,577834,581
300152389800,30-015-23898,SMITH 11 COM 001,1997-01-01,180,0,1713,3,408,579547,584
300152389800,30-015-23898,SMITH 11 COM 001,1997-02-01,181,0,1696,0,408,581243,584
300152389800,30-015-23898,SMITH 11 COM 001,1997-03-01,182,0,1116,0,408,582359,584
300152389800,30-015-23898,SMITH 11 COM 001,1997-04-01,183,0,1205,0,408,583564,584
300152389800,30-015-23898,SMITH 11 COM 001,1997-05-01,184,0,638,0,408,584202,584
300152389800,30-015-23898,SMITH 11 COM 001,1997-06-01,185,0,326,0,408,584528,584
300152389800,30-015-23898,SMITH 11 COM 001,1997-07-01,186,3,397,0,411,584925,584
300152389800,30-015-23898,SMITH 11 COM 001,1997-08-01,187,0,191,0,411,585116,584
300152389800,30-015-23898,SMITH 11 COM 001,1997-09-01,188,0,240,0,411,585356,584
300152389800,30-015-23898,SMITH 11 COM 001,1997-10-01,189,0,310,0,411,585666,584
300152389800,30-015-23898,SMITH 11 COM 001,1997-11-01,190,0,32,0,411,585698,584
300152389800,30-015-23898,SMITH 11 COM 001,1997-12-01,191,0,31,0,411,585729,584
300152389800,30-015-23898,SMITH 11 COM 001,1998-01-01,192,0,24,0,411,585753,584
300152389800,30-015-23898,SMITH 11 COM 001,1998-02-01,193,0,143,0,411,585896,584
300152389800,30-015-23898,SMITH 11 COM 001,1998-03-01,194,0,3,0,411,585899,584
300152389800,30-015-23898,SMITH 11 COM 001,1998-04-01,195,6,13,0,417,585912,584
300152389800,30-015-23898,SMITH 11 COM 001,1998-05-01,196,0,0,0,417,585912,584
300152389800,30-015-23898,SMITH 11 COM 001,1998-06-01,197,0,3,0,417,585915,584
300152389800,30-015-23898,SMITH 11 COM 001,1998-07-01,198,0,2,0,417,585917,584
300152389800,30-015-23898,SMITH 11 COM 001,1998-08-01,199,0,5,0,417,585922,584
300152389800,30-015-23898,SMITH 11 COM 001,1998-09-01,200,0,9,0,417,585931,584
300152389800,30-015-23898,SMITH 11 COM 001,1998-10-01,201,0,226,0,417,586157,584
300152389800,30-015-23898,SMITH 11 COM 001,1998-11-01,202,0,12,0,417,586169,584
300152389800,30-015-23898,SMITH 11 COM 001,1998-12-01,203,0,0,0,417,586169,584
300152389800,30-015-23898,SMITH 11 COM 001,1999-01-01,204,0,0,0,417,586169,584
300152389800,30-015-23898,SMITH 11 COM 001,1999-02-01,205,0,0,0,417,586169,584
300152389800,30-015-23898,SMITH 11 COM 001,1999-03-01,206,0,3,0,417,586172,584
300152389800,30-015-23898,SMITH 11 COM 001,1999-04-01,207,0,3,0,417,586175,584
300152389800,30-015-23898,SMITH 11 COM 001,1999-05-01,208,0,0,0,417,586175,584
300152389800,30-015-23898,SMITH 11 COM 001,1999-06-01,209,0,3,0,417,586178,584
300152389800,30-015-23898,SMITH 11 COM 001,1999-07-01,210,0,0,0,417,586178,584
300152389800,30-015-23898,SMITH 11 COM 001,1999-08-01,211,0,15,0,417,586193,584
300152389800,30-015-23898,SMITH 11 COM 001,1999-09-01,212,0,0,0,417,586193,584
300152389800,30-015-23898,SMITH 11 COM 001,1999-10-01,213,0,1,0,417,586194,584
300152389800,30-015-23898,SMITH 11 COM 001,1999-11-01,214,0,0,0,417,586194,584
300152389800,30-015-23898,SMITH 11 COM 001,1999-12-01,215,0,0,0,417,586194,584
300152389800,30-015-23898,SMITH 11 COM 001,2000-01-01,216,0,0,0,417,586194,584
300152389800,30-015-23898,SMITH 11 COM 001,2000-02-01,217,0,0,0,417,586194,584
300152389800,30-015-23898,SMITH 11 COM 001,2000-03-01,218,0,1,0,417,586195,584
300152389800,30-015-23898,SMITH 11 COM 001,2000-04-01,219,0,0,0,417,586195,584
300152389800,30-015-23898,SMITH 11 COM 001,2000-05-01,220,0,1,0,417,586196,584
300152389800,30-015-23898,SMITH 11 COM 001,2000-06-01,221,0,0,0,417,586196,584
300152389800,30-015-23898,SMITH 11 COM 001,2000-07-01,222,0,4,0,417,586200,584
300152389800,30-015-23898,SMITH 11 COM 001,2000-08-01,223,0,0,0,417,586200,584
300152389800,30-015-23898,SMITH 11 COM 001,2000-09-01,224,0,0,0,417,586200,584
300152389800,30-015-23898,SMITH 11 COM 001,2000-10-01,225,0,0,0,417,586200,584
300152389800,30-015-23898,SMITH 11 COM 001,2000-11-01,226,0,0,0,417,586200,584
300152389800,30-015-23898,SMITH 11 COM 001,2000-12-01,227,0,0,0,417,586200,584
300152389800,30-015-23898,SMITH 11 COM 001,2001-01-01,228,0,95,0,417,586295,584
300152389800,30-015-23898,SMITH 11 COM 001,2001-02-01,229,0,17,0,417,586312,584
300152389800,30-015-23898,SMITH 11 COM 001,2001-03-01,230,0,1,0,417,586313,584
300152389800,30-015-23898,SMITH 11 COM 001,2001-04-01,231,0,4,0,417,586317,584
300152389800,30-015-23898,SMITH 11 COM 001,2001-05-01,232,0,0,0,417,586317,584
300152389800,30-015-23898,SMITH 11 COM 001,2001-06-01,233,0,0,0,417,586317,584
300152389800,30-015-23898,SMITH 11 COM 001,2001-07-01,234,0,0,0,417,586317,584
300152389800,30-015-23898,SMITH 11 COM 001,2001-08-01,235,0,0,0,417,586317,584
300152389800,30-015-23898,SMITH 11 COM 001,2001-09-01,236,1,0,0,418,586317,584
300152389800,30-015-23898,SMITH 11 COM 001,2001-10-01,237,0,6,0,418,586323,584
300152389800,30-015-23898,SMITH 11 COM 001,2001-11-01,238,1,0,0,419,586323,584
300152389800,30-015-23898,SMITH 11 COM 001,2001-12-01,239,1,0,0,420,586323,584
300152389800,30-015-23898,SMITH 11 COM 001,2002-01-01,240,1,0,0,421,586323,584
300152389800,30-015-23898,SMITH 11 COM 001,2002-02-01,241,1,0,0,422,586323,584
300152389800,30-015-23898,SMITH 11 COM 001,2002-03-01,242,1,0,0,423,586323,584
300152389800,30-015-23898,SMITH 11 COM 001,2002-04-01,243,0,0,0,423,586323,584
300152389800,30-015-23898,SMITH 11 COM 001,2002-05-01,244,0,0,0,423,586323,584
300152389800,30-015-23898,SMITH 11 COM 001,2002-06-01,245,0,0,0,423,586323,584
300152389800,30-015-23898,SMITH 11 COM 001,2002-07-01,246,0,0,0,423,586323,584
300152389800,30-015-23898,SMITH 11 COM 001,2002-08-01,247,0,0,0,423,586323,584
300152389800,30-015-23898,SMITH 11 COM 001,2002-09-01,248,0,0,0,423,586323,584
300152389800,30-015-23898,SMITH 11 COM 001,2002-10-01,249,0,0,0,423,586323,584
300152389800,30-015-23898,SMITH 11 COM 001,2002-11-01,250,0,0,0,423,586323,584
300152389800,30-015-23898,SMITH 11 COM 001,2002-12-01,251,0,0,0,423,586323,584
300152389800,30-015-23898,SMITH 11 COM 001,2003-01-01,252,0,0,0,423,586323,584
300152389800,30-015-23898,SMITH 11 COM 001,2003-02-01,253,0,0,0,423,586323,584
300154416500,30-015-44165,EL PRESIDENTE STATE X 004H,2017-09-01,1,8196,15915,78079,8196,15915,78079
300154416500,30-015-44165,EL PRESIDENTE STATE X 004H,2017-10-01,2,30165,67128,104219,38361,83043,182298
300154416500,30-015-44165,EL PRESIDENTE STATE X 004H,2017-11-01,3,22526,49671,67391,60887,132714,249689
300154416500,30-015-44165,EL PRESIDENTE STATE X 004H,2017-12-01,4,15728,32701,46951,76615,165415,296640
300154416500,30-015-44165,EL PRESIDENTE STATE X 004H,2018-01-01,5,13351,25135,36963,89966,190550,333603
300154416500,30-015-44165,EL PRESIDENTE STATE X 004H,2018-02-01,6,11152,18016,34765,101118,208566,368368
300154416500,30-015-44165,EL PRESIDENTE STATE X 004H,2018-03-01,7,1609,2324,1407,102727,210890,369775
300154416500,30-015-44165,EL PRESIDENTE STATE X 004H,2018-04-01,8,0,0,0,102727,210890,369775
300154416500,30-015-44165,EL PRESIDENTE STATE X 004H,2018-05-01,9,11377,6112,24369,114104,217002,394144
300154416500,30-015-44165,EL PRESIDENTE STATE X 004H,2018-06-01,10,1404,621,11016,115508,217623,405160
300154416500,30-015-44165,EL PRESIDENTE STATE X 004H,2018-07-01,11,5403,12487,95402,120911,230110,500562
300154416500,30-015-44165,EL PRESIDENTE STATE X 004H,2018-08-01,12,7173,20385,60663,128084,250495,561225
300154416500,30-015-44165,EL PRESIDENTE STATE X 004H,2018-09-01,13,5136,4640,39488,133220,255135,600713
300154416500,30-015-44165,EL PRESIDENTE STATE X 004H,2018-10-01,14,4638,6791,118205,137858,261926,718918
300154416500,30-015-44165,EL PRESIDENTE STATE X 004H,2018-11-01,15,3161,8096,34637,141019,270022,753555
300154416500,30-015-44165,EL PRESIDENTE STATE X 004H,2018-12-01,16,8246,13670,47882,149265,283692,801437
300154416500,30-015-44165,EL PRESIDENTE STATE X 004H,2019-01-01,17,2702,0,9696,151967,283692,811133
300154416500,30-015-44165,EL PRESIDENTE STATE X 004H,2019-02-01,18,5372,0,2874,157339,283692,814007
300154416500,30-015-44165,EL PRESIDENTE STATE X 004H,2019-03-01,19,5637,2059,1956,162976,285751,815963
300154416500,30-015-44165,EL PRESIDENTE STATE X 004H,2019-04-01,20,3849,5724,14011,166825,291475,829974
300154416500,30-015-44165,EL PRESIDENTE STATE X 004H,2019-05-01,21,2386,10081,25859,169211,301556,855833
300154416500,30-015-44165,EL PRESIDENTE STATE X 004H,2019-06-01,22,4963,12419,26493,174174,313975,882326
300154416500,30-015-44165,EL PRESIDENTE STATE X 004H,2019-07-01,23,6154,12908,24056,180328,326883,906382
300154416500,30-015-44165,EL PRESIDENTE STATE X 004H,2019-08-01,24,5666,17320,28756,185994,344203,935138
300154416500,30-015-44165,EL PRESIDENTE STATE X 004H,2019-09-01,25,4061,15053,22364,190055,359256,957502
300154416500,30-015-44165,EL PRESIDENTE STATE X 004H,2019-10-01,26,3749,14401,21844,193804,373657,979346
300154416500,30-015-44165,EL PRESIDENTE STATE X 004H,2019-11-01,27,2040,6502,10125,195844,380159,989471
300154416500,30-015-44165,EL PRESIDENTE STATE X 004H,2019-12-01,28,1650,1370,7354,197494,381529,996825
300154416500,30-015-44165,EL PRESIDENTE STATE X 004H,2020-01-01,29,2678,6669,15278,200172,388198,1012103
300154416500,30-015-44165,EL PRESIDENTE STATE X 004H,2020-02-01,30,1037,1273,5662,201209,389471,1017765
300154416500,30-015-44165,EL PRESIDENTE STATE X 004H,2020-03-01,31,2534,8648,16139,203743,398119,1033904
300154416500,30-015-44165,EL PRESIDENTE STATE X 004H,2020-04-01,32,2643,10832,17539,206386,408951,1051443
300154416500,30-015-44165,EL PRESIDENTE STATE X 004H,2020-05-01,33,2953,14434,19292,209339,423385,1070735
300154416500,30-015-44165,EL PRESIDENTE STATE X 004H,2020-06-01,34,2504,13756,17247,211843,437141,1087982
300154416500,30-015-44165,EL PRESIDENTE STATE X 004H,2020-07-01,35,2273,12025,16466,214116,449166,1104448
300154416500,30-015-44165,EL PRESIDENTE STATE X 004H,2020-08-01,36,1990,11370,14889,216106,460536,1119337
300154416500,30-015-44165,EL PRESIDENTE STATE X 004H,2020-09-01,37,1759,11494,14949,217865,472030,1134286
300154416500,30-015-44165,EL PRESIDENTE STATE X 004H,2020-10-01,38,1594,9651,12007,219459,481681,1146293
300154416500,30-015-44165,EL PRESIDENTE STATE X 004H,2020-11-01,39,3062,12322,13713,222521,494003,1160006
300154416500,30-015-44165,EL PRESIDENTE STATE X 004H,2020-12-01,40,2254,7710,9471,224775,501713,1169477
300154416500,30-015-44165,EL PRESIDENTE STATE X 004H,2021-01-01,41,2581,9424,14009,227356,511137,1183486
300154416500,30-015-44165,EL PRESIDENTE STATE X 004H,2021-02-01,42,694,2282,4561,228050,513419,1188047
300154416500,30-015-44165,EL PRESIDENTE STATE X 004H,2021-03-01,43,1660,5425,10200,229710,518844,1198247
300154416500,30-015-44165,EL PRESIDENTE STATE X 004H,2021-04-01,44,2176,10634,14482,231886,529478,1212729
300154416500,30-015-44165,EL PRESIDENTE STATE X 004H,2021-05-01,45,1669,9186,13652,233555,538664,1226381
300154416500,30-015-44165,EL PRESIDENTE STATE X 004H,2021-06-01,46,1566,8846,11230,235121,547510,1237611
300154416500,30-015-44165,EL PRESIDENTE STATE X 004H,2021-07-01,47,779,4310,4760,235900,551820,1242371
300154416500,30-015-44165,EL PRESIDENTE STATE X 004H,2021-08-01,48,1792,11216,13696,237692,563036,1256067
300154416500,30-015-44165,EL PRESIDENTE STATE X 004H,2021-09-01,49,2265,14270,11746,239957,577306,1267813
300154416500,30-015-44165,EL PRESIDENTE STATE X 004H,2021-10-01,50,2223,13494,12558,242180,590800,1280371
300154416500,30-015-44165,EL PRESIDENTE STATE X 004H,2021-11-01,51,1970,10806,10469,244150,601606,1290840
300154416500,30-015-44165,EL PRESIDENTE STATE X 004H,2021-12-01,52,1010,6541,5029,245160,608147,1295869
300154416500,30-015-44165,EL PRESIDENTE STATE X 004H,2022-01-01,53,14,442,0,245174,608589,1295869
300154416500,30-015-44165,EL PRESIDENTE STATE X 004H,2022-02-01,54,4,79,59,245178,608668,1295928
300154416500,30-015-44165,EL PRESIDENTE STATE X 004H,2022-03-01,55,0,0,0,245178,608668,1295928
300154416500,30-015-44165,EL PRESIDENTE STATE X 004H,2022-04-01,56,2189,9439,12697,247367,618107,1308625
300154416500,30-015-44165,EL PRESIDENTE STATE X 004H,2022-05-01,57,1513,11337,12050,248880,629444,1320675
300154416500,30-015-44165,EL PRESIDENTE STATE X 004H,2022-06-01,58,1289,9947,10974,250169,639391,1331649
300154416500,30-015-44165,EL PRESIDENTE STATE X 004H,2022-07-01,59,905,7279,6168,251074,646670,1337817
300154416500,30-015-44165,EL PRESIDENTE STATE X 004H,2022-08-01,60,1340,6642,12290,252414,653312,1350107
300154416500,30-015-44165,EL PRESIDENTE STATE X 004H,2022-09-01,61,1163,8713,11899,253577,662025,1362006
300154416500,30-015-44165,EL PRESIDENTE STATE X 004H,2022-10-01,62,1273,14340,12333,254850,676365,1374339
300154416500,30-015-44165,EL PRESIDENTE STATE X 004H,2022-11-01,63,1278,9948,8917,256128,686313,1383256
300154416500,30-015-44165,EL PRESIDENTE STATE X 004H,2022-12-01,64,895,9458,8432,257023,695771,1391688
300154416500,30-015-44165,EL PRESIDENTE STATE X 004H,2023-01-01,65,984,8435,8858,258007,704206,1400546
300154416500,30-015-44165,EL PRESIDENTE STATE X 004H,2023-02-01,66,1057,8688,8885,259064,712894,1409431
300154416500,30-015-44165,EL PRESIDENTE STATE X 004H,2023-03-01,67,1129,10274,9974,260193,723168,1419405
300154416500,30-015-44165,EL PRESIDENTE STATE X 004H,2023-04-01,68,965,10011,9306,261158,733179,1428711
300154416500,30-015-44165,EL PRESIDENTE STATE X 004H,2023-05-01,69,910,9749,8950,262068,742928,1437661
300154416500,30-015-44165,EL PRESIDENTE STATE X 004H,2023-06-01,70,990,10703,10241,263058,753631,1447902
300154496700,30-015-44967,SOUTH LOVING 2 11 W0CF STATE COM 001H,2018-10-01,1,8017,8579,30569,8017,8579,30569
300154496700,30-015-44967,SOUTH LOVING 2 11 W0CF STATE COM 001H,2018-11-01,2,17335,33732,64527,25352,42311,95096
300154496700,30-015-44967,SOUTH LOVING 2 11 W0CF STATE COM 001H,2018-12-01,3,20566,41046,66482,45918,83357,161578
300154496700,30-015-44967,SOUTH LOVING 2 11 W0CF STATE COM 001H,2019-01-01,4,24797,50613,70053,70715,133970,231631
300154496700,30-015-44967,SOUTH LOVING 2 11 W0CF STATE COM 001H,2019-02-01,5,20061,36624,57485,90776,170594,289116
300154496700,30-015-44967,SOUTH LOVING 2 11 W0CF STATE COM 001H,2019-03-01,6,18083,33504,56736,108859,204098,345852
300154496700,30-015-44967,SOUTH LOVING 2 11 W0CF STATE COM 001H,2019-04-01,7,10268,20373,34162,119127,224471,380014
300154496700,30-015-44967,SOUTH LOVING 2 11 W0CF STATE COM 001H,2019-05-01,8,10899,21653,35117,130026,246124,415131
300154496700,30-015-44967,SOUTH LOVING 2 11 W0CF STATE COM 001H,2019-06-01,9,8767,19110,27877,138793,265234,443008
300154496700,30-015-44967,SOUTH LOVING 2 11 W0CF STATE COM 001H,2019-07-01,10,3604,5788,12867,142397,271022,455875
300154496700,30-015-44967,SOUTH LOVING 2 11 W0CF STATE COM 001H,2019-08-01,11,10959,26741,43909,153356,297763,499784
300154496700,30-015-44967,SOUTH LOVING 2 11 W0CF STATE COM 001H,2019-09-01,12,9588,25729,40191,162944,323492,539975
300154496700,30-015-44967,SOUTH LOVING 2 11 W0CF STATE COM 001H,2019-10-01,13,8375,35451,41656,171319,358943,581631
300154496700,30-015-44967,SOUTH LOVING 2 11 W0CF STATE COM 001H,2019-11-01,14,7416,31539,38922,178735,390482,620553
300154496700,30-015-44967,SOUTH LOVING 2 11 W0CF STATE COM 001H,2019-12-01,15,7480,32273,41412,186215,422755,661965
300154496700,30-015-44967,SOUTH LOVING 2 11 W0CF STATE COM 001H,2020-01-01,16,5414,24850,34628,191629,447605,696593
300154496700,30-015-44967,SOUTH LOVING 2 11 W0CF STATE COM 001H,2020-02-01,17,8326,26686,33334,199955,474291,729927
300154496700,30-015-44967,SOUTH LOVING 2 11 W0CF STATE COM 001H,2020-03-01,18,6629,18338,25002,206584,492629,754929
300154496700,30-015-44967,SOUTH LOVING 2 11 W0CF STATE COM 001H,2020-04-01,19,7637,27199,32564,214221,519828,787493
300154496700,30-015-44967,SOUTH LOVING 2 11 W0CF STATE COM 001H,2020-05-01,20,3617,12160,18201,217838,531988,805694
300154496700,30-015-44967,SOUTH LOVING 2 11 W0CF STATE COM 001H,2020-06-01,21,3685,12393,19420,221523,544381,825114
300154496700,30-015-44967,SOUTH LOVING 2 11 W0CF STATE COM 001H,2020-07-01,22,5063,23615,32833,226586,567996,857947
300154496700,30-015-44967,SOUTH LOVING 2 11 W0CF STATE COM 001H,2020-08-01,23,5891,28017,26365,232477,596013,884312
300154496700,30-015-44967,SOUTH LOVING 2 11 W0CF STATE COM 001H,2020-09-01,24,5991,24354,29193,238468,620367,913505
300154496700,30-015-44967,SOUTH LOVING 2 11 W0CF STATE COM 001H,2020-10-01,25,4574,20690,24695,243042,641057,938200
300154496700,30-015-44967,SOUTH LOVING 2 11 W0CF STATE COM 001H,2020-11-01,26,4205,12789,20393,247247,653846,958593
300154496700,30-015-44967,SOUTH LOVING 2 11 W0CF STATE COM 001H,2020-12-01,27,3537,10840,19642,250784,664686,978235
300154496700,30-015-44967,SOUTH LOVING 2 11 W0CF STATE COM 001H,2021-01-01,28,4095,16307,24592,254879,680993,1002827
300154496700,30-015-44967,SOUTH LOVING 2 11 W0CF STATE COM 001H,2021-02-01,29,2197,7004,13649,257076,687997,1016476
300154496700,30-015-44967,SOUTH LOVING 2 11 W0CF STATE COM 001H,2021-03-01,30,3866,10943,17078,260942,698940,1033554
300154496700,30-015-44967,SOUTH LOVING 2 11 W0CF STATE COM 001H,2021-04-01,31,3523,14546,20092,264465,713486,1053646
300154496700,30-015-44967,SOUTH LOVING 2 11 W0CF STATE COM 001H,2021-05-01,32,4061,22275,23343,268526,735761,1076989
300154496700,30-015-44967,SOUTH LOVING 2 11 W0CF STATE COM 001H,2021-06-01,33,3277,15262,19316,271803,751023,1096305
300154496700,30-015-44967,SOUTH LOVING 2 11 W0CF STATE COM 001H,2021-07-01,34,3764,20732,22306,275567,771755,1118611
300154496700,30-015-44967,SOUTH LOVING 2 11 W0CF STATE COM 001H,2021-08-01,35,3050,16618,18952,278617,788373,1137563
300154496700,30-015-44967,SOUTH LOVING 2 11 W0CF STATE COM 001H,2021-09-01,36,3089,4635,14373,281706,793008,1151936
300154496700,30-015-44967,SOUTH LOVING 2 11 W0CF STATE COM 001H,2021-10-01,37,3512,7840,20451,285218,800848,1172387
300154496700,30-015-44967,SOUTH LOVING 2 11 W0CF STATE COM 001H,2021-11-01,38,2780,6921,16631,287998,807769,1189018
300154496700,30-015-44967,SOUTH LOVING 2 11 W0CF STATE COM 001H,2021-12-01,39,2998,8727,17910,290996,816496,1206928
300154496700,30-015-44967,SOUTH LOVING 2 11 W0CF STATE COM 001H,2022-01-01,40,3316,10140,15417,294312,826636,1222345
300154496700,30-015-44967,SOUTH LOVING 2 11 W0CF STATE COM 001H,2022-02-01,41,2848,13409,15507,297160,840045,1237852
300154496700,30-015-44967,SOUTH LOVING 2 11 W0CF STATE COM 001H,2022-03-01,42,4174,19990,21475,301334,860035,1259327
300154496700,30-015-44967,SOUTH LOVING 2 11 W0CF STATE COM 001H,2022-04-01,43,2591,11921,11311,303925,871956,1270638
300154496700,30-015-44967,SOUTH LOVING 2 11 W0CF STATE COM 001H,2022-05-01,44,3203,15495,17237,307128,887451,1287875
300154496700,30-015-44967,SOUTH LOVING 2 11 W0CF STATE COM 001H,2022-06-01,45,2579,13320,15148,309707,900771,1303023
300154496700,30-015-44967,SOUTH LOVING 2 11 W0CF STATE COM 001H,2022-07-01,46,2787,15741,16700,312494,916512,1319723
300154496700,30-015-44967,SOUTH LOVING 2 11 W0CF STATE COM 001H,2022-08-01,47,2315,13533,14115,314809,930045,1333838
300154496700,30-015-44967,SOUTH LOVING 2 11 W0CF STATE COM 001H,2022-09-01,48,2820,13710,16471,317629,943755,1350309
300154496700,30-015-44967,SOUTH LOVING 2 11 W0CF STATE COM 001H,2022-10-01,49,2422,14440,13299,320051,958195,1363608
300154496700,30-015-44967,SOUTH LOVING 2 11 W0CF STATE COM 001H,2022-11-01,50,2430,20688,14645,322481,978883,1378253
300154496700,30-015-44967,SOUTH LOVING 2 11 W0CF STATE COM 001H,2022-12-01,51,2241,13124,14544,324722,992007,1392797
300154496700,30-015-44967,SOUTH LOVING 2 11 W0CF STATE COM 001H,2023-01-01,52,2092,14752,15411,326814,1006759,1408208
300154496700,30-015-44967,SOUTH LOVING 2 11 W0CF STATE COM 001H,2023-02-01,53,2092,11249,13882,328906,1018008,1422090
300154496700,30-015-44967,SOUTH LOVING 2 11 W0CF STATE COM 001H,2023-03-01,54,2282,15778,16389,331188,1033786,1438479
300154496700,30-015-44967,SOUTH LOVING 2 11 W0CF STATE COM 001H,2023-04-01,55,2375,15875,15898,333563,1049661,1454377
300154496700,30-015-44967,SOUTH LOVING 2 11 W0CF STATE COM 001H,2023-05-01,56,1852,13560,12379,335415,1063221,1466756
300154496700,30-015-44967,SOUTH LOVING 2 11 W0CF STATE COM 001H,2023-06-01,57,1784,10389,12227,337199,1073610,1478983
300154496700,30-015-44967,SOUTH LOVING 2 11 W0CF STATE COM 001H,2023-07-01,58,2292,9751,14153,339491,1083361,1493136
300152389800,30-015-23898,SMITH 11 COM 001,2003-03-01,1,205,0,3265,628,586323,3849
300152389800,30-015-23898,SMITH 11 COM 001,2003-04-01,2,211,0,2463,839,586323,6312
300152389800,30-015-23898,SMITH 11 COM 001,2003-05-01,3,299,0,1830,1138,586323,8142
300152389800,30-015-23898,SMITH 11 COM 001,2003-06-01,4,0,0,0,1138,586323,8142
300152389800,30-015-23898,SMITH 11 COM 001,2003-07-01,5,0,0,0,1138,586323,8142
300152389800,30-015-23898,SMITH 11 COM 001,2003-08-01,6,0,0,0,1138,586323,8142
300152389800,30-015-23898,SMITH 11 COM 001,2003-09-01,7,0,0,0,1138,586323,8142
300152389800,30-015-23898,SMITH 11 COM 001,2003-10-01,8,0,0,0,1138,586323,8142
300152389800,30-015-23898,SMITH 11 COM 001,2003-11-01,9,0,0,0,1138,586323,8142
300152389800,30-015-23898,SMITH 11 COM 001,2003-12-01,10,0,0,0,1138,586323,8142
300152389800,30-015-23898,SMITH 11 COM 001,2004-01-01,11,0,0,730,1138,586323,8872
300152389800,30-015-23898,SMITH 11 COM 001,2004-02-01,12,359,0,3987,1497,586323,12859
300152389800,30-015-23898,SMITH 11 COM 001,2004-03-01,13,499,0,3848,1996,586323,16707
300152389800,30-015-23898,SMITH 11 COM 001,2004-04-01,14,610,0,5516,2606,586323,22223
300152389800,30-015-23898,SMITH 11 COM 001,2004-05-01,15,917,0,8592,3523,586323,30815
300152389800,30-015-23898,SMITH 11 COM 001,2004-06-01,16,971,0,9737,4494,586323,40552
300152389800,30-015-23898,SMITH 11 COM 001,2004-07-01,17,869,0,11588,5363,586323,52140
300152389800,30-015-23898,SMITH 11 COM 001,2004-08-01,18,773,0,10493,6136,586323,62633
300152389800,30-015-23898,SMITH 11 COM 001,2004-09-01,19,666,0,9860,6802,586323,72493
300152389800,30-015-23898,SMITH 11 COM 001,2004-10-01,20,571,0,10224,7373,586323,82717
300152389800,30-015-23898,SMITH 11 COM 001,2004-11-01,21,450,0,7370,7823,586323,90087
300152389800,30-015-23898,SMITH 11 COM 001,2004-12-01,22,355,0,5743,8178,586323,95830
300152389800,30-015-23898,SMITH 11 COM 001,2005-01-01,23,401,0,6999,8579,586323,102829
300152389800,30-015-23898,SMITH 11 COM 001,2005-02-01,24,234,0,4475,8813,586323,107304
300152389800,30-015-23898,SMITH 11 COM 001,2005-03-01,25,230,0,6486,9043,586323,113790
300152389800,30-015-23898,SMITH 11 COM 001,2005-04-01,26,322,0,7495,9365,586323,121285
300152389800,30-015-23898,SMITH 11 COM 001,2005-05-01,27,302,0,8211,9667,586323,129496
300152389800,30-015-23898,SMITH 11 COM 001,2005-06-01,28,253,0,6060,9920,586323,135556
300152389800,30-015-23898,SMITH 11 COM 001,2005-07-01,29,250,0,5712,10170,586323,141268
300152389800,30-015-23898,SMITH 11 COM 001,2005-08-01,30,190,0,6027,10360,586323,147295
300152389800,30-015-23898,SMITH 11 COM 001,2005-09-01,31,225,0,7240,10585,586323,154535
300152389800,30-015-23898,SMITH 11 COM 001,2005-10-01,32,183,0,6276,10768,586323,160811
300152389800,30-015-23898,SMITH 11 COM 001,2005-11-01,33,191,0,6481,10959,586323,167292
300152389800,30-015-23898,SMITH 11 COM 001,2005-12-01,34,224,0,7208,11183,586323,174500
300152389800,30-015-23898,SMITH 11 COM 001,2006-01-01,35,74,0,4371,11257,586323,178871
300152389800,30-015-23898,SMITH 11 COM 001,2006-02-01,36,65,0,4952,11322,586323,183823
300152389800,30-015-23898,SMITH 11 COM 001,2006-03-01,37,238,0,5807,11560,586323,189630
300152389800,30-015-23898,SMITH 11 COM 001,2006-04-01,38,177,0,4320,11737,586323,193950
300152389800,30-015-23898,SMITH 11 COM 001,2006-05-01,39,121,0,5602,11858,586323,199552
300152389800,30-015-23898,SMITH 11 COM 001,2006-06-01,40,132,0,3596,11990,586323,203148
300152389800,30-015-23898,SMITH 11 COM 001,2006-07-01,41,83,0,3340,12073,586323,206488
300152389800,30-015-23898,SMITH 11 COM 001,2006-08-01,42,57,0,3683,12130,586323,210171
300152389800,30-015-23898,SMITH 11 COM 001,2006-09-01,43,85,0,4491,12215,586323,214662
300152389800,30-015-23898,SMITH 11 COM 001,2006-10-01,44,139,0,4038,12354,586323,218700
300152389800,30-015-23898,SMITH 11 COM 001,2006-11-01,45,91,0,4238,12445,586323,222938
300152389800,30-015-23898,SMITH 11 COM 001,2006-12-01,46,80,0,4062,12525,586323,227000
300152389800,30-015-23898,SMITH 11 COM 001,2007-01-01,47,38,0,2040,12563,586323,229040
300152389800,30-015-23898,SMITH 11 COM 001,2007-02-01,48,72,0,4350,12635,586323,233390
300152389800,30-015-23898,SMITH 11 COM 001,2007-03-01,49,41,0,2516,12676,586323,235906
300152389800,30-015-23898,SMITH 11 COM 001,2007-04-01,50,31,0,4185,12707,586323,240091
300152389800,30-015-23898,SMITH 11 COM 001,2007-05-01,51,58,0,3454,12765,586323,243545
300152389800,30-015-23898,SMITH 11 COM 001,2007-06-01,52,112,0,4319,12877,586323,247864
300152389800,30-015-23898,SMITH 11 COM 001,2007-07-01,53,105,0,3187,12982,586323,251051
300152389800,30-015-23898,SMITH 11 COM 001,2007-08-01,54,8,0,73,12990,586323,251124
300152389800,30-015-23898,SMITH 11 COM 001,2007-09-01,55,5,0,0,12995,586323,251124
300152389800,30-015-23898,SMITH 11 COM 001,2007-10-01,56,3,0,2705,12998,586323,253829
300152389800,30-015-23898,SMITH 11 COM 001,2007-11-01,57,0,0,0,12998,586323,253829
300152389800,30-015-23898,SMITH 11 COM 001,2007-12-01,58,0,0,0,12998,586323,253829
300152389800,30-015-23898,SMITH 11 COM 001,2008-01-01,59,0,0,2124,12998,586323,255953
300152389800,30-015-23898,SMITH 11 COM 001,2008-02-01,60,5,0,2769,13003,586323,258722
300152389800,30-015-23898,SMITH 11 COM 001,2008-03-01,61,3,0,0,13006,586323,258722
300153423100,30-015-34231,SOUTH LOVING 2 STATE 001,2006-02-01,1,0,4664,119,0,4664,119
300153423100,30-015-34231,SOUTH LOVING 2 STATE 001,2006-03-01,2,0,16069,98,0,20733,217
300153423100,30-015-34231,SOUTH LOVING 2 STATE 001,2006-04-01,3,0,12810,68,0,33543,285
300153423100,30-015-34231,SOUTH LOVING 2 STATE 001,2006-05-01,4,0,11391,42,0,44934,327
300153423100,30-015-34231,SOUTH LOVING 2 STATE 001,2006-06-01,5,0,10743,20,0,55677,347
300153423100,30-015-34231,SOUTH LOVING 2 STATE 001,2006-07-01,6,0,8700,23,0,64377,370
300153423100,30-015-34231,SOUTH LOVING 2 STATE 001,2006-08-01,7,0,7971,59,0,72348,429
300153423100,30-015-34231,SOUTH LOVING 2 STATE 001,2006-09-01,8,0,5946,13,0,78294,442
300153423100,30-015-34231,SOUTH LOVING 2 STATE 001,2006-10-01,9,0,3666,4,0,81960,446
300153423100,30-015-34231,SOUTH LOVING 2 STATE 001,2006-11-01,10,0,6465,47,0,88425,493
300153423100,30-015-34231,SOUTH LOVING 2 STATE 001,2006-12-01,11,0,6418,2,0,94843,495
300153423100,30-015-34231,SOUTH LOVING 2 STATE 001,2007-01-01,12,0,3811,12,0,98654,507
300153423100,30-015-34231,SOUTH LOVING 2 STATE 001,2007-02-01,13,0,3619,97,0,102273,604
300153423100,30-015-34231,SOUTH LOVING 2 STATE 001,2007-03-01,14,0,3866,3,0,106139,607
300153423100,30-015-34231,SOUTH LOVING 2 STATE 001,2007-04-01,15,0,5155,32,0,111294,639
300153423100,30-015-34231,SOUTH LOVING 2 STATE 001,2007-05-01,16,0,8667,24,0,119961,663
300153423100,30-015-34231,SOUTH LOVING 2 STATE 001,2007-06-01,17,0,7454,55,0,127415,718
300153423100,30-015-34231,SOUTH LOVING 2 STATE 001,2007-07-01,18,0,7528,28,0,134943,746
300153423100,30-015-34231,SOUTH LOVING 2 STATE 001,2007-08-01,19,0,7168,17,0,142111,763
300153423100,30-015-34231,SOUTH LOVING 2 STATE 001,2007-09-01,20,0,6116,19,0,148227,782
300153423100,30-015-34231,SOUTH LOVING 2 STATE 001,2007-10-01,21,0,6018,4,0,154245,786
300153423100,30-015-34231,SOUTH LOVING 2 STATE 001,2007-11-01,22,0,5300,3,0,159545,789
300153423100,30-015-34231,SOUTH LOVING 2 STATE 001,2007-12-01,23,0,5980,83,0,165525,872
300153423100,30-015-34231,SOUTH LOVING 2 STATE 001,2008-01-01,24,0,5823,15,0,171348,887
300153423100,30-015-34231,SOUTH LOVING 2 STATE 001,2008-02-01,25,0,5327,13,0,176675,900
300153423100,30-015-34231,SOUTH LOVING 2 STATE 001,2008-03-01,26,0,5569,8,0,182244,908
300153423100,30-015-34231,SOUTH LOVING 2 STATE 001,2008-04-01,27,0,4549,48,0,186793,956
300153423100,30-015-34231,SOUTH LOVING 2 STATE 001,2008-05-01,28,0,5746,20,0,192539,976
300153423100,30-015-34231,SOUTH LOVING 2 STATE 001,2008-06-01,29,0,5148,15,0,197687,991
300153423100,30-015-34231,SOUTH LOVING 2 STATE 001,2008-07-01,30,0,5125,6,0,202812,997
300153423100,30-015-34231,SOUTH LOVING 2 STATE 001,2008-08-01,31,0,5237,5,0,208049,1002
300153423100,30-015-34231,SOUTH LOVING 2 STATE 001,2008-09-01,32,0,4796,5,0,212845,1007
300153423100,30-015-34231,SOUTH LOVING 2 STATE 001,2008-10-01,33,0,4896,10,0,217741,1017
300153423100,30-015-34231,SOUTH LOVING 2 STATE 001,2008-11-01,34,0,4580,2,0,222321,1019
300153423100,30-015-34231,SOUTH LOVING 2 STATE 001,2008-12-01,35,0,3318,0,0,225639,1019
300153423100,30-015-34231,SOUTH LOVING 2 STATE 001,2009-01-01,36,0,4135,4,0,229774,1023
300153423100,30-015-34231,SOUTH LOVING 2 STATE 001,2009-02-01,37,0,5400,1,0,235174,1024
300153423100,30-015-34231,SOUTH LOVING 2 STATE 001,2009-03-01,38,0,5690,0,0,240864,1024
300153423100,30-015-34231,SOUTH LOVING 2 STATE 001,2009-04-01,39,0,5347,0,0,246211,1024
300153423100,30-015-34231,SOUTH LOVING 2 STATE 001,2009-05-01,40,0,4143,0,0,250354,1024
300153423100,30-015-34231,SOUTH LOVING 2 STATE 001,2009-06-01,41,0,5843,0,0,256197,1024
300153423100,30-015-34231,SOUTH LOVING 2 STATE 001,2009-07-01,42,0,5471,0,0,261668,1024
300153423100,30-015-34231,SOUTH LOVING 2 STATE 001,2009-08-01,43,0,5254,0,0,266922,1024
300153423100,30-015-34231,SOUTH LOVING 2 STATE 001,2009-09-01,44,0,4838,54,0,271760,1078
300153423100,30-015-34231,SOUTH LOVING 2 STATE 001,2009-10-01,45,0,5113,19,0,276873,1097
300153423100,30-015-34231,SOUTH LOVING 2 STATE 001,2009-11-01,46,0,4782,19,0,281655,1116
300153423100,30-015-34231,SOUTH LOVING 2 STATE 001,2009-12-01,47,0,5407,15,0,287062,1131
300153423100,30-015-34231,SOUTH LOVING 2 STATE 001,2010-01-01,48,0,3293,0,0,290355,1131
300153423100,30-015-34231,SOUTH LOVING 2 STATE 001,2010-02-01,49,0,5292,44,0,295647,1175
300153423100,30-015-34231,SOUTH LOVING 2 STATE 001,2010-03-01,50,0,4748,32,0,300395,1207
300153423100,30-015-34231,SOUTH LOVING 2 STATE 001,2010-04-01,51,0,3793,5,0,304188,1212
300153423100,30-015-34231,SOUTH LOVING 2 STATE 001,2010-05-01,52,0,5335,3,0,309523,1215
300153423100,30-015-34231,SOUTH LOVING 2 STATE 001,2010-06-01,53,0,4759,0,0,314282,1215
300153423100,30-015-34231,SOUTH LOVING 2 STATE 001,2010-07-01,54,0,5059,2,0,319341,1217
300153423100,30-015-34231,SOUTH LOVING 2 STATE 001,2010-08-01,55,0,4960,2,0,324301,1219
300153423100,30-015-34231,SOUTH LOVING 2 STATE 001,2010-09-01,56,0,4762,2,0,329063,1221
300153423100,30-015-34231,SOUTH LOVING 2 STATE 001,2010-10-01,57,0,5226,0,0,334289,1221
300153423100,30-015-34231,SOUTH LOVING 2 STATE 001,2010-11-01,58,0,4599,0,0,338888,1221
300153423100,30-015-34231,SOUTH LOVING 2 STATE 001,2010-12-01,59,0,4690,0,0,343578,1221
300153423100,30-015-34231,SOUTH LOVING 2 STATE 001,2011-01-01,60,0,4128,0,0,347706,1221
300153423100,30-015-34231,SOUTH LOVING 2 STATE 001,2011-02-01,61,0,3719,0,0,351425,1221
300153423100,30-015-34231,SOUTH LOVING 2 STATE 001,2011-03-01,62,0,3688,0,0,355113,1221
300153423100,30-015-34231,SOUTH LOVING 2 STATE 001,2011-04-01,63,0,3592,24,0,358705,1245
300153423100,30-015-34231,SOUTH LOVING 2 STATE 001,2011-05-01,64,0,2969,5,0,361674,1250
300153423100,30-015-34231,SOUTH LOVING 2 STATE 001,2011-06-01,65,0,3705,8,0,365379,1258
300153423100,30-015-34231,SOUTH LOVING 2 STATE 001,2011-07-01,66,0,3214,0,0,368593,1258
300153423100,30-015-34231,SOUTH LOVING 2 STATE 001,2011-08-01,67,0,3386,0,0,371979,1258
300153423100,30-015-34231,SOUTH LOVING 2 STATE 001,2011-09-01,68,0,4188,0,0,376167,1258
300153423100,30-015-34231,SOUTH LOVING 2 STATE 001,2011-10-01,69,0,3565,0,0,379732,1258
300153423100,30-015-34231,SOUTH LOVING 2 STATE 001,2011-11-01,70,0,2841,9,0,382573,1267
300153423100,30-015-34231,SOUTH LOVING 2 STATE 001,2011-12-01,71,0,3183,0,0,385756,1267
300153423100,30-015-34231,SOUTH LOVING 2 STATE 001,2012-01-01,72,0,3185,10,0,388941,1277
300153423100,30-015-34231,SOUTH LOVING 2 STATE 001,2012-02-01,73,0,2855,0,0,391796,1277
300153423100,30-015-34231,SOUTH LOVING 2 STATE 001,2012-03-01,74,0,2169,0,0,393965,1277
300153423100,30-015-34231,SOUTH LOVING 2 STATE 001,2012-04-01,75,0,3578,3,0,397543,1280
300153423100,30-015-34231,SOUTH LOVING 2 STATE 001,2012-05-01,76,0,4094,1,0,401637,1281
300153423100,30-015-34231,SOUTH LOVING 2 STATE 001,2012-06-01,77,0,5181,15,0,406818,1296
300153423100,30-015-34231,SOUTH LOVING 2 STATE 001,2012-07-01,78,0,5216,18,0,412034,1314
300153423100,30-015-34231,SOUTH LOVING 2 STATE 001,2012-08-01,79,0,4995,19,0,417029,1333
300153423100,30-015-34231,SOUTH LOVING 2 STATE 001,2012-09-01,80,0,4264,17,0,421293,1350
300153423100,30-015-34231,SOUTH LOVING 2 STATE 001,2012-10-01,81,0,3845,7,0,425138,1357
300153423100,30-015-34231,SOUTH LOVING 2 STATE 001,2012-11-01,82,0,4176,20,0,429314,1377
300153423100,30-015-34231,SOUTH LOVING 2 STATE 001,2012-12-01,83,0,4077,19,0,433391,1396
300153423100,30-015-34231,SOUTH LOVING 2 STATE 001,2013-01-01,84,0,3889,11,0,437280,1407
300153423100,30-015-34231,SOUTH LOVING 2 STATE 001,2013-02-01,85,0,3554,11,0,440834,1418
300153423100,30-015-34231,SOUTH LOVING 2 STATE 001,2013-03-01,86,0,3912,6,0,444746,1424
300153423100,30-015-34231,SOUTH LOVING 2 STATE 001,2013-04-01,87,0,3647,21,0,448393,1445
300153423100,30-015-34231,SOUTH LOVING 2 STATE 001,2013-05-01,88,0,3543,23,0,451936,1468
300153423100,30-015-34231,SOUTH LOVING 2 STATE 001,2013-06-01,89,0,3448,0,0,455384,1468
300153423100,30-015-34231,SOUTH LOVING 2 STATE 001,2013-07-01,90,0,2917,0,0,458301,1468
300153423100,30-015-34231,SOUTH LOVING 2 STATE 001,2013-08-01,91,0,2790,0,0,461091,1468
300153423100,30-015-34231,SOUTH LOVING 2 STATE 001,2013-09-01,92,0,2879,0,0,463970,1468
300153423100,30-015-34231,SOUTH LOVING 2 STATE 001,2013-10-01,93,0,3489,0,0,467459,1468
300153423100,30-015-34231,SOUTH LOVING 2 STATE 001,2013-11-01,94,0,2763,0,0,470222,1468
300153423100,30-015-34231,SOUTH LOVING 2 STATE 001,2013-12-01,95,0,2403,0,0,472625,1468
300153423100,30-015-34231,SOUTH LOVING 2 STATE 001,2014-01-01,96,0,2201,0,0,474826,1468
300153423100,30-015-34231,SOUTH LOVING 2 STATE 001,2014-02-01,97,0,2752,0,0,477578,1468
300153423100,30-015-34231,SOUTH LOVING 2 STATE 001,2014-03-01,98,0,3068,5,0,480646,1473
300153423100,30-015-34231,SOUTH LOVING 2 STATE 001,2014-04-01,99,0,3592,0,0,484238,1473
300153423100,30-015-34231,SOUTH LOVING 2 STATE 001,2014-05-01,100,0,5644,0,0,489882,1473
300153423100,30-015-34231,SOUTH LOVING 2 STATE 001,2014-06-01,101,0,4857,5,0,494739,1478
300153423100,30-015-34231,SOUTH LOVING 2 STATE 001,2014-07-01,102,0,4566,0,0,499305,1478
300153423100,30-015-34231,SOUTH LOVING 2 STATE 001,2014-08-01,103,0,4427,1,0,503732,1479
300153423100,30-015-34231,SOUTH LOVING 2 STATE 001,2014-09-01,104,0,3085,0,0,506817,1479
300153423100,30-015-34231,SOUTH LOVING 2 STATE 001,2014-10-01,105,0,4402,5,0,511219,1484
300153423100,30-015-34231,SOUTH LOVING 2 STATE 001,2014-11-01,106,0,4385,0,0,515604,1484
300153423100,30-015-34231,SOUTH LOVING 2 STATE 001,2014-12-01,107,0,5350,0,0,520954,1484
300153423100,30-015-34231,SOUTH LOVING 2 STATE 001,2015-01-01,108,0,2111,0,0,523065,1484
300153423100,30-015-34231,SOUTH LOVING 2 STATE 001,2015-02-01,109,0,5483,0,0,528548,1484
300153423100,30-015-34231,SOUTH LOVING 2 STATE 001,2015-03-01,110,0,5450,0,0,533998,1484
300153423100,30-015-34231,SOUTH LOVING 2 STATE 001,2015-04-01,111,0,3046,0,0,537044,1484
300153423100,30-015-34231,SOUTH LOVING 2 STATE 001,2015-05-01,112,0,5065,0,0,542109,1484
300153423100,30-015-34231,SOUTH LOVING 2 STATE 001,2015-06-01,113,0,4385,1,0,546494,1485
300153423100,30-015-34231,SOUTH LOVING 2 STATE 001,2015-07-01,114,0,3697,7,0,550191,1492
300153423100,30-015-34231,SOUTH LOVING 2 STATE 001,2015-08-01,115,0,5199,9,0,555390,1501
300153423100,30-015-34231,SOUTH LOVING 2 STATE 001,2015-09-01,116,0,4605,5,0,559995,1506
300153423100,30-015-34231,SOUTH LOVING 2 STATE 001,2015-10-01,117,0,4571,5,0,564566,1511
300153423100,30-015-34231,SOUTH LOVING 2 STATE 001,2015-11-01,118,0,2996,11,0,567562,1522
300153423100,30-015-34231,SOUTH LOVING 2 STATE 001,2015-12-01,119,0,3856,3,0,571418,1525
300153423100,30-015-34231,SOUTH LOVING 2 STATE 001,2016-01-01,120,0,5518,9,0,576936,1534
300153423100,30-015-34231,SOUTH LOVING 2 STATE 001,2016-02-01,121,0,4208,6,0,581144,1540
300153423100,30-015-34231,SOUTH LOVING 2 STATE 001,2016-03-01,122,0,3411,6,0,584555,1546
300153423100,30-015-34231,SOUTH LOVING 2 STATE 001,2016-04-01,123,0,2604,7,0,587159,1553
300153423100,30-015-34231,SOUTH LOVING 2 STATE 001,2016-05-01,124,0,4673,11,0,591832,1564
300153423100,30-015-34231,SOUTH LOVING 2 STATE 001,2016-06-01,125,0,3998,3,0,595830,1567
300153423100,30-015-34231,SOUTH LOVING 2 STATE 001,2016-07-01,126,0,3024,6,0,598854,1573
300153423100,30-015-34231,SOUTH LOVING 2 STATE 001,2016-08-01,127,0,268,17,0,599122,1590
300153423100,30-015-34231,SOUTH LOVING 2 STATE 001,2016-09-01,128,0,4902,0,0,604024,1590
300153423100,30-015-34231,SOUTH LOVING 2 STATE 001,2016-10-01,129,0,4905,0,0,608929,1590
300153423100,30-015-34231,SOUTH LOVING 2 STATE 001,2016-11-01,130,0,4189,0,0,613118,1590
300153423100,30-015-34231,SOUTH LOVING 2 STATE 001,2016-12-01,131,0,3496,0,0,616614,1590
300153423100,30-015-34231,SOUTH LOVING 2 STATE 001,2017-01-01,132,0,3416,0,0,620030,1590
300153423100,30-015-34231,SOUTH LOVING 2 STATE 001,2017-02-01,133,0,3635,0,0,623665,1590
300153423100,30-015-34231,SOUTH LOVING 2 STATE 001,2017-03-01,134,0,3761,3,0,627426,1593
300153423100,30-015-34231,SOUTH LOVING 2 STATE 001,2017-04-01,135,0,3567,2,0,630993,1595
300153423100,30-015-34231,SOUTH LOVING 2 STATE 001,2017-05-01,136,0,3598,0,0,634591,1595
300153423100,30-015-34231,SOUTH LOVING 2 STATE 001,2017-06-01,137,0,3489,0,0,638080,1595
300153423100,30-015-34231,SOUTH LOVING 2 STATE 001,2017-07-01,138,0,3371,0,0,641451,1595
300153423100,30-015-34231,SOUTH LOVING 2 STATE 001,2017-08-01,139,0,3819,0,0,645270,1595
300153423100,30-015-34231,SOUTH LOVING 2 STATE 001,2017-09-01,140,0,3381,0,0,648651,1595
300153423100,30-015-34231,SOUTH LOVING 2 STATE 001,2017-10-01,141,0,3477,0,0,652128,1595
300153423100,30-015-34231,SOUTH LOVING 2 STATE 001,2017-11-01,142,0,3159,0,0,655287,1595
300153423100,30-015-34231,SOUTH LOVING 2 STATE 001,2017-12-01,143,0,3356,0,0,658643,1595
300153423100,30-015-34231,SOUTH LOVING 2 STATE 001,2018-01-01,144,0,3291,0,0,661934,1595
300153423100,30-015-34231,SOUTH LOVING 2 STATE 001,2018-02-01,145,0,2992,0,0,664926,1595
300153423100,30-015-34231,SOUTH LOVING 2 STATE 001,2018-03-01,146,0,2691,6,0,667617,1601
300153423100,30-015-34231,SOUTH LOVING 2 STATE 001,2018-04-01,147,0,2079,0,0,669696,1601
300153423100,30-015-34231,SOUTH LOVING 2 STATE 001,2018-05-01,148,0,3432,0,0,673128,1601
300153423100,30-015-34231,SOUTH LOVING 2 STATE 001,2018-06-01,149,0,3309,0,0,676437,1601
300153423100,30-015-34231,SOUTH LOVING 2 STATE 001,2018-07-01,150,0,3138,0,0,679575,1601
300153423100,30-015-34231,SOUTH LOVING 2 STATE 001,2018-08-01,151,0,3568,0,0,683143,1601
300153423100,30-015-34231,SOUTH LOVING 2 STATE 001,2018-09-01,152,0,2843,0,0,685986,1601
300153423100,30-015-34231,SOUTH LOVING 2 STATE 001,2018-10-01,153,0,4068,0,0,690054,1601
300153423100,30-015-34231,SOUTH LOVING 2 STATE 001,2018-11-01,154,0,3274,0,0,693328,1601
300153423100,30-015-34231,SOUTH LOVING 2 STATE 001,2018-12-01,155,0,3413,0,0,696741,1601
300153423100,30-015-34231,SOUTH LOVING 2 STATE 001,2019-01-01,156,0,3571,0,0,700312,1601
300153423100,30-015-34231,SOUTH LOVING 2 STATE 001,2019-02-01,157,0,3435,0,0,703747,1601
300153423100,30-015-34231,SOUTH LOVING 2 STATE 001,2019-03-01,158,0,3242,0,0,706989,1601
300153423100,30-015-34231,SOUTH LOVING 2 STATE 001,2019-04-01,159,0,313,0,0,707302,1601
300153423100,30-015-34231,SOUTH LOVING 2 STATE 001,2019-05-01,160,0,1362,0,0,708664,1601
300153423100,30-015-34231,SOUTH LOVING 2 STATE 001,2019-06-01,161,0,713,0,0,709377,1601
300153423100,30-015-34231,SOUTH LOVING 2 STATE 001,2019-07-01,162,0,1081,0,0,710458,1601
300153423100,30-015-34231,SOUTH LOVING 2 STATE 001,2019-08-01,163,0,831,0,0,711289,1601
300153423100,30-015-34231,SOUTH LOVING 2 STATE 001,2019-09-01,164,0,4620,0,0,715909,1601
300153423100,30-015-34231,SOUTH LOVING 2 STATE 001,2019-10-01,165,0,5010,0,0,720919,1601
300153423100,30-015-34231,SOUTH LOVING 2 STATE 001,2019-11-01,166,0,4407,0,0,725326,1601
300153423100,30-015-34231,SOUTH LOVING 2 STATE 001,2019-12-01,167,0,4706,0,0,730032,1601
300153423100,30-015-34231,SOUTH LOVING 2 STATE 001,2020-01-01,168,0,4561,0,0,734593,1601
300153423100,30-015-34231,SOUTH LOVING 2 STATE 001,2020-02-01,169,0,4305,0,0,738898,1601
300153423100,30-015-34231,SOUTH LOVING 2 STATE 001,2020-03-01,170,0,788,0,0,739686,1601
300153423100,30-015-34231,SOUTH LOVING 2 STATE 001,2020-04-01,171,0,431,0,0,740117,1601
300153423100,30-015-34231,SOUTH LOVING 2 STATE 001,2020-05-01,172,0,5015,0,0,745132,1601
300153423100,30-015-34231,SOUTH LOVING 2 STATE 001,2020-06-01,173,0,6638,38,0,751770,1639
300153423100,30-015-34231,SOUTH LOVING 2 STATE 001,2020-07-01,174,0,8267,23,0,760037,1662
300153423100,30-015-34231,SOUTH LOVING 2 STATE 001,2020-08-01,175,0,904,5,0,760941,1667
300153423100,30-015-34231,SOUTH LOVING 2 STATE 001,2020-09-01,176,0,7939,0,0,768880,1667
300153423100,30-015-34231,SOUTH LOVING 2 STATE 001,2020-10-01,177,0,8016,0,0,776896,1667
300153423100,30-015-34231,SOUTH LOVING 2 STATE 001,2020-11-01,178,0,7308,0,0,784204,1667
300153423100,30-015-34231,SOUTH LOVING 2 STATE 001,2020-12-01,179,0,7499,49,0,791703,1716
300153423100,30-015-34231,SOUTH LOVING 2 STATE 001,2021-01-01,180,0,6480,11,0,798183,1727
300153423100,30-015-34231,SOUTH LOVING 2 STATE 001,2021-02-01,181,0,4641,19,0,802824,1746
300153423100,30-015-34231,SOUTH LOVING 2 STATE 001,2021-03-01,182,0,7003,6,0,809827,1752
300153423100,30-015-34231,SOUTH LOVING 2 STATE 001,2021-04-01,183,0,6551,0,0,816378,1752
300153423100,30-015-34231,SOUTH LOVING 2 STATE 001,2021-05-01,184,0,6043,5,0,822421,1757
300153423100,30-015-34231,SOUTH LOVING 2 STATE 001,2021-06-01,185,0,4743,10,0,827164,1767
300153423100,30-015-34231,SOUTH LOVING 2 STATE 001,2021-07-01,186,0,5333,9,0,832497,1776
300153423100,30-015-34231,SOUTH LOVING 2 STATE 001,2021-08-01,187,0,4891,10,0,837388,1786
300153423100,30-015-34231,SOUTH LOVING 2 STATE 001,2021-09-01,188,0,5567,14,0,842955,1800
300153423100,30-015-34231,SOUTH LOVING 2 STATE 001,2021-10-01,189,0,5748,15,0,848703,1815
300153423100,30-015-34231,SOUTH LOVING 2 STATE 001,2021-11-01,190,0,5639,12,0,854342,1827
300153423100,30-015-34231,SOUTH LOVING 2 STATE 001,2021-12-01,191,0,1148,0,0,855490,1827
300153423100,30-015-34231,SOUTH LOVING 2 STATE 001,2022-01-01,192,0,6352,11,0,861842,1838
300153423100,30-015-34231,SOUTH LOVING 2 STATE 001,2022-02-01,193,0,4848,8,0,866690,1846
300153423100,30-015-34231,SOUTH LOVING 2 STATE 001,2022-03-01,194,0,5312,114,0,872002,1960
300153423100,30-015-34231,SOUTH LOVING 2 STATE 001,2022-04-01,195,0,5196,0,0,877198,1960
300153423100,30-015-34231,SOUTH LOVING 2 STATE 001,2022-05-01,196,0,4646,0,0,881844,1960
300153423100,30-015-34231,SOUTH LOVING 2 STATE 001,2022-06-01,197,0,6470,0,0,888314,1960
300153423100,30-015-34231,SOUTH LOVING 2 STATE 001,2022-07-01,198,0,4794,0,0,893108,1960
300153423100,30-015-34231,SOUTH LOVING 2 STATE 001,2022-08-01,199,0,81,0,0,893189,1960
300153423100,30-015-34231,SOUTH LOVING 2 STATE 001,2022-09-01,200,0,6813,0,0,900002,1960
300153423100,30-015-34231,SOUTH LOVING 2 STATE 001,2022-10-01,201,0,3801,0,0,903803,1960
300153423100,30-015-34231,SOUTH LOVING 2 STATE 001,2022-11-01,202,0,6887,6,0,910690,1966
300153423100,30-015-34231,SOUTH LOVING 2 STATE 001,2022-12-01,203,0,3128,0,0,913818,1966
300153423100,30-015-34231,SOUTH LOVING 2 STATE 001,2023-01-01,204,0,2198,6,0,916016,1972
300153423100,30-015-34231,SOUTH LOVING 2 STATE 001,2023-02-01,205,0,5485,0,0,921501,1972
300153423100,30-015-34231,SOUTH LOVING 2 STATE 001,2023-03-01,206,0,5251,0,0,926752,1972
300153423100,30-015-34231,SOUTH LOVING 2 STATE 001,2023-04-01,207,0,833,0,0,927585,1972
300153423100,30-015-34231,SOUTH LOVING 2 STATE 001,2023-05-01,208,0,1795,0,0,929380,1972
300153423100,30-015-34231,SOUTH LOVING 2 STATE 001,2023-06-01,209,0,4409,2,0,933789,1974
300153423100,30-015-34231,SOUTH LOVING 2 STATE 001,2023-07-01,210,0,5576,11,0,939365,1985
300154177500,30-015-41775,RUSTLER BREAKS 12 24 27 001H,2014-02-01,1,351,12902,0,351,12902,0
300154177500,30-015-41775,RUSTLER BREAKS 12 24 27 001H,2014-03-01,2,2194,8736,0,2545,21638,0
300154177500,30-015-41775,RUSTLER BREAKS 12 24 27 001H,2014-04-01,3,543,1838,143,3088,23476,143
300154177500,30-015-41775,RUSTLER BREAKS 12 24 27 001H,2014-05-01,4,12057,85492,38558,15145,108968,38701
300154177500,30-015-41775,RUSTLER BREAKS 12 24 27 001H,2014-06-01,5,8395,63057,34102,23540,172025,72803
300154177500,30-015-41775,RUSTLER BREAKS 12 24 27 001H,2014-07-01,6,7725,58432,29563,31265,230457,102366
300154177500,30-015-41775,RUSTLER BREAKS 12 24 27 001H,2014-08-01,7,6523,52538,25058,37788,282995,127424
300154177500,30-015-41775,RUSTLER BREAKS 12 24 27 001H,2014-09-01,8,5292,45376,18852,43080,328371,146276
300154177500,30-015-41775,RUSTLER BREAKS 12 24 27 001H,2014-10-01,9,5478,44983,18299,48558,373354,164575
300154177500,30-015-41775,RUSTLER BREAKS 12 24 27 001H,2014-11-01,10,4601,38147,15197,53159,411501,179772
300154177500,30-015-41775,RUSTLER BREAKS 12 24 27 001H,2014-12-01,11,4308,36119,13568,57467,447620,193340
300154177500,30-015-41775,RUSTLER BREAKS 12 24 27 001H,2015-01-01,12,4205,37263,13820,61672,484883,207160
300154177500,30-015-41775,RUSTLER BREAKS 12 24 27 001H,2015-02-01,13,4413,42041,16513,66085,526924,223673
300154177500,30-015-41775,RUSTLER BREAKS 12 24 27 001H,2015-03-01,14,4692,1664,18820,70777,528588,242493
300154177500,30-015-41775,RUSTLER BREAKS 12 24 27 001H,2015-04-01,15,3794,37450,15850,74571,566038,258343
300154177500,30-015-41775,RUSTLER BREAKS 12 24 27 001H,2015-05-01,16,3579,36333,15522,78150,602371,273865
300154177500,30-015-41775,RUSTLER BREAKS 12 24 27 001H,2015-06-01,17,3124,31623,13462,81274,633994,287327
300154177500,30-015-41775,RUSTLER BREAKS 12 24 27 001H,2015-07-01,18,3086,32808,12637,84360,666802,299964
300154177500,30-015-41775,RUSTLER BREAKS 12 24 27 001H,2015-08-01,19,2909,32104,11302,87269,698906,311266
300154177500,30-015-41775,RUSTLER BREAKS 12 24 27 001H,2015-09-01,20,2721,28094,10310,89990,727000,321576
300154177500,30-015-41775,RUSTLER BREAKS 12 24 27 001H,2015-10-01,21,2739,27730,9663,92729,754730,331239
300154177500,30-015-41775,RUSTLER BREAKS 12 24 27 001H,2015-11-01,22,2499,25478,8507,95228,780208,339746
300154177500,30-015-41775,RUSTLER BREAKS 12 24 27 001H,2015-12-01,23,2612,26586,8523,97840,806794,348269
300154177500,30-015-41775,RUSTLER BREAKS 12 24 27 001H,2016-01-01,24,2564,25706,7905,100404,832500,356174
300154177500,30-015-41775,RUSTLER BREAKS 12 24 27 001H,2016-02-01,25,2306,22269,7550,102710,854769,363724
300154177500,30-015-41775,RUSTLER BREAKS 12 24 27 001H,2016-03-01,26,2411,23090,7806,105121,877859,371530
300154177500,30-015-41775,RUSTLER BREAKS 12 24 27 001H,2016-04-01,27,2310,22503,7550,107431,900362,379080
300154177500,30-015-41775,RUSTLER BREAKS 12 24 27 001H,2016-05-01,28,2401,27512,7393,109832,927874,386473
300154177500,30-015-41775,RUSTLER BREAKS 12 24 27 001H,2016-06-01,29,2110,21912,6168,111942,949786,392641
300154177500,30-015-41775,RUSTLER BREAKS 12 24 27 001H,2016-07-01,30,2081,21698,5062,114023,971484,397703
300154177500,30-015-41775,RUSTLER BREAKS 12 24 27 001H,2016-08-01,31,2080,21041,5863,116103,992525,403566
300154177500,30-015-41775,RUSTLER BREAKS 12 24 27 001H,2016-09-01,32,2166,21688,6592,118269,1014213,410158
300154177500,30-015-41775,RUSTLER BREAKS 12 24 27 001H,2016-10-01,33,2213,21790,6823,120482,1036003,416981
300154177500,30-015-41775,RUSTLER BREAKS 12 24 27 001H,2016-11-01,34,2019,21324,6573,122501,1057327,423554
300154177500,30-015-41775,RUSTLER BREAKS 12 24 27 001H,2016-12-01,35,1842,20276,4789,124343,1077603,428343
300154177500,30-015-41775,RUSTLER BREAKS 12 24 27 001H,2017-01-01,36,1749,17807,3845,126092,1095410,432188
300154177500,30-015-41775,RUSTLER BREAKS 12 24 27 001H,2017-02-01,37,1186,12941,2455,127278,1108351,434643
300154177500,30-015-41775,RUSTLER BREAKS 12 24 27 001H,2017-03-01,38,613,9031,5439,127891,1117382,440082
300154177500,30-015-41775,RUSTLER BREAKS 12 24 27 001H,2017-04-01,39,1909,38839,7270,129800,1156221,447352
300154177500,30-015-41775,RUSTLER BREAKS 12 24 27 001H,2017-05-01,40,632,12990,7248,130432,1169211,454600
300154177500,30-015-41775,RUSTLER BREAKS 12 24 27 001H,2017-06-01,41,505,1589,5960,130937,1170800,460560
300154177500,30-015-41775,RUSTLER BREAKS 12 24 27 001H,2017-07-01,42,623,3469,4964,131560,1174269,465524
300154177500,30-015-41775,RUSTLER BREAKS 12 24 27 001H,2017-08-01,43,673,8915,4888,132233,1183184,470412
300154177500,30-015-41775,RUSTLER BREAKS 12 24 27 001H,2017-09-01,44,554,9965,5117,132787,1193149,475529
300154177500,30-015-41775,RUSTLER BREAKS 12 24 27 001H,2017-10-01,45,585,7115,5590,133372,1200264,481119
300154177500,30-015-41775,RUSTLER BREAKS 12 24 27 001H,2017-11-01,46,593,6578,5950,133965,1206842,487069
300154177500,30-015-41775,RUSTLER BREAKS 12 24 27 001H,2017-12-01,47,654,0,6263,134619,1206842,493332
300154177500,30-015-41775,RUSTLER BREAKS 12 24 27 001H,2018-01-01,48,606,7455,6525,135225,1214297,499857
300154177500,30-015-41775,RUSTLER BREAKS 12 24 27 001H,2018-02-01,49,683,6054,8519,135908,1220351,508376
300154177500,30-015-41775,RUSTLER BREAKS 12 24 27 001H,2018-03-01,50,752,222,7223,136660,1220573,515599
300154177500,30-015-41775,RUSTLER BREAKS 12 24 27 001H,2018-04-01,51,707,0,5673,137367,1220573,521272
300154177500,30-015-41775,RUSTLER BREAKS 12 24 27 001H,2018-05-01,52,645,7715,5417,138012,1228288,526689
300154177500,30-015-41775,RUSTLER BREAKS 12 24 27 001H,2018-06-01,53,378,0,4391,138390,1228288,531080
300154177500,30-015-41775,RUSTLER BREAKS 12 24 27 001H,2018-07-01,54,214,1658,1817,138604,1229946,532897
300154177500,30-015-41775,RUSTLER BREAKS 12 24 27 001H,2018-08-01,55,474,0,2912,139078,1229946,535809
300154177500,30-015-41775,RUSTLER BREAKS 12 24 27 001H,2018-09-01,56,648,5365,6862,139726,1235311,542671
300154177500,30-015-41775,RUSTLER BREAKS 12 24 27 001H,2018-10-01,57,688,4039,5611,140414,1239350,548282
300154177500,30-015-41775,RUSTLER BREAKS 12 24 27 001H,2018-11-01,58,703,3377,5794,141117,1242727,554076
300154177500,30-015-41775,RUSTLER BREAKS 12 24 27 001H,2018-12-01,59,709,1887,5727,141826,1244614,559803
300154177500,30-015-41775,RUSTLER BREAKS 12 24 27 001H,2019-01-01,60,709,3821,5608,142535,1248435,565411
300154177500,30-015-41775,RUSTLER BREAKS 12 24 27 001H,2019-02-01,61,571,3269,4906,143106,1251704,570317
300154177500,30-015-41775,RUSTLER BREAKS 12 24 27 001H,2019-03-01,62,526,6159,5099,143632,1257863,575416
300154177500,30-015-41775,RUSTLER BREAKS 12 24 27 001H,2019-04-01,63,516,10905,4026,144148,1268768,579442
300154177500,30-015-41775,RUSTLER BREAKS 12 24 27 001H,2019-05-01,64,465,6617,4467,144613,1275385,583909
300154177500,30-015-41775,RUSTLER BREAKS 12 24 27 001H,2019-06-01,65,470,6263,4018,145083,1281648,587927
300154177500,30-015-41775,RUSTLER BREAKS 12 24 27 001H,2019-07-01,66,341,6547,3473,145424,1288195,591400
300154177500,30-015-41775,RUSTLER BREAKS 12 24 27 001H,2019-08-01,67,562,7274,4039,145986,1295469,595439
300154177500,30-015-41775,RUSTLER BREAKS 12 24 27 001H,2019-09-01,68,548,6810,3567,146534,1302279,599006
300154177500,30-015-41775,RUSTLER BREAKS 12 24 27 001H,2019-10-01,69,550,6348,3318,147084,1308627,602324
300154177500,30-015-41775,RUSTLER BREAKS 12 24 27 001H,2019-11-01,70,572,6770,3620,147656,1315397,605944
300154177500,30-015-41775,RUSTLER BREAKS 12 24 27 001H,2019-12-01,71,558,1740,3084,148214,1317137,609028
300154177500,30-015-41775,RUSTLER BREAKS 12 24 27 001H,2020-01-01,72,549,4557,3611,148763,1321694,612639
300154177500,30-015-41775,RUSTLER BREAKS 12 24 27 001H,2020-02-01,73,503,7902,3590,149266,1329596,616229
300154177500,30-015-41775,RUSTLER BREAKS 12 24 27 001H,2020-03-01,74,557,8305,3976,149823,1337901,620205
300154177500,30-015-41775,RUSTLER BREAKS 12 24 27 001H,2020-04-01,75,520,7333,4071,150343,1345234,624276
300154177500,30-015-41775,RUSTLER BREAKS 12 24 27 001H,2020-05-01,76,41,1685,247,150384,1346919,624523
300154177500,30-015-41775,RUSTLER BREAKS 12 24 27 001H,2020-06-01,77,571,8214,5425,150955,1355133,629948
300154177500,30-015-41775,RUSTLER BREAKS 12 24 27 001H,2020-07-01,78,429,6612,4104,151384,1361745,634052
300154177500,30-015-41775,RUSTLER BREAKS 12 24 27 001H,2020-08-01,79,403,6936,3707,151787,1368681,637759
300154177500,30-015-41775,RUSTLER BREAKS 12 24 27 001H,2020-09-01,80,415,4923,3426,152202,1373604,641185
300154177500,30-015-41775,RUSTLER BREAKS 12 24 27 001H,2020-10-01,81,463,6951,3052,152665,1380555,644237
300154177500,30-015-41775,RUSTLER BREAKS 12 24 27 001H,2020-11-01,82,427,5518,2340,153092,1386073,646577
300154177500,30-015-41775,RUSTLER BREAKS 12 24 27 001H,2020-12-01,83,435,6800,2755,153527,1392873,649332
300154177500,30-015-41775,RUSTLER BREAKS 12 24 27 001H,2021-01-01,84,384,6574,2668,153911,1399447,652000
300154177500,30-015-41775,RUSTLER BREAKS 12 24 27 001H,2021-02-01,85,262,4944,1976,154173,1404391,653976
300154177500,30-015-41775,RUSTLER BREAKS 12 24 27 001H,2021-03-01,86,365,6889,2954,154538,1411280,656930
300154177500,30-015-41775,RUSTLER BREAKS 12 24 27 001H,2021-04-01,87,343,6651,2551,154881,1417931,659481
300154177500,30-015-41775,RUSTLER BREAKS 12 24 27 001H,2021-05-01,88,373,7122,2453,155254,1425053,661934
300154177500,30-015-41775,RUSTLER BREAKS 12 24 27 001H,2021-06-01,89,328,6526,2310,155582,1431579,664244
300154177500,30-015-41775,RUSTLER BREAKS 12 24 27 001H,2021-07-01,90,332,5919,2220,155914,1437498,666464
300154177500,30-015-41775,RUSTLER BREAKS 12 24 27 001H,2021-08-01,91,384,6259,2445,156298,1443757,668909
300154177500,30-015-41775,RUSTLER BREAKS 12 24 27 001H,2021-09-01,92,364,6754,2365,156662,1450511,671274
300154177500,30-015-41775,RUSTLER BREAKS 12 24 27 001H,2021-10-01,93,314,5981,1696,156976,1456492,672970
300154177500,30-015-41775,RUSTLER BREAKS 12 24 27 001H,2021-11-01,94,331,6373,2155,157307,1462865,675125
300154177500,30-015-41775,RUSTLER BREAKS 12 24 27 001H,2021-12-01,95,324,6687,1896,157631,1469552,677021
300154177500,30-015-41775,RUSTLER BREAKS 12 24 27 001H,2022-01-01,96,317,4617,1530,157948,1474169,678551
300154177500,30-015-41775,RUSTLER BREAKS 12 24 27 001H,2022-02-01,97,351,4636,1732,158299,1478805,680283
300154177500,30-015-41775,RUSTLER BREAKS 12 24 27 001H,2022-03-01,98,393,4845,1752,158692,1483650,682035
300154177500,30-015-41775,RUSTLER BREAKS 12 24 27 001H,2022-04-01,99,373,4915,2133,159065,1488565,684168
300154177500,30-015-41775,RUSTLER BREAKS 12 24 27 001H,2022-05-01,100,347,5321,2513,159412,1493886,686681
300154177500,30-015-41775,RUSTLER BREAKS 12 24 27 001H,2022-06-01,101,321,4874,2228,159733,1498760,688909
300154177500,30-015-41775,RUSTLER BREAKS 12 24 27 001H,2022-07-01,102,302,4984,1967,160035,1503744,690876
300154177500,30-015-41775,RUSTLER BREAKS 12 24 27 001H,2022-08-01,103,329,5653,1690,160364,1509397,692566
300154177500,30-015-41775,RUSTLER BREAKS 12 24 27 001H,2022-09-01,104,315,5194,1978,160679,1514591,694544
300154177500,30-015-41775,RUSTLER BREAKS 12 24 27 001H,2022-10-01,105,308,5447,1880,160987,1520038,696424
300154177500,30-015-41775,RUSTLER BREAKS 12 24 27 001H,2022-11-01,106,313,4914,1894,161300,1524952,698318
300154177500,30-015-41775,RUSTLER BREAKS 12 24 27 001H,2022-12-01,107,274,4938,1778,161574,1529890,700096
300154177500,30-015-41775,RUSTLER BREAKS 12 24 27 001H,2023-01-01,108,304,5071,2367,161878,1534961,702463
300154177500,30-015-41775,RUSTLER BREAKS 12 24 27 001H,2023-02-01,109,96,1664,376,161974,1536625,702839
300154177500,30-015-41775,RUSTLER BREAKS 12 24 27 001H,2023-03-01,110,249,4684,1730,162223,1541309,704569
300154177500,30-015-41775,RUSTLER BREAKS 12 24 27 001H,2023-04-01,111,247,4150,2057,162470,1545459,706626
300154177500,30-015-41775,RUSTLER BREAKS 12 24 27 001H,2023-05-01,112,251,4213,2386,162721,1549672,709012
300154177500,30-015-41775,RUSTLER BREAKS 12 24 27 001H,2023-06-01,113,110,2109,376,162831,1551781,709388
300153265000,30-015-32650,WEST LOVING 2 STATE 001,2003-05-01,1,0,24075,41,0,24075,41
300153265000,30-015-32650,WEST LOVING 2 STATE 001,2003-06-01,2,0,28552,39,0,52627,80
300153265000,30-015-32650,WEST LOVING 2 STATE 001,2003-07-01,3,0,32923,42,0,85550,122
300153265000,30-015-32650,WEST LOVING 2 STATE 001,2003-08-01,4,0,31594,27,0,117144,149
300153265000,30-015-32650,WEST LOVING 2 STATE 001,2003-09-01,5,0,28872,0,0,146016,149
300153265000,30-015-32650,WEST LOVING 2 STATE 001,2003-10-01,6,0,26127,0,0,172143,149
300153265000,30-015-32650,WEST LOVING 2 STATE 001,2003-11-01,7,0,26645,34,0,198788,183
300153265000,30-015-32650,WEST LOVING 2 STATE 001,2003-12-01,8,0,26116,55,0,224904,238
300153265000,30-015-32650,WEST LOVING 2 STATE 001,2004-01-01,9,0,25903,48,0,250807,286
300153265000,30-015-32650,WEST LOVING 2 STATE 001,2004-02-01,10,0,23341,53,0,274148,339
300153265000,30-015-32650,WEST LOVING 2 STATE 001,2004-03-01,11,0,23969,50,0,298117,389
300153265000,30-015-32650,WEST LOVING 2 STATE 001,2004-04-01,12,0,21699,18,0,319816,407
300153265000,30-015-32650,WEST LOVING 2 STATE 001,2004-05-01,13,0,20871,14,0,340687,421
300153265000,30-015-32650,WEST LOVING 2 STATE 001,2004-06-01,14,0,17782,13,0,358469,434
300153265000,30-015-32650,WEST LOVING 2 STATE 001,2004-07-01,15,0,15823,14,0,374292,448
300153265000,30-015-32650,WEST LOVING 2 STATE 001,2004-08-01,16,0,18065,12,0,392357,460
300153265000,30-015-32650,WEST LOVING 2 STATE 001,2004-09-01,17,0,17565,16,0,409922,476
300153265000,30-015-32650,WEST LOVING 2 STATE 001,2004-10-01,18,0,15153,18,0,425075,494
300153265000,30-015-32650,WEST LOVING 2 STATE 001,2004-11-01,19,0,8029,7,0,433104,501
300153265000,30-015-32650,WEST LOVING 2 STATE 001,2004-12-01,20,0,8304,14,0,441408,515
300153265000,30-015-32650,WEST LOVING 2 STATE 001,2005-01-01,21,0,11850,71,0,453258,586
300153265000,30-015-32650,WEST LOVING 2 STATE 001,2005-02-01,22,0,13765,28,0,467023,614
300153265000,30-015-32650,WEST LOVING 2 STATE 001,2005-03-01,23,0,10950,45,0,477973,659
300153265000,30-015-32650,WEST LOVING 2 STATE 001,2005-04-01,24,0,9242,3,0,487215,662
300153265000,30-015-32650,WEST LOVING 2 STATE 001,2005-05-01,25,0,5655,19,0,492870,681
300153265000,30-015-32650,WEST LOVING 2 STATE 001,2005-06-01,26,0,14229,14,0,507099,695
300153265000,30-015-32650,WEST LOVING 2 STATE 001,2005-07-01,27,0,8767,45,0,515866,740
300153265000,30-015-32650,WEST LOVING 2 STATE 001,2005-08-01,28,0,11585,45,0,527451,785
300153265000,30-015-32650,WEST LOVING 2 STATE 001,2005-09-01,29,0,5729,3,0,533180,788
300153265000,30-015-32650,WEST LOVING 2 STATE 001,2005-10-01,30,0,7366,18,0,540546,806
300153265000,30-015-32650,WEST LOVING 2 STATE 001,2005-11-01,31,0,5245,7,0,545791,813
300153265000,30-015-32650,WEST LOVING 2 STATE 001,2005-12-01,32,0,760,1,0,546551,814
300153265000,30-015-32650,WEST LOVING 2 STATE 001,2006-01-01,33,0,4604,52,0,551155,866
300153265000,30-015-32650,WEST LOVING 2 STATE 001,2006-02-01,34,0,6332,52,0,557487,918
300153265000,30-015-32650,WEST LOVING 2 STATE 001,2006-03-01,35,0,9437,16,0,566924,934
300153265000,30-015-32650,WEST LOVING 2 STATE 001,2006-04-01,36,0,10317,86,0,577241,1020
300153265000,30-015-32650,WEST LOVING 2 STATE 001,2006-05-01,37,0,5670,8,0,582911,1028
300153265000,30-015-32650,WEST LOVING 2 STATE 001,2006-06-01,38,0,4592,17,0,587503,1045
300153265000,30-015-32650,WEST LOVING 2 STATE 001,2006-07-01,39,0,7612,51,0,595115,1096
300153265000,30-015-32650,WEST LOVING 2 STATE 001,2006-08-01,40,0,10768,64,0,605883,1160
300153265000,30-015-32650,WEST LOVING 2 STATE 001,2006-09-01,41,0,10161,45,0,616044,1205
300153265000,30-015-32650,WEST LOVING 2 STATE 001,2006-10-01,42,0,7810,47,0,623854,1252
300153265000,30-015-32650,WEST LOVING 2 STATE 001,2006-11-01,43,0,8384,9,0,632238,1261
300153265000,30-015-32650,WEST LOVING 2 STATE 001,2006-12-01,44,0,5322,13,0,637560,1274
300153265000,30-015-32650,WEST LOVING 2 STATE 001,2007-01-01,45,0,6381,138,0,643941,1412
300153265000,30-015-32650,WEST LOVING 2 STATE 001,2007-02-01,46,0,7072,80,0,651013,1492
300153265000,30-015-32650,WEST LOVING 2 STATE 001,2007-03-01,47,0,6876,18,0,657889,1510
300153265000,30-015-32650,WEST LOVING 2 STATE 001,2007-04-01,48,0,8234,0,0,666123,1510
300153265000,30-015-32650,WEST LOVING 2 STATE 001,2007-05-01,49,0,9758,5,0,675881,1515
300153265000,30-015-32650,WEST LOVING 2 STATE 001,2007-06-01,50,0,8333,0,0,684214,1515
300153265000,30-015-32650,WEST LOVING 2 STATE 001,2007-07-01,51,0,8899,126,0,693113,1641
300153265000,30-015-32650,WEST LOVING 2 STATE 001,2007-08-01,52,0,9611,80,0,702724,1721
300153265000,30-015-32650,WEST LOVING 2 STATE 001,2007-09-01,53,0,8091,33,0,710815,1754
300153265000,30-015-32650,WEST LOVING 2 STATE 001,2007-10-01,54,0,8218,6,0,719033,1760
300153265000,30-015-32650,WEST LOVING 2 STATE 001,2007-11-01,55,0,4300,59,0,723333,1819
300153265000,30-015-32650,WEST LOVING 2 STATE 001,2007-12-01,56,0,7593,18,0,730926,1837
300153265000,30-015-32650,WEST LOVING 2 STATE 001,2008-01-01,57,0,6749,54,0,737675,1891
300153265000,30-015-32650,WEST LOVING 2 STATE 001,2008-02-01,58,0,7593,12,0,745268,1903
300153265000,30-015-32650,WEST LOVING 2 STATE 001,2008-03-01,59,0,7676,3,0,752944,1906
300153265000,30-015-32650,WEST LOVING 2 STATE 001,2008-04-01,60,0,5631,66,0,758575,1972
300153265000,30-015-32650,WEST LOVING 2 STATE 001,2008-05-01,61,0,8416,69,0,766991,2041
300153265000,30-015-32650,WEST LOVING 2 STATE 001,2008-06-01,62,0,7138,51,0,774129,2092
300153265000,30-015-32650,WEST LOVING 2 STATE 001,2008-07-01,63,0,6906,22,0,781035,2114
300153265000,30-015-32650,WEST LOVING 2 STATE 001,2008-08-01,64,0,7546,18,0,788581,2132
300153265000,30-015-32650,WEST LOVING 2 STATE 001,2008-09-01,65,0,5472,9,0,794053,2141
300153265000,30-015-32650,WEST LOVING 2 STATE 001,2008-10-01,66,0,6680,7,0,800733,2148
300153265000,30-015-32650,WEST LOVING 2 STATE 001,2008-11-01,67,0,5228,6,0,805961,2154
300153265000,30-015-32650,WEST LOVING 2 STATE 001,2008-12-01,68,0,2658,0,0,808619,2154
300153265000,30-015-32650,WEST LOVING 2 STATE 001,2009-01-01,69,0,1744,71,0,810363,2225
300153265000,30-015-32650,WEST LOVING 2 STATE 001,2009-02-01,70,0,5642,0,0,816005,2225
300153265000,30-015-32650,WEST LOVING 2 STATE 001,2009-03-01,71,0,7540,3,0,823545,2228
300153265000,30-015-32650,WEST LOVING 2 STATE 001,2009-04-01,72,0,8824,0,0,832369,2228
300153265000,30-015-32650,WEST LOVING 2 STATE 001,2009-05-01,73,0,6031,0,0,838400,2228
300153265000,30-015-32650,WEST LOVING 2 STATE 001,2009-06-01,74,0,7215,0,0,845615,2228
300153265000,30-015-32650,WEST LOVING 2 STATE 001,2009-07-01,75,0,7598,0,0,853213,2228
300153265000,30-015-32650,WEST LOVING 2 STATE 001,2009-08-01,76,0,7920,0,0,861133,2228
300153265000,30-015-32650,WEST LOVING 2 STATE 001,2009-09-01,77,0,7783,28,0,868916,2256
300153265000,30-015-32650,WEST LOVING 2 STATE 001,2009-10-01,78,0,8117,21,0,877033,2277
300153265000,30-015-32650,WEST LOVING 2 STATE 001,2009-11-01,79,0,7062,34,0,884095,2311
300153265000,30-015-32650,WEST LOVING 2 STATE 001,2009-12-01,80,0,4463,18,0,888558,2329
300153265000,30-015-32650,WEST LOVING 2 STATE 001,2010-01-01,81,0,1880,3,0,890438,2332
300153265000,30-015-32650,WEST LOVING 2 STATE 001,2010-02-01,82,0,5797,42,0,896235,2374
300153265000,30-015-32650,WEST LOVING 2 STATE 001,2010-03-01,83,0,5945,18,0,902180,2392
300153265000,30-015-32650,WEST LOVING 2 STATE 001,2010-04-01,84,0,5367,16,0,907547,2408
300153265000,30-015-32650,WEST LOVING 2 STATE 001,2010-05-01,85,0,5875,29,0,913422,2437
300153265000,30-015-32650,WEST LOVING 2 STATE 001,2010-06-01,86,0,6403,23,0,919825,2460
300153265000,30-015-32650,WEST LOVING 2 STATE 001,2010-07-01,87,0,8419,8,0,928244,2468
300153265000,30-015-32650,WEST LOVING 2 STATE 001,2010-08-01,88,0,9291,16,0,937535,2484
300153265000,30-015-32650,WEST LOVING 2 STATE 001,2010-09-01,89,0,7453,73,0,944988,2557
300153265000,30-015-32650,WEST LOVING 2 STATE 001,2010-10-01,90,0,8596,44,0,953584,2601
300153265000,30-015-32650,WEST LOVING 2 STATE 001,2010-11-01,91,0,8946,21,0,962530,2622
300153265000,30-015-32650,WEST LOVING 2 STATE 001,2010-12-01,92,0,9418,10,0,971948,2632
300153265000,30-015-32650,WEST LOVING 2 STATE 001,2011-01-01,93,0,6347,70,0,978295,2702
300153265000,30-015-32650,WEST LOVING 2 STATE 001,2011-02-01,94,0,5262,3,0,983557,2705
300153265000,30-015-32650,WEST LOVING 2 STATE 001,2011-03-01,95,0,9999,68,0,993556,2773
300153265000,30-015-32650,WEST LOVING 2 STATE 001,2011-04-01,96,0,7884,39,0,1001440,2812
300153265000,30-015-32650,WEST LOVING 2 STATE 001,2011-05-01,97,0,4054,5,0,1005494,2817
300153265000,30-015-32650,WEST LOVING 2 STATE 001,2011-06-01,98,0,2713,0,0,1008207,2817
300153265000,30-015-32650,WEST LOVING 2 STATE 001,2011-07-01,99,0,490,0,0,1008697,2817
300153265000,30-015-32650,WEST LOVING 2 STATE 001,2011-08-01,100,0,3357,34,0,1012054,2851
300153265000,30-015-32650,WEST LOVING 2 STATE 001,2011-09-01,101,0,8799,23,0,1020853,2874
300153265000,30-015-32650,WEST LOVING 2 STATE 001,2011-10-01,102,0,10035,55,0,1030888,2929
300153265000,30-015-32650,WEST LOVING 2 STATE 001,2011-11-01,103,0,5240,21,0,1036128,2950
300153265000,30-015-32650,WEST LOVING 2 STATE 001,2011-12-01,104,0,3588,13,0,1039716,2963
300153265000,30-015-32650,WEST LOVING 2 STATE 001,2012-01-01,105,0,5255,18,0,1044971,2981
300153265000,30-015-32650,WEST LOVING 2 STATE 001,2012-02-01,106,0,5030,10,0,1050001,2991
300153265000,30-015-32650,WEST LOVING 2 STATE 001,2012-03-01,107,0,3343,18,0,1053344,3009
300153265000,30-015-32650,WEST LOVING 2 STATE 001,2012-04-01,108,0,5017,18,0,1058361,3027
300153265000,30-015-32650,WEST LOVING 2 STATE 001,2012-05-01,109,0,3175,16,0,1061536,3043
300153265000,30-015-32650,WEST LOVING 2 STATE 001,2012-06-01,110,0,5235,13,0,1066771,3056
300153265000,30-015-32650,WEST LOVING 2 STATE 001,2012-07-01,111,0,5590,26,0,1072361,3082
300153265000,30-015-32650,WEST LOVING 2 STATE 001,2012-08-01,112,0,6405,16,0,1078766,3098
300153265000,30-015-32650,WEST LOVING 2 STATE 001,2012-09-01,113,0,6687,23,0,1085453,3121
300153265000,30-015-32650,WEST LOVING 2 STATE 001,2012-10-01,114,0,4087,13,0,1089540,3134
300153265000,30-015-32650,WEST LOVING 2 STATE 001,2012-11-01,115,0,7338,39,0,1096878,3173
300153265000,30-015-32650,WEST LOVING 2 STATE 001,2012-12-01,116,0,7160,52,0,1104038,3225
300153265000,30-015-32650,WEST LOVING 2 STATE 001,2013-01-01,117,0,7821,36,0,1111859,3261
300153265000,30-015-32650,WEST LOVING 2 STATE 001,2013-02-01,118,0,7191,34,0,1119050,3295
300153265000,30-015-32650,WEST LOVING 2 STATE 001,2013-03-01,119,0,7760,16,0,1126810,3311
300153265000,30-015-32650,WEST LOVING 2 STATE 001,2013-04-01,120,0,6942,55,0,1133752,3366
300153265000,30-015-32650,WEST LOVING 2 STATE 001,2013-05-01,121,0,4547,34,0,1138299,3400
300153265000,30-015-32650,WEST LOVING 2 STATE 001,2013-06-01,122,0,5817,21,0,1144116,3421
300153265000,30-015-32650,WEST LOVING 2 STATE 001,2013-07-01,123,0,4306,21,0,1148422,3442
300153265000,30-015-32650,WEST LOVING 2 STATE 001,2013-08-01,124,0,3372,16,0,1151794,3458
300153265000,30-015-32650,WEST LOVING 2 STATE 001,2013-09-01,125,0,5316,42,0,1157110,3500
300153265000,30-015-32650,WEST LOVING 2 STATE 001,2013-10-01,126,0,1305,0,0,1158415,3500
300153265000,30-015-32650,WEST LOVING 2 STATE 001,2013-11-01,127,0,3614,39,0,1162029,3539
300153265000,30-015-32650,WEST LOVING 2 STATE 001,2013-12-01,128,0,2948,0,0,1164977,3539
300153265000,30-015-32650,WEST LOVING 2 STATE 001,2014-01-01,129,0,3970,49,0,1168947,3588
300153265000,30-015-32650,WEST LOVING 2 STATE 001,2014-02-01,130,0,455,0,0,1169402,3588
300153265000,30-015-32650,WEST LOVING 2 STATE 001,2014-03-01,131,0,7302,18,0,1176704,3606
300153265000,30-015-32650,WEST LOVING 2 STATE 001,2014-04-01,132,0,6546,18,0,1183250,3624
300153265000,30-015-32650,WEST LOVING 2 STATE 001,2014-05-01,133,0,4820,5,0,1188070,3629
300153265000,30-015-32650,WEST LOVING 2 STATE 001,2014-06-01,134,0,6403,55,0,1194473,3684
300153265000,30-015-32650,WEST LOVING 2 STATE 001,2014-07-01,135,0,5196,29,0,1199669,3713
300153265000,30-015-32650,WEST LOVING 2 STATE 001,2014-08-01,136,0,4835,23,0,1204504,3736
300153265000,30-015-32650,WEST LOVING 2 STATE 001,2014-09-01,137,0,1120,0,0,1205624,3736
300153265000,30-015-32650,WEST LOVING 2 STATE 001,2014-10-01,138,0,4523,39,0,1210147,3775
300153265000,30-015-32650,WEST LOVING 2 STATE 001,2014-11-01,139,0,2955,0,0,1213102,3775
300153265000,30-015-32650,WEST LOVING 2 STATE 001,2014-12-01,140,0,5291,0,0,1218393,3775
300153265000,30-015-32650,WEST LOVING 2 STATE 001,2015-01-01,141,0,19,0,0,1218412,3775
300153265000,30-015-32650,WEST LOVING 2 STATE 001,2015-02-01,142,0,1611,10,0,1220023,3785
300153265000,30-015-32650,WEST LOVING 2 STATE 001,2015-03-01,143,0,5623,60,0,1225646,3845
300153265000,30-015-32650,WEST LOVING 2 STATE 001,2015-04-01,144,0,124,2,0,1225770,3847
300153265000,30-015-32650,WEST LOVING 2 STATE 001,2015-05-01,145,0,5894,23,0,1231664,3870
300153265000,30-015-32650,WEST LOVING 2 STATE 001,2015-06-01,146,0,4075,26,0,1235739,3896
300153265000,30-015-32650,WEST LOVING 2 STATE 001,2015-07-01,147,0,3319,5,0,1239058,3901
300153265000,30-015-32650,WEST LOVING 2 STATE 001,2015-08-01,148,0,5107,38,0,1244165,3939
300153265000,30-015-32650,WEST LOVING 2 STATE 001,2015-09-01,149,0,5015,21,0,1249180,3960
300153265000,30-015-32650,WEST LOVING 2 STATE 001,2015-10-01,150,0,2854,10,0,1252034,3970
300153265000,30-015-32650,WEST LOVING 2 STATE 001,2015-11-01,151,0,2079,16,0,1254113,3986
300153265000,30-015-32650,WEST LOVING 2 STATE 001,2015-12-01,152,0,1700,13,0,1255813,3999
300153265000,30-015-32650,WEST LOVING 2 STATE 001,2016-01-01,153,0,584,5,0,1256397,4004
300153265000,30-015-32650,WEST LOVING 2 STATE 001,2016-02-01,154,0,72,3,0,1256469,4007
300153265000,30-015-32650,WEST LOVING 2 STATE 001,2016-03-01,155,0,4341,5,0,1260810,4012
300153265000,30-015-32650,WEST LOVING 2 STATE 001,2016-04-01,156,0,4409,32,0,1265219,4044
300153265000,30-015-32650,WEST LOVING 2 STATE 001,2016-05-01,157,0,4431,10,0,1269650,4054
300153265000,30-015-32650,WEST LOVING 2 STATE 001,2016-06-01,158,0,5144,16,0,1274794,4070
300153265000,30-015-32650,WEST LOVING 2 STATE 001,2016-07-01,159,0,5455,13,0,1280249,4083
300153265000,30-015-32650,WEST LOVING 2 STATE 001,2016-08-01,160,0,5700,16,0,1285949,4099
300153265000,30-015-32650,WEST LOVING 2 STATE 001,2016-09-01,161,0,4177,12,0,1290126,4111
300153265000,30-015-32650,WEST LOVING 2 STATE 001,2016-10-01,162,0,4750,10,0,1294876,4121
300153265000,30-015-32650,WEST LOVING 2 STATE 001,2016-11-01,163,0,4913,13,0,1299789,4134
300153265000,30-015-32650,WEST LOVING 2 STATE 001,2016-12-01,164,0,4436,16,0,1304225,4150
300153265000,30-015-32650,WEST LOVING 2 STATE 001,2017-01-01,165,0,4372,8,0,1308597,4158
300153265000,30-015-32650,WEST LOVING 2 STATE 001,2017-02-01,166,0,4321,0,0,1312918,4158
300153265000,30-015-32650,WEST LOVING 2 STATE 001,2017-03-01,167,0,4199,3,0,1317117,4161
300153265000,30-015-32650,WEST LOVING 2 STATE 001,2017-04-01,168,0,4646,5,0,1321763,4166
300153265000,30-015-32650,WEST LOVING 2 STATE 001,2017-05-01,169,0,4269,0,0,1326032,4166
300153265000,30-015-32650,WEST LOVING 2 STATE 001,2017-06-01,170,0,4763,16,0,1330795,4182
300153265000,30-015-32650,WEST LOVING 2 STATE 001,2017-07-01,171,0,4975,8,0,1335770,4190
300153265000,30-015-32650,WEST LOVING 2 STATE 001,2017-08-01,172,0,4895,0,0,1340665,4190
300153265000,30-015-32650,WEST LOVING 2 STATE 001,2017-09-01,173,0,4713,0,0,1345378,4190
300153265000,30-015-32650,WEST LOVING 2 STATE 001,2017-10-01,174,0,5108,0,0,1350486,4190
300153265000,30-015-32650,WEST LOVING 2 STATE 001,2017-11-01,175,0,4786,0,0,1355272,4190
300153265000,30-015-32650,WEST LOVING 2 STATE 001,2017-12-01,176,0,3935,0,0,1359207,4190
300153265000,30-015-32650,WEST LOVING 2 STATE 001,2018-01-01,177,0,5124,0,0,1364331,4190
300153265000,30-015-32650,WEST LOVING 2 STATE 001,2018-02-01,178,0,3694,0,0,1368025,4190
300153265000,30-015-32650,WEST LOVING 2 STATE 001,2018-03-01,179,0,3545,0,0,1371570,4190
300153265000,30-015-32650,WEST LOVING 2 STATE 001,2018-04-01,180,0,2038,0,0,1373608,4190
300153265000,30-015-32650,WEST LOVING 2 STATE 001,2018-05-01,181,0,5268,0,0,1378876,4190
300153265000,30-015-32650,WEST LOVING 2 STATE 001,2018-06-01,182,0,3313,0,0,1382189,4190
300153265000,30-015-32650,WEST LOVING 2 STATE 001,2018-07-01,183,0,3438,0,0,1385627,4190
300153265000,30-015-32650,WEST LOVING 2 STATE 001,2018-08-01,184,0,2631,0,0,1388258,4190
300153265000,30-015-32650,WEST LOVING 2 STATE 001,2018-09-01,185,0,2234,0,0,1390492,4190
300153265000,30-015-32650,WEST LOVING 2 STATE 001,2018-10-01,186,0,2863,0,0,1393355,4190
300153265000,30-015-32650,WEST LOVING 2 STATE 001,2018-11-01,187,0,4291,0,0,1397646,4190
300153265000,30-015-32650,WEST LOVING 2 STATE 001,2018-12-01,188,0,4002,0,0,1401648,4190
300153265000,30-015-32650,WEST LOVING 2 STATE 001,2019-01-01,189,0,3772,0,0,1405420,4190
300153265000,30-015-32650,WEST LOVING 2 STATE 001,2019-02-01,190,0,4322,0,0,1409742,4190
300153265000,30-015-32650,WEST LOVING 2 STATE 001,2019-03-01,191,0,3140,0,0,1412882,4190
300153265000,30-015-32650,WEST LOVING 2 STATE 001,2019-04-01,192,0,207,0,0,1413089,4190
300153265000,30-015-32650,WEST LOVING 2 STATE 001,2019-05-01,193,0,22,0,0,1413111,4190
300153265000,30-015-32650,WEST LOVING 2 STATE 001,2019-06-01,194,0,677,0,0,1413788,4190
300153265000,30-015-32650,WEST LOVING 2 STATE 001,2019-07-01,195,0,11,0,0,1413799,4190
300153265000,30-015-32650,WEST LOVING 2 STATE 001,2019-08-01,196,0,304,0,0,1414103,4190
300153265000,30-015-32650,WEST LOVING 2 STATE 001,2019-09-01,197,0,1770,0,0,1415873,4190
300153265000,30-015-32650,WEST LOVING 2 STATE 001,2019-10-01,198,0,1067,0,0,1416940,4190
300153265000,30-015-32650,WEST LOVING 2 STATE 001,2019-11-01,199,0,300,0,0,1417240,4190
300153265000,30-015-32650,WEST LOVING 2 STATE 001,2019-12-01,200,0,580,0,0,1417820,4190
300153265000,30-015-32650,WEST LOVING 2 STATE 001,2020-01-01,201,0,337,0,0,1418157,4190
300153265000,30-015-32650,WEST LOVING 2 STATE 001,2020-02-01,202,0,500,0,0,1418657,4190
300153265000,30-015-32650,WEST LOVING 2 STATE 001,2020-03-01,203,0,50,0,0,1418707,4190
300153265000,30-015-32650,WEST LOVING 2 STATE 001,2020-04-01,204,0,126,0,0,1418833,4190
300153265000,30-015-32650,WEST LOVING 2 STATE 001,2020-05-01,205,0,1568,0,0,1420401,4190
300153265000,30-015-32650,WEST LOVING 2 STATE 001,2020-06-01,206,0,3274,0,0,1423675,4190
300153265000,30-015-32650,WEST LOVING 2 STATE 001,2020-07-01,207,0,3229,3,0,1426904,4193
300153265000,30-015-32650,WEST LOVING 2 STATE 001,2020-08-01,208,0,1114,0,0,1428018,4193
300153265000,30-015-32650,WEST LOVING 2 STATE 001,2020-09-01,209,0,5710,0,0,1433728,4193
300153265000,30-015-32650,WEST LOVING 2 STATE 001,2020-10-01,210,0,4157,0,0,1437885,4193
300153265000,30-015-32650,WEST LOVING 2 STATE 001,2020-11-01,211,0,1859,0,0,1439744,4193
300153265000,30-015-32650,WEST LOVING 2 STATE 001,2020-12-01,212,0,1039,23,0,1440783,4216
300153265000,30-015-32650,WEST LOVING 2 STATE 001,2021-01-01,213,0,1401,5,0,1442184,4221
300153265000,30-015-32650,WEST LOVING 2 STATE 001,2021-02-01,214,0,2315,3,0,1444499,4224
300153265000,30-015-32650,WEST LOVING 2 STATE 001,2021-03-01,215,0,8497,18,0,1452996,4242
300153265000,30-015-32650,WEST LOVING 2 STATE 001,2021-04-01,216,0,10068,16,0,1463064,4258
300153265000,30-015-32650,WEST LOVING 2 STATE 001,2021-05-01,217,0,9055,0,0,1472119,4258
300153265000,30-015-32650,WEST LOVING 2 STATE 001,2021-06-01,218,0,6848,5,0,1478967,4263
300153265000,30-015-32650,WEST LOVING 2 STATE 001,2021-07-01,219,0,7164,8,0,1486131,4271
300153265000,30-015-32650,WEST LOVING 2 STATE 001,2021-08-01,220,0,7002,8,0,1493133,4279
300153265000,30-015-32650,WEST LOVING 2 STATE 001,2021-09-01,221,0,9065,16,0,1502198,4295
300153265000,30-015-32650,WEST LOVING 2 STATE 001,2021-10-01,222,0,10357,26,0,1512555,4321
300153265000,30-015-32650,WEST LOVING 2 STATE 001,2021-11-01,223,0,9952,16,0,1522507,4337
300153265000,30-015-32650,WEST LOVING 2 STATE 001,2021-12-01,224,0,445,3,0,1522952,4340
300153265000,30-015-32650,WEST LOVING 2 STATE 001,2022-01-01,225,0,8555,21,0,1531507,4361
300153265000,30-015-32650,WEST LOVING 2 STATE 001,2022-02-01,226,0,7066,16,0,1538573,4377
300153265000,30-015-32650,WEST LOVING 2 STATE 001,2022-03-01,227,0,8835,21,0,1547408,4398
300153265000,30-015-32650,WEST LOVING 2 STATE 001,2022-04-01,228,0,8087,21,0,1555495,4419
300153265000,30-015-32650,WEST LOVING 2 STATE 001,2022-05-01,229,0,6041,13,0,1561536,4432
300153265000,30-015-32650,WEST LOVING 2 STATE 001,2022-06-01,230,0,4491,18,0,1566027,4450
300153265000,30-015-32650,WEST LOVING 2 STATE 001,2022-07-01,231,0,5110,0,0,1571137,4450
300153265000,30-015-32650,WEST LOVING 2 STATE 001,2022-08-01,232,0,25,0,0,1571162,4450
300153265000,30-015-32650,WEST LOVING 2 STATE 001,2022-09-01,233,0,2911,8,0,1574073,4458
300153265000,30-015-32650,WEST LOVING 2 STATE 001,2022-10-01,234,0,5068,8,0,1579141,4466
300153265000,30-015-32650,WEST LOVING 2 STATE 001,2022-11-01,235,0,5719,10,0,1584860,4476
300153265000,30-015-32650,WEST LOVING 2 STATE 001,2022-12-01,236,0,4979,8,0,1589839,4484
300153265000,30-015-32650,WEST LOVING 2 STATE 001,2023-01-01,237,0,2150,0,0,1591989,4484
300153265000,30-015-32650,WEST LOVING 2 STATE 001,2023-02-01,238,0,1343,0,0,1593332,4484
300153265000,30-015-32650,WEST LOVING 2 STATE 001,2023-03-01,239,0,1614,0,0,1594946,4484
300153265000,30-015-32650,WEST LOVING 2 STATE 001,2023-04-01,240,0,682,0,0,1595628,4484
300153265000,30-015-32650,WEST LOVING 2 STATE 001,2023-05-01,241,0,227,0,0,1595855,4484
300153265000,30-015-32650,WEST LOVING 2 STATE 001,2023-06-01,242,0,1181,5,0,1597036,4489
300153265000,30-015-32650,WEST LOVING 2 STATE 001,2023-07-01,243,0,1272,18,0,1598308,4507
300153244600,30-015-32446,LOVING 1 STATE 003,2003-02-01,1,0,235303,365,0,235303,365
300153244600,30-015-32446,LOVING 1 STATE 003,2003-03-01,2,0,212122,385,0,447425,750
300153244600,30-015-32446,LOVING 1 STATE 003,2003-04-01,3,62,166339,445,62,613764,1195
300153244600,30-015-32446,LOVING 1 STATE 003,2003-05-01,4,17,150785,0,79,764549,1195
300153244600,30-015-32446,LOVING 1 STATE 003,2003-06-01,5,13,128436,0,92,892985,1195
300153244600,30-015-32446,LOVING 1 STATE 003,2003-07-01,6,15,112901,0,107,1005886,1195
300153244600,30-015-32446,LOVING 1 STATE 003,2003-08-01,7,13,92186,0,120,1098072,1195
300153244600,30-015-32446,LOVING 1 STATE 003,2003-09-01,8,4,53373,0,124,1151445,1195
300153244600,30-015-32446,LOVING 1 STATE 003,2003-10-01,9,5,53238,0,129,1204683,1195
300153244600,30-015-32446,LOVING 1 STATE 003,2003-11-01,10,0,51698,0,129,1256381,1195
300153244600,30-015-32446,LOVING 1 STATE 003,2003-12-01,11,0,50473,0,129,1306854,1195
300153244600,30-015-32446,LOVING 1 STATE 003,2004-01-01,12,54,49371,0,183,1356225,1195
300153244600,30-015-32446,LOVING 1 STATE 003,2004-02-01,13,0,43340,0,183,1399565,1195
300153244600,30-015-32446,LOVING 1 STATE 003,2004-03-01,14,5,46804,195,188,1446369,1390
300153244600,30-015-32446,LOVING 1 STATE 003,2004-04-01,15,7,42857,162,195,1489226,1552
300153244600,30-015-32446,LOVING 1 STATE 003,2004-05-01,16,8,42250,163,203,1531476,1715
300153244600,30-015-32446,LOVING 1 STATE 003,2004-06-01,17,5,38346,156,208,1569822,1871
300153244600,30-015-32446,LOVING 1 STATE 003,2004-07-01,18,4,37469,171,212,1607291,2042
300153244600,30-015-32446,LOVING 1 STATE 003,2004-08-01,19,6,37021,211,218,1644312,2253
300153244600,30-015-32446,LOVING 1 STATE 003,2004-09-01,20,7,27335,454,225,1671647,2707
300153244600,30-015-32446,LOVING 1 STATE 003,2004-10-01,1,2,33937,965,227,1705584,3672
300153244600,30-015-32446,LOVING 1 STATE 003,2004-11-01,2,0,31295,978,227,1736879,4650
300153244600,30-015-32446,LOVING 1 STATE 003,2004-12-01,3,0,30965,994,227,1767844,5644
300153244600,30-015-32446,LOVING 1 STATE 003,2005-01-01,4,0,31234,1046,227,1799078,6690
300153244600,30-015-32446,LOVING 1 STATE 003,2005-02-01,5,3,27114,926,230,1826192,7616
300153244600,30-015-32446,LOVING 1 STATE 003,2005-03-01,6,5,29419,1020,235,1855611,8636
300153244600,30-015-32446,LOVING 1 STATE 003,2005-04-01,7,0,26564,1109,235,1882175,9745
300153244600,30-015-32446,LOVING 1 STATE 003,2005-05-01,8,10,27001,1003,245,1909176,10748
300153244600,30-015-32446,LOVING 1 STATE 003,2005-06-01,9,5,18339,857,250,1927515,11605
300153244600,30-015-32446,LOVING 1 STATE 003,2005-07-01,10,0,27791,866,250,1955306,12471
300153244600,30-015-32446,LOVING 1 STATE 003,2005-08-01,11,0,28103,932,250,1983409,13403
300153244600,30-015-32446,LOVING 1 STATE 003,2005-09-01,12,0,25596,963,250,2009005,14366
300153244600,30-015-32446,LOVING 1 STATE 003,2005-10-01,13,0,24620,895,250,2033625,15261
300153244600,30-015-32446,LOVING 1 STATE 003,2005-11-01,14,0,24331,896,250,2057956,16157
300153244600,30-015-32446,LOVING 1 STATE 003,2005-12-01,15,0,26608,918,250,2084564,17075
300153244600,30-015-32446,LOVING 1 STATE 003,2006-01-01,16,0,26767,935,250,2111331,18010
300153244600,30-015-32446,LOVING 1 STATE 003,2006-02-01,17,0,18575,758,250,2129906,18768
300153244600,30-015-32446,LOVING 1 STATE 003,2006-03-01,18,0,22300,880,250,2152206,19648
300153244600,30-015-32446,LOVING 1 STATE 003,2006-04-01,19,0,22815,870,250,2175021,20518
300153244600,30-015-32446,LOVING 1 STATE 003,2006-05-01,20,0,19872,760,250,2194893,21278
300153244600,30-015-32446,LOVING 1 STATE 003,2006-06-01,21,0,18385,648,250,2213278,21926
300153244600,30-015-32446,LOVING 1 STATE 003,2006-07-01,22,64,22907,785,314,2236185,22711
300153244600,30-015-32446,LOVING 1 STATE 003,2006-08-01,23,55,22156,939,369,2258341,23650
300153244600,30-015-32446,LOVING 1 STATE 003,2006-09-01,24,0,19900,887,369,2278241,24537
300153244600,30-015-32446,LOVING 1 STATE 003,2006-10-01,25,0,14081,623,369,2292322,25160
300153244600,30-015-32446,LOVING 1 STATE 003,2006-11-01,26,0,19810,851,369,2312132,26011
300153244600,30-015-32446,LOVING 1 STATE 003,2006-12-01,27,0,17778,862,369,2329910,26873
300153244600,30-015-32446,LOVING 1 STATE 003,2007-01-01,28,0,17299,842,369,2347209,27715
300153244600,30-015-32446,LOVING 1 STATE 003,2007-02-01,29,11,18448,946,380,2365657,28661
300153244600,30-015-32446,LOVING 1 STATE 003,2007-03-01,30,27,19651,1029,407,2385308,29690
300153244600,30-015-32446,LOVING 1 STATE 003,2007-04-01,31,19,18163,988,426,2403471,30678
300153244600,30-015-32446,LOVING 1 STATE 003,2007-05-01,32,0,18473,1025,426,2421944,31703
300153244600,30-015-32446,LOVING 1 STATE 003,2007-06-01,33,0,10733,693,426,2432677,32396
300153244600,30-015-32446,LOVING 1 STATE 003,2007-07-01,34,0,10687,742,426,2443364,33138
300153244600,30-015-32446,LOVING 1 STATE 003,2007-08-01,35,0,11840,728,426,2455204,33866
300153244600,30-015-32446,LOVING 1 STATE 003,2007-09-01,36,0,16779,905,426,2471983,34771
300153244600,30-015-32446,LOVING 1 STATE 003,2007-10-01,37,0,9386,744,426,2481369,35515
300153244600,30-015-32446,LOVING 1 STATE 003,2007-11-01,38,0,12981,866,426,2494350,36381
300153244600,30-015-32446,LOVING 1 STATE 003,2007-12-01,39,0,12238,968,426,2506588,37349
300153244600,30-015-32446,LOVING 1 STATE 003,2008-01-01,40,0,15660,910,426,2522248,38259
300153244600,30-015-32446,LOVING 1 STATE 003,2008-02-01,41,0,11811,857,426,2534059,39116
300153244600,30-015-32446,LOVING 1 STATE 003,2008-03-01,42,0,13234,904,426,2547293,40020
300153244600,30-015-32446,LOVING 1 STATE 003,2008-04-01,43,0,11881,877,426,2559174,40897
300153244600,30-015-32446,LOVING 1 STATE 003,2008-05-01,44,0,11330,1008,426,2570504,41905
300153244600,30-015-32446,LOVING 1 STATE 003,2008-06-01,45,0,11461,909,426,2581965,42814
300153244600,30-015-32446,LOVING 1 STATE 003,2008-07-01,46,0,11283,1033,426,2593248,43847
300153244600,30-015-32446,LOVING 1 STATE 003,2008-08-01,47,0,11035,995,426,2604283,44842
300153244600,30-015-32446,LOVING 1 STATE 003,2008-09-01,48,0,6209,1114,426,2610492,45956
300153244600,30-015-32446,LOVING 1 STATE 003,2008-10-01,49,0,10565,1115,426,2621057,47071
300153244600,30-015-32446,LOVING 1 STATE 003,2008-11-01,50,0,13274,970,426,2634331,48041
300153244600,30-015-32446,LOVING 1 STATE 003,2008-12-01,51,0,12083,960,426,2646414,49001
300153244600,30-015-32446,LOVING 1 STATE 003,2009-01-01,52,0,14204,970,426,2660618,49971
300153244600,30-015-32446,LOVING 1 STATE 003,2009-02-01,53,0,10670,945,426,2671288,50916
300153244600,30-015-32446,LOVING 1 STATE 003,2009-03-01,54,0,11881,1015,426,2683169,51931
300153244600,30-015-32446,LOVING 1 STATE 003,2009-04-01,55,0,12623,1000,426,2695792,52931
300153244600,30-015-32446,LOVING 1 STATE 003,2009-05-01,56,0,9233,1128,426,2705025,54059
300153244600,30-015-32446,LOVING 1 STATE 003,2009-06-01,57,0,12536,950,426,2717561,55009
300153244600,30-015-32446,LOVING 1 STATE 003,2009-07-01,58,7,10461,965,433,2728022,55974
300153244600,30-015-32446,LOVING 1 STATE 003,2009-08-01,59,0,10682,1073,433,2738704,57047
300153244600,30-015-32446,LOVING 1 STATE 003,2009-09-01,60,0,11874,991,433,2750578,58038
300153244600,30-015-32446,LOVING 1 STATE 003,2009-10-01,61,10,12201,1010,443,2762779,59048
300153244600,30-015-32446,LOVING 1 STATE 003,2009-11-01,62,0,11220,975,443,2773999,60023
300153244600,30-015-32446,LOVING 1 STATE 003,2009-12-01,63,0,10978,915,443,2784977,60938
300153244600,30-015-32446,LOVING 1 STATE 003,2010-01-01,64,0,13675,920,443,2798652,61858
300153244600,30-015-32446,LOVING 1 STATE 003,2010-02-01,65,0,9227,705,443,2807879,62563
300153244600,30-015-32446,LOVING 1 STATE 003,2010-03-01,66,0,13439,818,443,2821318,63381
300153244600,30-015-32446,LOVING 1 STATE 003,2010-04-01,67,0,12976,857,443,2834294,64238
300153244600,30-015-32446,LOVING 1 STATE 003,2010-05-01,68,0,12250,900,443,2846544,65138
300153244600,30-015-32446,LOVING 1 STATE 003,2010-06-01,69,0,12403,840,443,2858947,65978
300153244600,30-015-32446,LOVING 1 STATE 003,2010-07-01,70,0,13695,906,443,2872642,66884
300153244600,30-015-32446,LOVING 1 STATE 003,2010-08-01,71,0,11146,828,443,2883788,67712
300153244600,30-015-32446,LOVING 1 STATE 003,2010-09-01,72,0,10139,737,443,2893927,68449
300153244600,30-015-32446,LOVING 1 STATE 003,2010-10-01,73,0,10396,609,443,2904323,69058
300153244600,30-015-32446,LOVING 1 STATE 003,2010-11-01,74,0,9476,589,443,2913799,69647
300153244600,30-015-32446,LOVING 1 STATE 003,2010-12-01,75,0,10121,545,443,2923920,70192
300153244600,30-015-32446,LOVING 1 STATE 003,2011-01-01,76,20,7664,437,463,2931584,70629
300153244600,30-015-32446,LOVING 1 STATE 003,2011-02-01,77,0,3889,600,463,2935473,71229
300153244600,30-015-32446,LOVING 1 STATE 003,2011-03-01,78,0,8191,304,463,2943664,71533
300153244600,30-015-32446,LOVING 1 STATE 003,2011-04-01,79,0,11798,432,463,2955462,71965
300153244600,30-015-32446,LOVING 1 STATE 003,2011-05-01,80,0,12035,460,463,2967497,72425
300153244600,30-015-32446,LOVING 1 STATE 003,2011-06-01,81,0,8412,400,463,2975909,72825
300153244600,30-015-32446,LOVING 1 STATE 003,2011-07-01,82,0,9625,513,463,2985534,73338
300153244600,30-015-32446,LOVING 1 STATE 003,2011-08-01,83,0,14295,585,463,2999829,73923
300153244600,30-015-32446,LOVING 1 STATE 003,2011-09-01,84,0,16920,600,463,3016749,74523
300153244600,30-015-32446,LOVING 1 STATE 003,2011-10-01,85,0,13216,500,463,3029965,75023
300153244600,30-015-32446,LOVING 1 STATE 003,2011-11-01,86,0,13481,545,463,3043446,75568
300153244600,30-015-32446,LOVING 1 STATE 003,2011-12-01,87,0,16168,560,463,3059614,76128
300153244600,30-015-32446,LOVING 1 STATE 003,2012-01-01,88,0,13883,81,463,3073497,76209
300153244600,30-015-32446,LOVING 1 STATE 003,2012-02-01,89,0,11699,101,463,3085196,76310
300153244600,30-015-32446,LOVING 1 STATE 003,2012-03-01,90,0,14500,118,463,3099696,76428
300153244600,30-015-32446,LOVING 1 STATE 003,2012-04-01,91,0,12835,120,463,3112531,76548
300153244600,30-015-32446,LOVING 1 STATE 003,2012-05-01,92,0,13096,26,463,3125627,76574
300153244600,30-015-32446,LOVING 1 STATE 003,2012-06-01,93,0,11879,100,463,3137506,76674
300153244600,30-015-32446,LOVING 1 STATE 003,2012-07-01,94,0,8533,50,463,3146039,76724
300153244600,30-015-32446,LOVING 1 STATE 003,2012-08-01,95,0,11465,120,463,3157504,76844
300153244600,30-015-32446,LOVING 1 STATE 003,2012-09-01,96,0,11790,36,463,3169294,76880
300153244600,30-015-32446,LOVING 1 STATE 003,2012-10-01,97,0,9387,73,463,3178681,76953
300153244600,30-015-32446,LOVING 1 STATE 003,2012-11-01,98,1,9794,113,464,3188475,77066
300153244600,30-015-32446,LOVING 1 STATE 003,2012-12-01,99,0,11042,92,464,3199517,77158
300153244600,30-015-32446,LOVING 1 STATE 003,2013-01-01,100,2,9450,92,466,3208967,77250
300153244600,30-015-32446,LOVING 1 STATE 003,2013-02-01,101,0,11166,105,466,3220133,77355
300153244600,30-015-32446,LOVING 1 STATE 003,2013-03-01,102,0,10175,79,466,3230308,77434
300153244600,30-015-32446,LOVING 1 STATE 003,2013-04-01,103,0,9941,87,466,3240249,77521
300153244600,30-015-32446,LOVING 1 STATE 003,2013-05-01,104,0,5922,46,466,3246171,77567
300153244600,30-015-32446,LOVING 1 STATE 003,2013-06-01,105,0,4292,34,466,3250463,77601
300153244600,30-015-32446,LOVING 1 STATE 003,2013-07-01,106,0,8995,58,466,3259458,77659
300153244600,30-015-32446,LOVING 1 STATE 003,2013-08-01,107,0,12736,113,466,3272194,77772
300153244600,30-015-32446,LOVING 1 STATE 003,2013-09-01,108,0,10648,71,466,3282842,77843
300153244600,30-015-32446,LOVING 1 STATE 003,2013-10-01,109,3,7056,94,469,3289898,77937
300153244600,30-015-32446,LOVING 1 STATE 003,2013-11-01,110,0,2738,14,469,3292636,77951
300153244600,30-015-32446,LOVING 1 STATE 003,2013-12-01,111,0,995,8,469,3293631,77959
300153244600,30-015-32446,LOVING 1 STATE 003,2014-01-01,112,0,2059,19,469,3295690,77978
300153244600,30-015-32446,LOVING 1 STATE 003,2014-02-01,113,55,1811,1305,524,3297501,79283
300153244600,30-015-32446,LOVING 1 STATE 003,2014-03-01,114,0,3062,1556,524,3300563,80839
300153244600,30-015-32446,LOVING 1 STATE 003,2014-04-01,115,12,2984,684,536,3303547,81523
300153244600,30-015-32446,LOVING 1 STATE 003,2014-05-01,116,0,3533,1352,536,3307080,82875
300153244600,30-015-32446,LOVING 1 STATE 003,2014-06-01,117,0,4096,1055,536,3311176,83930
300153244600,30-015-32446,LOVING 1 STATE 003,2014-07-01,118,0,3445,865,536,3314621,84795
300153244600,30-015-32446,LOVING 1 STATE 003,2014-08-01,119,0,916,442,536,3315537,85237
300153244600,30-015-32446,LOVING 1 STATE 003,2014-09-01,120,0,0,0,536,3315537,85237
300153244600,30-015-32446,LOVING 1 STATE 003,2014-10-01,121,0,0,0,536,3315537,85237
300153244600,30-015-32446,LOVING 1 STATE 003,2014-11-01,122,0,570,22,536,3316107,85259
300153244600,30-015-32446,LOVING 1 STATE 003,2014-12-01,123,0,898,5,536,3317005,85264
300153244600,30-015-32446,LOVING 1 STATE 003,2015-01-01,124,0,56,20,536,3317061,85284
300153244600,30-015-32446,LOVING 1 STATE 003,2015-02-01,125,2,0,0,538,3317061,85284
300153244600,30-015-32446,LOVING 1 STATE 003,2015-03-01,126,0,374,0,538,3317435,85284
300153244600,30-015-32446,LOVING 1 STATE 003,2015-04-01,127,0,902,0,538,3318337,85284
300153244600,30-015-32446,LOVING 1 STATE 003,2015-05-01,128,0,6318,0,538,3324655,85284
300153244600,30-015-32446,LOVING 1 STATE 003,2015-06-01,129,0,3253,0,538,3327908,85284
300153244600,30-015-32446,LOVING 1 STATE 003,2015-07-01,130,0,1990,0,538,3329898,85284
300153244600,30-015-32446,LOVING 1 STATE 003,2015-08-01,131,0,939,0,538,3330837,85284
300153244600,30-015-32446,LOVING 1 STATE 003,2015-09-01,132,0,3012,0,538,3333849,85284
300153244600,30-015-32446,LOVING 1 STATE 003,2015-10-01,133,0,3522,0,538,3337371,85284
300153244600,30-015-32446,LOVING 1 STATE 003,2015-11-01,134,0,2494,6,538,3339865,85290
300153244600,30-015-32446,LOVING 1 STATE 003,2015-12-01,135,0,486,6,538,3340351,85296
300153244600,30-015-32446,LOVING 1 STATE 003,2016-01-01,136,1,1,0,539,3340352,85296
300153244600,30-015-32446,LOVING 1 STATE 003,2016-02-01,137,0,702,0,539,3341054,85296
300153244600,30-015-32446,LOVING 1 STATE 003,2016-03-01,138,55,3211,570,594,3344265,85866
300153244600,30-015-32446,LOVING 1 STATE 003,2016-04-01,139,0,1398,0,594,3345663,85866
300153244600,30-015-32446,LOVING 1 STATE 003,2016-05-01,140,0,831,0,594,3346494,85866
300154450400,30-015-44504,BLACK RIVER 374 STATE 24 27 15 WXY 003H,2018-07-01,1,18722,41882,106490,18722,41882,106490
300154450400,30-015-44504,BLACK RIVER 374 STATE 24 27 15 WXY 003H,2018-08-01,2,19118,59880,68607,37840,101762,175097
300154450400,30-015-44504,BLACK RIVER 374 STATE 24 27 15 WXY 003H,2018-09-01,3,7663,29647,36588,45503,131409,211685
300154450400,30-015-44504,BLACK RIVER 374 STATE 24 27 15 WXY 003H,2018-10-01,4,14987,19112,31898,60490,150521,243583
300154450400,30-015-44504,BLACK RIVER 374 STATE 24 27 15 WXY 003H,2018-11-01,5,8561,24588,37209,69051,175109,280792
300154450400,30-015-44504,BLACK RIVER 374 STATE 24 27 15 WXY 003H,2018-12-01,6,8154,35260,33813,77205,210369,314605
300154450400,30-015-44504,BLACK RIVER 374 STATE 24 27 15 WXY 003H,2019-01-01,7,6197,33307,22776,83402,243676,337381
300154450400,30-015-44504,BLACK RIVER 374 STATE 24 27 15 WXY 003H,2019-02-01,8,1941,17695,17555,85343,261371,354936
300154450400,30-015-44504,BLACK RIVER 374 STATE 24 27 15 WXY 003H,2019-03-01,9,5796,18202,28359,91139,279573,383295
300154450400,30-015-44504,BLACK RIVER 374 STATE 24 27 15 WXY 003H,2019-04-01,10,3753,9551,15204,94892,289124,398499
300154450400,30-015-44504,BLACK RIVER 374 STATE 24 27 15 WXY 003H,2019-05-01,11,5091,18849,24445,99983,307973,422944
300154450400,30-015-44504,BLACK RIVER 374 STATE 24 27 15 WXY 003H,2019-06-01,12,4147,15204,20105,104130,323177,443049
300154450400,30-015-44504,BLACK RIVER 374 STATE 24 27 15 WXY 003H,2019-07-01,13,3713,11628,17481,107843,334805,460530
300154450400,30-015-44504,BLACK RIVER 374 STATE 24 27 15 WXY 003H,2019-08-01,14,2935,8991,15249,110778,343796,475779
300154450400,30-015-44504,BLACK RIVER 374 STATE 24 27 15 WXY 003H,2019-09-01,15,3743,7888,15181,114521,351684,490960
300154450400,30-015-44504,BLACK RIVER 374 STATE 24 27 15 WXY 003H,2019-10-01,16,2342,5732,10190,116863,357416,501150
300154450400,30-015-44504,BLACK RIVER 374 STATE 24 27 15 WXY 003H,2019-11-01,17,2672,7321,10131,119535,364737,511281
300154450400,30-015-44504,BLACK RIVER 374 STATE 24 27 15 WXY 003H,2019-12-01,18,2781,7844,10927,122316,372581,522208
300154450400,30-015-44504,BLACK RIVER 374 STATE 24 27 15 WXY 003H,2020-01-01,19,2736,6736,10776,125052,379317,532984
300154450400,30-015-44504,BLACK RIVER 374 STATE 24 27 15 WXY 003H,2020-02-01,20,1555,32764,5318,126607,412081,538302
300154450400,30-015-44504,BLACK RIVER 374 STATE 24 27 15 WXY 003H,2020-03-01,21,3371,13914,13472,129978,425995,551774
300154450400,30-015-44504,BLACK RIVER 374 STATE 24 27 15 WXY 003H,2020-04-01,22,2867,9374,15275,132845,435369,567049
300154450400,30-015-44504,BLACK RIVER 374 STATE 24 27 15 WXY 003H,2020-05-01,23,2366,9659,12834,135211,445028,579883
300154450400,30-015-44504,BLACK RIVER 374 STATE 24 27 15 WXY 003H,2020-06-01,24,2281,12328,10432,137492,457356,590315
300154450400,30-015-44504,BLACK RIVER 374 STATE 24 27 15 WXY 003H,2020-07-01,25,2185,8625,10838,139677,465981,601153
300154450400,30-015-44504,BLACK RIVER 374 STATE 24 27 15 WXY 003H,2020-08-01,26,1709,5202,7624,141386,471183,608777
300154450400,30-015-44504,BLACK RIVER 374 STATE 24 27 15 WXY 003H,2020-09-01,27,1940,6457,9105,143326,477640,617882
300154450400,30-015-44504,BLACK RIVER 374 STATE 24 27 15 WXY 003H,2020-10-01,28,1816,4691,7399,145142,482331,625281
300154450400,30-015-44504,BLACK RIVER 374 STATE 24 27 15 WXY 003H,2020-11-01,29,1955,2585,8051,147097,484916,633332
300154450400,30-015-44504,BLACK RIVER 374 STATE 24 27 15 WXY 003H,2020-12-01,30,1618,3127,6197,148715,488043,639529
300154450400,30-015-44504,BLACK RIVER 374 STATE 24 27 15 WXY 003H,2021-01-01,31,1869,5126,8946,150584,493169,648475
300154450400,30-015-44504,BLACK RIVER 374 STATE 24 27 15 WXY 003H,2021-02-01,32,1464,4722,4088,152048,497891,652563
300154450400,30-015-44504,BLACK RIVER 374 STATE 24 27 15 WXY 003H,2021-03-01,33,2149,6736,8252,154197,504627,660815
300154450400,30-015-44504,BLACK RIVER 374 STATE 24 27 15 WXY 003H,2021-04-01,34,1261,5242,7233,155458,509869,668048
300154450400,30-015-44504,BLACK RIVER 374 STATE 24 27 15 WXY 003H,2021-05-01,35,1734,5368,8039,157192,515237,676087
300154450400,30-015-44504,BLACK RIVER 374 STATE 24 27 15 WXY 003H,2021-06-01,36,1610,3660,8490,158802,518897,684577
300154450400,30-015-44504,BLACK RIVER 374 STATE 24 27 15 WXY 003H,2021-07-01,37,262,639,3375,159064,519536,687952
300154450400,30-015-44504,BLACK RIVER 374 STATE 24 27 15 WXY 003H,2021-08-01,38,1209,4401,7264,160273,523937,695216
300154450400,30-015-44504,BLACK RIVER 374 STATE 24 27 15 WXY 003H,2021-09-01,39,1707,4184,8181,161980,528121,703397
300154450400,30-015-44504,BLACK RIVER 374 STATE 24 27 15 WXY 003H,2021-10-01,40,1762,4973,8227,163742,533094,711624
300154450400,30-015-44504,BLACK RIVER 374 STATE 24 27 15 WXY 003H,2021-11-01,41,1657,6640,8773,165399,539734,720397
300154450400,30-015-44504,BLACK RIVER 374 STATE 24 27 15 WXY 003H,2021-12-01,42,1425,5940,7335,166824,545674,727732
300154450400,30-015-44504,BLACK RIVER 374 STATE 24 27 15 WXY 003H,2022-01-01,43,1406,4921,6131,168230,550595,733863
300154450400,30-015-44504,BLACK RIVER 374 STATE 24 27 15 WXY 003H,2022-02-01,44,748,2699,3334,168978,553294,737197
300154450400,30-015-44504,BLACK RIVER 374 STATE 24 27 15 WXY 003H,2022-03-01,45,1577,5063,7102,170555,558357,744299
300154450400,30-015-44504,BLACK RIVER 374 STATE 24 27 15 WXY 003H,2022-04-01,46,1503,7005,8869,172058,565362,753168
300154450400,30-015-44504,BLACK RIVER 374 STATE 24 27 15 WXY 003H,2022-05-01,47,1424,6934,8340,173482,572296,761508
300154450400,30-015-44504,BLACK RIVER 374 STATE 24 27 15 WXY 003H,2022-06-01,48,1449,8163,9072,174931,580459,770580
300154450400,30-015-44504,BLACK RIVER 374 STATE 24 27 15 WXY 003H,2022-07-01,49,1372,9494,9970,176303,589953,780550
300154450400,30-015-44504,BLACK RIVER 374 STATE 24 27 15 WXY 003H,2022-08-01,50,1247,9943,9784,177550,599896,790334
300154450400,30-015-44504,BLACK RIVER 374 STATE 24 27 15 WXY 003H,2022-09-01,51,1129,8189,8264,178679,608085,798598
300154450400,30-015-44504,BLACK RIVER 374 STATE 24 27 15 WXY 003H,2022-10-01,52,1248,8061,8275,179927,616146,806873
300154450400,30-015-44504,BLACK RIVER 374 STATE 24 27 15 WXY 003H,2022-11-01,53,1130,6939,7072,181057,623085,813945
300154450400,30-015-44504,BLACK RIVER 374 STATE 24 27 15 WXY 003H,2022-12-01,54,971,6148,5449,182028,629233,819394
300154450400,30-015-44504,BLACK RIVER 374 STATE 24 27 15 WXY 003H,2023-01-01,55,1212,6890,7202,183240,636123,826596
300154450400,30-015-44504,BLACK RIVER 374 STATE 24 27 15 WXY 003H,2023-02-01,56,902,5321,5041,184142,641444,831637
300154450400,30-015-44504,BLACK RIVER 374 STATE 24 27 15 WXY 003H,2023-03-01,57,1151,6929,6463,185293,648373,838100
300154450400,30-015-44504,BLACK RIVER 374 STATE 24 27 15 WXY 003H,2023-04-01,58,1100,6608,6329,186393,654981,844429
300154450400,30-015-44504,BLACK RIVER 374 STATE 24 27 15 WXY 003H,2023-05-01,59,1084,6684,6490,187477,661665,850919
300154450400,30-015-44504,BLACK RIVER 374 STATE 24 27 15 WXY 003H,2023-06-01,60,764,4990,4437,188241,666655,855356
300154450600,30-015-44506,BLACK RIVER 374 STATE 24 27 15 TB 010H,2018-07-01,1,6674,11773,96543,6674,11773,96543
300154450600,30-015-44506,BLACK RIVER 374 STATE 24 27 15 TB 010H,2018-08-01,2,0,0,0,6674,11773,96543
300154450600,30-015-44506,BLACK RIVER 374 STATE 24 27 15 TB 010H,2018-09-01,3,3478,8749,21984,10152,20522,118527
300154450600,30-015-44506,BLACK RIVER 374 STATE 24 27 15 TB 010H,2018-10-01,4,1240,7283,27880,11392,27805,146407
300154450600,30-015-44506,BLACK RIVER 374 STATE 24 27 15 TB 010H,2018-11-01,5,1410,0,17604,12802,27805,164011
300154450600,30-015-44506,BLACK RIVER 374 STATE 24 27 15 TB 010H,2018-12-01,6,517,7893,10947,13319,35698,174958
300154450600,30-015-44506,BLACK RIVER 374 STATE 24 27 15 TB 010H,2019-01-01,7,232,1884,1910,13551,37582,176868
300154450600,30-015-44506,BLACK RIVER 374 STATE 24 27 15 TB 010H,2019-02-01,8,340,1394,1757,13891,38976,178625
300154450600,30-015-44506,BLACK RIVER 374 STATE 24 27 15 TB 010H,2019-03-01,9,21,287,20,13912,39263,178645
300154450600,30-015-44506,BLACK RIVER 374 STATE 24 27 15 TB 010H,2019-04-01,10,345,0,6102,14257,39263,184747
300154450600,30-015-44506,BLACK RIVER 374 STATE 24 27 15 TB 010H,2019-05-01,11,240,1708,4330,14497,40971,189077
300154450600,30-015-44506,BLACK RIVER 374 STATE 24 27 15 TB 010H,2019-06-01,12,241,462,4135,14738,41433,193212
300154450600,30-015-44506,BLACK RIVER 374 STATE 24 27 15 TB 010H,2019-07-01,13,229,1719,4326,14967,43152,197538
300154450600,30-015-44506,BLACK RIVER 374 STATE 24 27 15 TB 010H,2019-08-01,14,200,1073,3756,15167,44225,201294
300154450600,30-015-44506,BLACK RIVER 374 STATE 24 27 15 TB 010H,2019-09-01,15,269,540,3880,15436,44765,205174
300154450600,30-015-44506,BLACK RIVER 374 STATE 24 27 15 TB 010H,2019-10-01,16,379,566,3447,15815,45331,208621
300154450600,30-015-44506,BLACK RIVER 374 STATE 24 27 15 TB 010H,2019-11-01,17,306,0,8601,16121,45331,217222
300154450600,30-015-44506,BLACK RIVER 374 STATE 24 27 15 TB 010H,2019-12-01,18,286,0,8780,16407,45331,226002
300154450600,30-015-44506,BLACK RIVER 374 STATE 24 27 15 TB 010H,2020-01-01,19,282,0,7264,16689,45331,233266
300154450600,30-015-44506,BLACK RIVER 374 STATE 24 27 15 TB 010H,2020-02-01,20,168,0,4016,16857,45331,237282
300154450600,30-015-44506,BLACK RIVER 374 STATE 24 27 15 TB 010H,2020-03-01,21,158,0,3872,17015,45331,241154
300154450600,30-015-44506,BLACK RIVER 374 STATE 24 27 15 TB 010H,2020-04-01,22,0,22,0,17015,45353,241154
300154450600,30-015-44506,BLACK RIVER 374 STATE 24 27 15 TB 010H,2020-05-01,23,0,8,0,17015,45361,241154
300154450600,30-015-44506,BLACK RIVER 374 STATE 24 27 15 TB 010H,2020-06-01,24,0,0,0,17015,45361,241154
300154450600,30-015-44506,BLACK RIVER 374 STATE 24 27 15 TB 010H,2020-07-01,25,0,0,0,17015,45361,241154
300154450600,30-015-44506,BLACK RIVER 374 STATE 24 27 15 TB 010H,2020-08-01,26,0,0,0,17015,45361,241154
300154450600,30-015-44506,BLACK RIVER 374 STATE 24 27 15 TB 010H,2020-09-01,27,0,0,0,17015,45361,241154
300154450600,30-015-44506,BLACK RIVER 374 STATE 24 27 15 TB 010H,2020-10-01,28,37,0,0,17052,45361,241154
300154450600,30-015-44506,BLACK RIVER 374 STATE 24 27 15 TB 010H,2020-11-01,29,0,0,0,17052,45361,241154
300154450600,30-015-44506,BLACK RIVER 374 STATE 24 27 15 TB 010H,2020-12-01,30,0,0,0,17052,45361,241154
300154450600,30-015-44506,BLACK RIVER 374 STATE 24 27 15 TB 010H,2021-01-01,31,0,0,0,17052,45361,241154
300154450600,30-015-44506,BLACK RIVER 374 STATE 24 27 15 TB 010H,2021-02-01,32,0,0,0,17052,45361,241154
300154450600,30-015-44506,BLACK RIVER 374 STATE 24 27 15 TB 010H,2021-03-01,33,50,0,0,17102,45361,241154
300154450600,30-015-44506,BLACK RIVER 374 STATE 24 27 15 TB 010H,2021-04-01,34,0,0,0,17102,45361,241154
300154450600,30-015-44506,BLACK RIVER 374 STATE 24 27 15 TB 010H,2021-05-01,35,0,0,0,17102,45361,241154
300154450600,30-015-44506,BLACK RIVER 374 STATE 24 27 15 TB 010H,2021-06-01,36,0,0,0,17102,45361,241154
300154450600,30-015-44506,BLACK RIVER 374 STATE 24 27 15 TB 010H,2021-07-01,37,0,0,0,17102,45361,241154
300154450600,30-015-44506,BLACK RIVER 374 STATE 24 27 15 TB 010H,2021-08-01,38,0,0,0,17102,45361,241154
300154450600,30-015-44506,BLACK RIVER 374 STATE 24 27 15 TB 010H,2021-09-01,39,0,0,0,17102,45361,241154
300154450600,30-015-44506,BLACK RIVER 374 STATE 24 27 15 TB 010H,2021-10-01,40,0,0,0,17102,45361,241154
300154450600,30-015-44506,BLACK RIVER 374 STATE 24 27 15 TB 010H,2021-11-01,41,0,0,0,17102,45361,241154
300154450600,30-015-44506,BLACK RIVER 374 STATE 24 27 15 TB 010H,2021-12-01,42,0,0,0,17102,45361,241154
300154450600,30-015-44506,BLACK RIVER 374 STATE 24 27 15 TB 010H,2022-01-01,43,0,0,0,17102,45361,241154
300154450600,30-015-44506,BLACK RIVER 374 STATE 24 27 15 TB 010H,2022-02-01,44,0,0,0,17102,45361,241154
300154450600,30-015-44506,BLACK RIVER 374 STATE 24 27 15 TB 010H,2022-03-01,45,0,0,0,17102,45361,241154
300154450600,30-015-44506,BLACK RIVER 374 STATE 24 27 15 TB 010H,2022-04-01,46,0,86,0,17102,45447,241154
300154450600,30-015-44506,BLACK RIVER 374 STATE 24 27 15 TB 010H,2022-05-01,47,0,0,0,17102,45447,241154
300154450600,30-015-44506,BLACK RIVER 374 STATE 24 27 15 TB 010H,2022-06-01,48,0,1,0,17102,45448,241154
300154450600,30-015-44506,BLACK RIVER 374 STATE 24 27 15 TB 010H,2022-07-01,49,0,0,0,17102,45448,241154
300154450600,30-015-44506,BLACK RIVER 374 STATE 24 27 15 TB 010H,2022-08-01,50,0,0,0,17102,45448,241154
300154450600,30-015-44506,BLACK RIVER 374 STATE 24 27 15 TB 010H,2022-09-01,51,0,0,0,17102,45448,241154
300154450600,30-015-44506,BLACK RIVER 374 STATE 24 27 15 TB 010H,2022-10-01,52,0,0,0,17102,45448,241154
300154450600,30-015-44506,BLACK RIVER 374 STATE 24 27 15 TB 010H,2022-11-01,53,0,0,0,17102,45448,241154
300154450600,30-015-44506,BLACK RIVER 374 STATE 24 27 15 TB 010H,2022-12-01,54,0,0,0,17102,45448,241154
300154450600,30-015-44506,BLACK RIVER 374 STATE 24 27 15 TB 010H,2023-01-01,55,0,0,0,17102,45448,241154
300154450600,30-015-44506,BLACK RIVER 374 STATE 24 27 15 TB 010H,2023-02-01,56,0,0,0,17102,45448,241154
300154450600,30-015-44506,BLACK RIVER 374 STATE 24 27 15 TB 010H,2023-03-01,57,0,0,0,17102,45448,241154
300154450600,30-015-44506,BLACK RIVER 374 STATE 24 27 15 TB 010H,2023-04-01,58,0,0,0,17102,45448,241154
300154450600,30-015-44506,BLACK RIVER 374 STATE 24 27 15 TB 010H,2023-05-01,59,0,0,0,17102,45448,241154
300154450600,30-015-44506,BLACK RIVER 374 STATE 24 27 15 TB 010H,2023-06-01,60,0,95,0,17102,45543,241154
300154418900,30-015-44189,ROADSTER STATE COM 001H,2018-03-01,1,1730,5365,61581,1730,5365,61581
300154418900,30-015-44189,ROADSTER STATE COM 001H,2018-04-01,2,23039,49446,119289,24769,54811,180870
300154418900,30-015-44189,ROADSTER STATE COM 001H,2018-05-01,3,25909,56684,120741,50678,111495,301611
300154418900,30-015-44189,ROADSTER STATE COM 001H,2018-06-01,4,20884,46841,83544,71562,158336,385155
300154418900,30-015-44189,ROADSTER STATE COM 001H,2018-07-01,5,19754,46779,75094,91316,205115,460249
300154418900,30-015-44189,ROADSTER STATE COM 001H,2018-08-01,6,18382,44669,64429,109698,249784,524678
300154418900,30-015-44189,ROADSTER STATE COM 001H,2018-09-01,7,15676,42130,48069,125374,291914,572747
300154418900,30-015-44189,ROADSTER STATE COM 001H,2018-10-01,8,13650,42450,54197,139024,334364,626944
300154418900,30-015-44189,ROADSTER STATE COM 001H,2018-11-01,9,12585,38379,50484,151609,372743,677428
300154418900,30-015-44189,ROADSTER STATE COM 001H,2018-12-01,10,10895,36724,49549,162504,409467,726977
300154418900,30-015-44189,ROADSTER STATE COM 001H,2019-01-01,11,10624,38822,47754,173128,448289,774731
300154418900,30-015-44189,ROADSTER STATE COM 001H,2019-02-01,12,8135,26419,34454,181263,474708,809185
300154418900,30-015-44189,ROADSTER STATE COM 001H,2019-03-01,13,9490,35848,41497,190753,510556,850682
300154418900,30-015-44189,ROADSTER STATE COM 001H,2019-04-01,14,7809,33444,38376,198562,544000,889058
300154418900,30-015-44189,ROADSTER STATE COM 001H,2019-05-01,15,7794,32680,39000,206356,576680,928058
300154418900,30-015-44189,ROADSTER STATE COM 001H,2019-06-01,16,7166,37731,31865,213522,614411,959923
300154418900,30-015-44189,ROADSTER STATE COM 001H,2019-07-01,17,7168,44082,34612,220690,658493,994535
300154418900,30-015-44189,ROADSTER STATE COM 001H,2019-08-01,18,2763,21077,17679,223453,679570,1012214
300154418900,30-015-44189,ROADSTER STATE COM 001H,2019-09-01,19,1487,7853,22777,224940,687423,1034991
300154418900,30-015-44189,ROADSTER STATE COM 001H,2019-10-01,20,2339,6947,18129,227279,694370,1053120
300154418900,30-015-44189,ROADSTER STATE COM 001H,2019-11-01,21,5212,28615,42317,232491,722985,1095437
300154418900,30-015-44189,ROADSTER STATE COM 001H,2019-12-01,22,4052,26680,30252,236543,749665,1125689
300154418900,30-015-44189,ROADSTER STATE COM 001H,2020-01-01,23,5504,28230,30989,242047,777895,1156678
300154418900,30-015-44189,ROADSTER STATE COM 001H,2020-02-01,24,5288,26775,27520,247335,804670,1184198
300154418900,30-015-44189,ROADSTER STATE COM 001H,2020-03-01,25,5461,28722,27298,252796,833392,1211496
300154418900,30-015-44189,ROADSTER STATE COM 001H,2020-04-01,26,5088,30527,29382,257884,863919,1240878
300154418900,30-015-44189,ROADSTER STATE COM 001H,2020-05-01,27,5413,29961,26019,263297,893880,1266897
300154418900,30-015-44189,ROADSTER STATE COM 001H,2020-06-01,28,4583,28421,22135,267880,922301,1289032
300154418900,30-015-44189,ROADSTER STATE COM 001H,2020-07-01,29,4693,31017,23253,272573,953318,1312285
300154418900,30-015-44189,ROADSTER STATE COM 001H,2020-08-01,30,4606,30339,21228,277179,983657,1333513
300154418900,30-015-44189,ROADSTER STATE COM 001H,2020-09-01,31,4506,35394,18006,281685,1019051,1351519
300154418900,30-015-44189,ROADSTER STATE COM 001H,2020-10-01,32,3666,29656,19110,285351,1048707,1370629
300154418900,30-015-44189,ROADSTER STATE COM 001H,2020-11-01,33,3929,25988,18310,289280,1074695,1388939
300154418900,30-015-44189,ROADSTER STATE COM 001H,2020-12-01,34,3446,24932,17678,292726,1099627,1406617
300154418900,30-015-44189,ROADSTER STATE COM 001H,2021-01-01,35,3762,26699,17155,296488,1126326,1423772
300154418900,30-015-44189,ROADSTER STATE COM 001H,2021-02-01,36,3331,13346,16184,299819,1139672,1439956
300154418900,30-015-44189,ROADSTER STATE COM 001H,2021-03-01,37,4257,22173,18260,304076,1161845,1458216
300154418900,30-015-44189,ROADSTER STATE COM 001H,2021-04-01,38,3415,23473,16129,307491,1185318,1474345
300154418900,30-015-44189,ROADSTER STATE COM 001H,2021-05-01,39,3437,22546,16258,310928,1207864,1490603
300154418900,30-015-44189,ROADSTER STATE COM 001H,2021-06-01,40,3292,22271,17846,314220,1230135,1508449
300154418900,30-015-44189,ROADSTER STATE COM 001H,2021-07-01,41,3095,24307,20458,317315,1254442,1528907
300154418900,30-015-44189,ROADSTER STATE COM 001H,2021-08-01,42,3044,23721,21075,320359,1278163,1549982
300154418900,30-015-44189,ROADSTER STATE COM 001H,2021-09-01,43,3079,21327,22857,323438,1299490,1572839
300154418900,30-015-44189,ROADSTER STATE COM 001H,2021-10-01,44,2847,21003,21988,326285,1320493,1594827
300154418900,30-015-44189,ROADSTER STATE COM 001H,2021-11-01,45,2464,21679,22972,328749,1342172,1617799
300154418900,30-015-44189,ROADSTER STATE COM 001H,2021-12-01,46,3664,19506,20424,332413,1361678,1638223
300154418900,30-015-44189,ROADSTER STATE COM 001H,2022-01-01,47,3320,14601,16771,335733,1376279,1654994
300154418900,30-015-44189,ROADSTER STATE COM 001H,2022-02-01,48,2922,18216,14740,338655,1394495,1669734
300154418900,30-015-44189,ROADSTER STATE COM 001H,2022-03-01,49,2886,18731,13926,341541,1413226,1683660
300154418900,30-015-44189,ROADSTER STATE COM 001H,2022-04-01,50,2556,22913,14215,344097,1436139,1697875
300154418900,30-015-44189,ROADSTER STATE COM 001H,2022-05-01,51,2858,25076,13804,346955,1461215,1711679
300154418900,30-015-44189,ROADSTER STATE COM 001H,2022-06-01,52,2151,14028,19021,349106,1475243,1730700
300154418900,30-015-44189,ROADSTER STATE COM 001H,2022-07-01,53,53,7733,9905,349159,1482976,1740605
300154418900,30-015-44189,ROADSTER STATE COM 001H,2022-08-01,54,48,14573,10907,349207,1497549,1751512
300154418900,30-015-44189,ROADSTER STATE COM 001H,2022-09-01,55,3076,9657,9142,352283,1507206,1760654
300154418900,30-015-44189,ROADSTER STATE COM 001H,2022-10-01,56,3976,11420,13114,356259,1518626,1773768
300154418900,30-015-44189,ROADSTER STATE COM 001H,2022-11-01,57,495,2893,2618,356754,1521519,1776386
300154418900,30-015-44189,ROADSTER STATE COM 001H,2022-12-01,58,0,6279,597,356754,1527798,1776983
300154418900,30-015-44189,ROADSTER STATE COM 001H,2023-01-01,59,1430,14501,867,358184,1542299,1777850
300154418900,30-015-44189,ROADSTER STATE COM 001H,2023-02-01,60,2018,18534,14569,360202,1560833,1792419
300154418900,30-015-44189,ROADSTER STATE COM 001H,2023-03-01,61,2313,19195,17502,362515,1580028,1809921
300154418900,30-015-44189,ROADSTER STATE COM 001H,2023-04-01,62,2331,17179,17017,364846,1597207,1826938
300154418900,30-015-44189,ROADSTER STATE COM 001H,2023-05-01,63,2371,17982,15872,367217,1615189,1842810
300154418900,30-015-44189,ROADSTER STATE COM 001H,2023-06-01,64,2308,16162,15638,369525,1631351,1858448
300154418900,30-015-44189,ROADSTER STATE COM 001H,2023-07-01,65,1642,15643,14055,371167,1646994,1872503
300154450500,30-015-44505,BLACK RIVER 374 STATE 24 27 15 WA 008H,2018-07-01,1,15247,33496,89061,15247,33496,89061
300154450500,30-015-44505,BLACK RIVER 374 STATE 24 27 15 WA 008H,2018-08-01,2,9122,19881,41245,24369,53377,130306
300154450500,30-015-44505,BLACK RIVER 374 STATE 24 27 15 WA 008H,2018-09-01,3,10758,40676,36573,35127,94053,166879
300154450500,30-015-44505,BLACK RIVER 374 STATE 24 27 15 WA 008H,2018-10-01,4,2812,25540,30245,37939,119593,197124
300154450500,30-015-44505,BLACK RIVER 374 STATE 24 27 15 WA 008H,2018-11-01,5,6633,27809,26603,44572,147402,223727
300154450500,30-015-44505,BLACK RIVER 374 STATE 24 27 15 WA 008H,2018-12-01,6,5916,30609,23521,50488,178011,247248
300154450500,30-015-44505,BLACK RIVER 374 STATE 24 27 15 WA 008H,2019-01-01,7,4644,32231,22241,55132,210242,269489
300154450500,30-015-44505,BLACK RIVER 374 STATE 24 27 15 WA 008H,2019-02-01,8,3016,12896,13978,58148,223138,283467
300154450500,30-015-44505,BLACK RIVER 374 STATE 24 27 15 WA 008H,2019-03-01,9,4536,11198,22177,62684,234336,305644
300154450500,30-015-44505,BLACK RIVER 374 STATE 24 27 15 WA 008H,2019-04-01,10,3973,14705,20745,66657,249041,326389
300154450500,30-015-44505,BLACK RIVER 374 STATE 24 27 15 WA 008H,2019-05-01,11,3605,21924,22202,70262,270965,348591
300154450500,30-015-44505,BLACK RIVER 374 STATE 24 27 15 WA 008H,2019-06-01,12,2662,12945,17478,72924,283910,366069
300154450500,30-015-44505,BLACK RIVER 374 STATE 24 27 15 WA 008H,2019-07-01,13,2768,13022,17064,75692,296932,383133
300154450500,30-015-44505,BLACK RIVER 374 STATE 24 27 15 WA 008H,2019-08-01,14,2193,10533,15044,77885,307465,398177
300154450500,30-015-44505,BLACK RIVER 374 STATE 24 27 15 WA 008H,2019-09-01,15,2649,9122,13998,80534,316587,412175
300154450500,30-015-44505,BLACK RIVER 374 STATE 24 27 15 WA 008H,2019-10-01,16,1794,9334,12394,82328,325921,424569
300154450500,30-015-44505,BLACK RIVER 374 STATE 24 27 15 WA 008H,2019-11-01,17,2236,11504,12176,84564,337425,436745
300154450500,30-015-44505,BLACK RIVER 374 STATE 24 27 15 WA 008H,2019-12-01,18,2028,13057,11596,86592,350482,448341
300154450500,30-015-44505,BLACK RIVER 374 STATE 24 27 15 WA 008H,2020-01-01,19,1963,9929,10882,88555,360411,459223
300154450500,30-015-44505,BLACK RIVER 374 STATE 24 27 15 WA 008H,2020-02-01,20,1254,0,7357,89809,360411,466580
300154450500,30-015-44505,BLACK RIVER 374 STATE 24 27 15 WA 008H,2020-03-01,21,2194,7492,13719,92003,367903,480299
300154450500,30-015-44505,BLACK RIVER 374 STATE 24 27 15 WA 008H,2020-04-01,22,1789,17236,14011,93792,385139,494310
300154450500,30-015-44505,BLACK RIVER 374 STATE 24 27 15 WA 008H,2020-05-01,23,1674,15337,14149,95466,400476,508459
300154450500,30-015-44505,BLACK RIVER 374 STATE 24 27 15 WA 008H,2020-06-01,24,1601,10696,13879,97067,411172,522338
300154450500,30-015-44505,BLACK RIVER 374 STATE 24 27 15 WA 008H,2020-07-01,25,1552,12344,13616,98619,423516,535954
300154450500,30-015-44505,BLACK RIVER 374 STATE 24 27 15 WA 008H,2020-08-01,26,1082,8560,10085,99701,432076,546039
300154450500,30-015-44505,BLACK RIVER 374 STATE 24 27 15 WA 008H,2020-09-01,27,988,7163,8104,100689,439239,554143
300154450500,30-015-44505,BLACK RIVER 374 STATE 24 27 15 WA 008H,2020-10-01,28,1378,8727,10936,102067,447966,565079
300154450500,30-015-44505,BLACK RIVER 374 STATE 24 27 15 WA 008H,2020-11-01,29,1370,11965,11334,103437,459931,576413
300154450500,30-015-44505,BLACK RIVER 374 STATE 24 27 15 WA 008H,2020-12-01,30,944,6631,7543,104381,466562,583956
300154450500,30-015-44505,BLACK RIVER 374 STATE 24 27 15 WA 008H,2021-01-01,31,1345,6401,8516,105726,472963,592472
300154450500,30-015-44505,BLACK RIVER 374 STATE 24 27 15 WA 008H,2021-02-01,32,977,4920,7425,106703,477883,599897
300154450500,30-015-44505,BLACK RIVER 374 STATE 24 27 15 WA 008H,2021-03-01,33,1355,6368,10418,108058,484251,610315
300154450500,30-015-44505,BLACK RIVER 374 STATE 24 27 15 WA 008H,2021-04-01,34,853,5478,7276,108911,489729,617591
300154450500,30-015-44505,BLACK RIVER 374 STATE 24 27 15 WA 008H,2021-05-01,35,688,4609,5041,109599,494338,622632
300154450500,30-015-44505,BLACK RIVER 374 STATE 24 27 15 WA 008H,2021-06-01,36,1251,8116,9362,110850,502454,631994
300154450500,30-015-44505,BLACK RIVER 374 STATE 24 27 15 WA 008H,2021-07-01,37,440,5210,4618,111290,507664,636612
300154450500,30-015-44505,BLACK RIVER 374 STATE 24 27 15 WA 008H,2021-08-01,38,899,6816,8479,112189,514480,645091
300154450500,30-015-44505,BLACK RIVER 374 STATE 24 27 15 WA 008H,2021-09-01,39,1026,5521,7641,113215,520001,652732
300154450500,30-015-44505,BLACK RIVER 374 STATE 24 27 15 WA 008H,2021-10-01,40,1291,7416,8994,114506,527417,661726
300154450500,30-015-44505,BLACK RIVER 374 STATE 24 27 15 WA 008H,2021-11-01,41,923,6691,6762,115429,534108,668488
300154450500,30-015-44505,BLACK RIVER 374 STATE 24 27 15 WA 008H,2021-12-01,42,1036,8182,8601,116465,542290,677089
300154450500,30-015-44505,BLACK RIVER 374 STATE 24 27 15 WA 008H,2022-01-01,43,802,7330,6997,117267,549620,684086
300154450500,30-015-44505,BLACK RIVER 374 STATE 24 27 15 WA 008H,2022-02-01,44,477,4211,3806,117744,553831,687892
300154450500,30-015-44505,BLACK RIVER 374 STATE 24 27 15 WA 008H,2022-03-01,45,1325,7369,7981,119069,561200,695873
300154450500,30-015-44505,BLACK RIVER 374 STATE 24 27 15 WA 008H,2022-04-01,46,946,6619,7725,120015,567819,703598
300154450500,30-015-44505,BLACK RIVER 374 STATE 24 27 15 WA 008H,2022-05-01,47,873,7736,7568,120888,575555,711166
300154450500,30-015-44505,BLACK RIVER 374 STATE 24 27 15 WA 008H,2022-06-01,48,1032,7985,8791,121920,583540,719957
300154450500,30-015-44505,BLACK RIVER 374 STATE 24 27 15 WA 008H,2022-07-01,49,872,8562,8704,122792,592102,728661
300154450500,30-015-44505,BLACK RIVER 374 STATE 24 27 15 WA 008H,2022-08-01,50,912,8846,9539,123704,600948,738200
300154450500,30-015-44505,BLACK RIVER 374 STATE 24 27 15 WA 008H,2022-09-01,51,688,7670,8307,124392,608618,746507
300154450500,30-015-44505,BLACK RIVER 374 STATE 24 27 15 WA 008H,2022-10-01,52,735,7365,7975,125127,615983,754482
300154450500,30-015-44505,BLACK RIVER 374 STATE 24 27 15 WA 008H,2022-11-01,53,695,6709,6611,125822,622692,761093
300154450500,30-015-44505,BLACK RIVER 374 STATE 24 27 15 WA 008H,2022-12-01,54,670,7055,6546,126492,629747,767639
300154450500,30-015-44505,BLACK RIVER 374 STATE 24 27 15 WA 008H,2023-01-01,55,702,6630,6789,127194,636377,774428
300154450500,30-015-44505,BLACK RIVER 374 STATE 24 27 15 WA 008H,2023-02-01,56,641,6429,6242,127835,642806,780670
300154450500,30-015-44505,BLACK RIVER 374 STATE 24 27 15 WA 008H,2023-03-01,57,577,6484,5667,128412,649290,786337
300154450500,30-015-44505,BLACK RIVER 374 STATE 24 27 15 WA 008H,2023-04-01,58,744,7269,7023,129156,656559,793360
300154450500,30-015-44505,BLACK RIVER 374 STATE 24 27 15 WA 008H,2023-05-01,59,659,6555,6665,129815,663114,800025
300154450500,30-015-44505,BLACK RIVER 374 STATE 24 27 15 WA 008H,2023-06-01,60,506,5718,5122,130321,668832,805147
300154531900,30-015-45319,ROADSTER STATE COM 808H,2019-06-01,1,8164,42381,79546,8164,42381,79546
300154531900,30-015-45319,ROADSTER STATE COM 808H,2019-07-01,2,18091,94342,105360,26255,136723,184906
300154531900,30-015-45319,ROADSTER STATE COM 808H,2019-08-01,3,16902,103743,91388,43157,240466,276294
300154531900,30-015-45319,ROADSTER STATE COM 808H,2019-09-01,4,15256,101085,78910,58413,341551,355204
300154531900,30-015-45319,ROADSTER STATE COM 808H,2019-10-01,5,13942,94700,70035,72355,436251,425239
300154531900,30-015-45319,ROADSTER STATE COM 808H,2019-11-01,6,11717,71015,80208,84072,507266,505447
300154531900,30-015-45319,ROADSTER STATE COM 808H,2019-12-01,7,12242,70130,79754,96314,577396,585201
300154531900,30-015-45319,ROADSTER STATE COM 808H,2020-01-01,8,10767,65512,55953,107081,642908,641154
300154531900,30-015-45319,ROADSTER STATE COM 808H,2020-02-01,9,8861,57882,46063,115942,700790,687217
300154531900,30-015-45319,ROADSTER STATE COM 808H,2020-03-01,10,9166,63803,46053,125108,764593,733270
300154531900,30-015-45319,ROADSTER STATE COM 808H,2020-04-01,11,7888,58822,42873,132996,823415,776143
300154531900,30-015-45319,ROADSTER STATE COM 808H,2020-05-01,12,7785,54384,36988,140781,877799,813131
300154531900,30-015-45319,ROADSTER STATE COM 808H,2020-06-01,13,6834,52411,36406,147615,930210,849537
300154531900,30-015-45319,ROADSTER STATE COM 808H,2020-07-01,14,7095,53965,37135,154710,984175,886672
300154531900,30-015-45319,ROADSTER STATE COM 808H,2020-08-01,15,5140,41177,29917,159850,1025352,916589
300154531900,30-015-45319,ROADSTER STATE COM 808H,2020-09-01,16,6254,46144,38556,166104,1071496,955145
300154531900,30-015-45319,ROADSTER STATE COM 808H,2020-10-01,17,6590,46013,33333,172694,1117509,988478
300154531900,30-015-45319,ROADSTER STATE COM 808H,2020-11-01,18,5626,45814,30843,178320,1163323,1019321
300154531900,30-015-45319,ROADSTER STATE COM 808H,2020-12-01,19,5733,39981,27958,184053,1203304,1047279
300154531900,30-015-45319,ROADSTER STATE COM 808H,2021-01-01,20,5330,36950,28445,189383,1240254,1075724
300154531900,30-015-45319,ROADSTER STATE COM 808H,2021-02-01,21,3095,34920,15673,192478,1275174,1091397
300154531900,30-015-45319,ROADSTER STATE COM 808H,2021-03-01,22,4933,43238,28536,197411,1318412,1119933
300154531900,30-015-45319,ROADSTER STATE COM 808H,2021-04-01,23,4641,36106,25001,202052,1354518,1144934
300154531900,30-015-45319,ROADSTER STATE COM 808H,2021-05-01,24,4868,37623,25659,206920,1392141,1170593
300154531900,30-015-45319,ROADSTER STATE COM 808H,2021-06-01,25,4395,36649,22229,211315,1428790,1192822
300154531900,30-015-45319,ROADSTER STATE COM 808H,2021-07-01,26,4586,36778,20521,215901,1465568,1213343
300154531900,30-015-45319,ROADSTER STATE COM 808H,2021-08-01,27,4377,36199,18861,220278,1501767,1232204
300154531900,30-015-45319,ROADSTER STATE COM 808H,2021-09-01,28,3630,33392,15621,223908,1535159,1247825
300154531900,30-015-45319,ROADSTER STATE COM 808H,2021-10-01,29,3867,35029,17791,227775,1570188,1265616
300154531900,30-015-45319,ROADSTER STATE COM 808H,2021-11-01,30,4426,32871,12752,232201,1603059,1278368
300154531900,30-015-45319,ROADSTER STATE COM 808H,2021-12-01,31,2975,30243,9049,235176,1633302,1287417
300154531900,30-015-45319,ROADSTER STATE COM 808H,2022-01-01,32,2816,28717,12198,237992,1662019,1299615
300154531900,30-015-45319,ROADSTER STATE COM 808H,2022-02-01,33,3093,26048,15282,241085,1688067,1314897
300154531900,30-015-45319,ROADSTER STATE COM 808H,2022-03-01,34,3324,29777,18017,244409,1717844,1332914
300154531900,30-015-45319,ROADSTER STATE COM 808H,2022-04-01,35,3613,25974,18149,248022,1743818,1351063
300154531900,30-015-45319,ROADSTER STATE COM 808H,2022-05-01,36,3394,26899,20548,251416,1770717,1371611
300154531900,30-015-45319,ROADSTER STATE COM 808H,2022-06-01,37,2617,25369,18121,254033,1796086,1389732
300154531900,30-015-45319,ROADSTER STATE COM 808H,2022-07-01,38,3237,22788,19210,257270,1818874,1408942
300154531900,30-015-45319,ROADSTER STATE COM 808H,2022-08-01,39,3237,15601,16800,260507,1834475,1425742
300154531900,30-015-45319,ROADSTER STATE COM 808H,2022-09-01,40,1324,26439,17673,261831,1860914,1443415
300154531900,30-015-45319,ROADSTER STATE COM 808H,2022-10-01,41,1162,25152,20731,262993,1886066,1464146
300154531900,30-015-45319,ROADSTER STATE COM 808H,2022-11-01,42,338,5251,7870,263331,1891317,1472016
300154531900,30-015-45319,ROADSTER STATE COM 808H,2022-12-01,43,3585,22243,18815,266916,1913560,1490831
300154531900,30-015-45319,ROADSTER STATE COM 808H,2023-01-01,44,4435,25374,38460,271351,1938934,1529291
300154531900,30-015-45319,ROADSTER STATE COM 808H,2023-02-01,45,3540,21177,19466,274891,1960111,1548757
300154531900,30-015-45319,ROADSTER STATE COM 808H,2023-03-01,46,3381,20821,16610,278272,1980932,1565367
300154531900,30-015-45319,ROADSTER STATE COM 808H,2023-04-01,47,2824,18744,15298,281096,1999676,1580665
300154531900,30-015-45319,ROADSTER STATE COM 808H,2023-05-01,48,2611,18164,14106,283707,2017840,1594771
300154531900,30-015-45319,ROADSTER STATE COM 808H,2023-06-01,49,2485,17277,13221,286192,2035117,1607992
300154531900,30-015-45319,ROADSTER STATE COM 808H,2023-07-01,50,2794,17043,13588,288986,2052160,1621580
300154952000,30-015-49520,TONY LA RUSSA 0310 STATE COM 225H,2022-11-01,1,5556,33711,60200,5556,33711,60200
300154952000,30-015-49520,TONY LA RUSSA 0310 STATE COM 225H,2022-12-01,2,19666,120341,123077,25222,154052,183277
300154952000,30-015-49520,TONY LA RUSSA 0310 STATE COM 225H,2023-01-01,3,14721,101160,84361,39943,255212,267638
300154952000,30-015-49520,TONY LA RUSSA 0310 STATE COM 225H,2023-02-01,4,1009,5946,5450,40952,261158,273088
300154952000,30-015-49520,TONY LA RUSSA 0310 STATE COM 225H,2023-03-01,5,8593,66663,51545,49545,327821,324633
300154952000,30-015-49520,TONY LA RUSSA 0310 STATE COM 225H,2023-04-01,6,9516,80483,54883,59061,408304,379516
300154952000,30-015-49520,TONY LA RUSSA 0310 STATE COM 225H,2023-05-01,7,7668,70181,45460,66729,478485,424976
300154952000,30-015-49520,TONY LA RUSSA 0310 STATE COM 225H,2023-06-01,8,6735,63731,40433,73464,542216,465409
300153203800,30-015-32038,EL PRESIDENTE STATE 001,2002-05-01,1,13,66502,239,13,66502,239
300153203800,30-015-32038,EL PRESIDENTE STATE 001,2002-06-01,2,37,166377,393,50,232879,632
300153203800,30-015-32038,EL PRESIDENTE STATE 001,2002-07-01,3,0,205365,0,50,438244,632
300153203800,30-015-32038,EL PRESIDENTE STATE 001,2002-08-01,4,14,165177,343,64,603421,975
300153203800,30-015-32038,EL PRESIDENTE STATE 001,2002-09-01,5,9,188896,346,73,792317,1321
300153203800,30-015-32038,EL PRESIDENTE STATE 001,2002-10-01,6,11,203374,420,84,995691,1741
300153203800,30-015-32038,EL PRESIDENTE STATE 001,2002-11-01,7,18,178306,376,102,1173997,2117
300153203800,30-015-32038,EL PRESIDENTE STATE 001,2002-12-01,8,7,191365,415,109,1365362,2532
300153203800,30-015-32038,EL PRESIDENTE STATE 001,2003-01-01,9,0,163391,299,109,1528753,2831
300153203800,30-015-32038,EL PRESIDENTE STATE 001,2003-02-01,10,0,66161,365,109,1594914,3196
300153203800,30-015-32038,EL PRESIDENTE STATE 001,2003-03-01,11,34,213323,1534,143,1808237,4730
300153203800,30-015-32038,EL PRESIDENTE STATE 001,2003-04-01,12,10,194515,612,153,2002752,5342
300153203800,30-015-32038,EL PRESIDENTE STATE 001,2003-05-01,13,0,161047,583,153,2163799,5925
300153203800,30-015-32038,EL PRESIDENTE STATE 001,2003-06-01,14,21,123508,501,174,2287307,6426
300153203800,30-015-32038,EL PRESIDENTE STATE 001,2003-07-01,15,0,111834,536,174,2399141,6962
300153203800,30-015-32038,EL PRESIDENTE STATE 001,2003-08-01,16,0,95129,502,174,2494270,7464
300153203800,30-015-32038,EL PRESIDENTE STATE 001,2003-09-01,17,0,70379,398,174,2564649,7862
300153203800,30-015-32038,EL PRESIDENTE STATE 001,2003-10-01,18,0,77815,435,174,2642464,8297
300153203800,30-015-32038,EL PRESIDENTE STATE 001,2003-11-01,19,0,64096,377,174,2706560,8674
300153203800,30-015-32038,EL PRESIDENTE STATE 001,2003-12-01,20,0,65075,343,174,2771635,9017
300153203800,30-015-32038,EL PRESIDENTE STATE 001,2004-01-01,21,0,54695,293,174,2826330,9310
300153203800,30-015-32038,EL PRESIDENTE STATE 001,2004-02-01,22,0,48149,285,174,2874479,9595
300153203800,30-015-32038,EL PRESIDENTE STATE 001,2004-03-01,23,0,47072,236,174,2921551,9831
300153203800,30-015-32038,EL PRESIDENTE STATE 001,2004-04-01,24,0,43585,196,174,2965136,10027
300153203800,30-015-32038,EL PRESIDENTE STATE 001,2004-05-01,25,0,39839,165,174,3004975,10192
300153203800,30-015-32038,EL PRESIDENTE STATE 001,2004-06-01,26,0,42240,174,174,3047215,10366
300153203800,30-015-32038,EL PRESIDENTE STATE 001,2004-07-01,27,0,42050,169,174,3089265,10535
300153203800,30-015-32038,EL PRESIDENTE STATE 001,2004-08-01,28,0,36499,133,174,3125764,10668
300153203800,30-015-32038,EL PRESIDENTE STATE 001,2004-09-01,29,0,34003,107,174,3159767,10775
300153203800,30-015-32038,EL PRESIDENTE STATE 001,2004-10-01,30,0,34892,131,174,3194659,10906
300153203800,30-015-32038,EL PRESIDENTE STATE 001,2004-11-01,31,0,29225,104,174,3223884,11010
300153203800,30-015-32038,EL PRESIDENTE STATE 001,2004-12-01,32,0,28319,93,174,3252203,11103
300153203800,30-015-32038,EL PRESIDENTE STATE 001,2005-01-01,33,0,26066,88,174,3278269,11191
300153203800,30-015-32038,EL PRESIDENTE STATE 001,2005-02-01,34,0,25375,59,174,3303644,11250
300153203800,30-015-32038,EL PRESIDENTE STATE 001,2005-03-01,35,0,21479,73,174,3325123,11323
300153203800,30-015-32038,EL PRESIDENTE STATE 001,2005-04-01,36,0,25999,66,174,3351122,11389
300153203800,30-015-32038,EL PRESIDENTE STATE 001,2005-05-01,37,0,25388,68,174,3376510,11457
300153203800,30-015-32038,EL PRESIDENTE STATE 001,2005-06-01,38,0,18357,44,174,3394867,11501
300153203800,30-015-32038,EL PRESIDENTE STATE 001,2005-07-01,39,0,5471,20,174,3400338,11521
300153203800,30-015-32038,EL PRESIDENTE STATE 001,2005-08-01,40,0,22648,52,174,3422986,11573
300153203800,30-015-32038,EL PRESIDENTE STATE 001,2005-09-01,41,0,16896,109,174,3439882,11682
300153203800,30-015-32038,EL PRESIDENTE STATE 001,2005-10-01,42,0,23284,58,174,3463166,11740
300153203800,30-015-32038,EL PRESIDENTE STATE 001,2005-11-01,43,0,7779,40,174,3470945,11780
300153203800,30-015-32038,EL PRESIDENTE STATE 001,2005-12-01,44,0,8937,36,174,3479882,11816
300153203800,30-015-32038,EL PRESIDENTE STATE 001,2006-01-01,45,0,18127,46,174,3498009,11862
300153203800,30-015-32038,EL PRESIDENTE STATE 001,2006-02-01,46,0,12138,18,174,3510147,11880
300153203800,30-015-32038,EL PRESIDENTE STATE 001,2006-03-01,47,0,16392,39,174,3526539,11919
300153203800,30-015-32038,EL PRESIDENTE STATE 001,2006-04-01,48,0,11391,21,174,3537930,11940
300153203800,30-015-32038,EL PRESIDENTE STATE 001,2006-05-01,49,0,12323,30,174,3550253,11970
300153203800,30-015-32038,EL PRESIDENTE STATE 001,2006-06-01,50,0,9059,9,174,3559312,11979
300153203800,30-015-32038,EL PRESIDENTE STATE 001,2006-07-01,51,0,17586,43,174,3576898,12022
300153203800,30-015-32038,EL PRESIDENTE STATE 001,2006-08-01,52,0,11939,18,174,3588837,12040
300153203800,30-015-32038,EL PRESIDENTE STATE 001,2006-09-01,53,0,13839,31,174,3602676,12071
300153203800,30-015-32038,EL PRESIDENTE STATE 001,2006-10-01,54,0,7126,13,174,3609802,12084
300153203800,30-015-32038,EL PRESIDENTE STATE 001,2006-11-01,55,0,16394,15,174,3626196,12099
300153203800,30-015-32038,EL PRESIDENTE STATE 001,2006-12-01,56,0,13255,27,174,3639451,12126
300153203800,30-015-32038,EL PRESIDENTE STATE 001,2007-01-01,57,0,9593,40,174,3649044,12166
300153203800,30-015-32038,EL PRESIDENTE STATE 001,2007-02-01,58,0,4744,8,174,3653788,12174
300153203800,30-015-32038,EL PRESIDENTE STATE 001,2007-03-01,59,0,9946,12,174,3663734,12186
300153203800,30-015-32038,EL PRESIDENTE STATE 001,2007-04-01,60,0,7023,9,174,3670757,12195
300153203800,30-015-32038,EL PRESIDENTE STATE 001,2007-05-01,61,0,9398,20,174,3680155,12215
300153203800,30-015-32038,EL PRESIDENTE STATE 001,2007-06-01,62,0,8679,20,174,3688834,12235
300153203800,30-015-32038,EL PRESIDENTE STATE 001,2007-07-01,63,0,11875,17,174,3700709,12252
300153203800,30-015-32038,EL PRESIDENTE STATE 001,2007-08-01,64,5,4901,33,179,3705610,12285
300153203800,30-015-32038,EL PRESIDENTE STATE 001,2007-09-01,65,0,11677,26,179,3717287,12311
300153203800,30-015-32038,EL PRESIDENTE STATE 001,2007-10-01,66,0,14247,33,179,3731534,12344
300153203800,30-015-32038,EL PRESIDENTE STATE 001,2007-11-01,67,0,10151,26,179,3741685,12370
300153203800,30-015-32038,EL PRESIDENTE STATE 001,2007-12-01,68,0,9796,14,179,3751481,12384
300153203800,30-015-32038,EL PRESIDENTE STATE 001,2008-01-01,69,0,9229,12,179,3760710,12396
300153203800,30-015-32038,EL PRESIDENTE STATE 001,2008-02-01,70,0,9069,33,179,3769779,12429
300153203800,30-015-32038,EL PRESIDENTE STATE 001,2008-03-01,71,0,9987,59,179,3779766,12488
300153203800,30-015-32038,EL PRESIDENTE STATE 001,2008-04-01,72,0,8603,48,179,3788369,12536
300153203800,30-015-32038,EL PRESIDENTE STATE 001,2008-05-01,73,0,8710,34,179,3797079,12570
300153203800,30-015-32038,EL PRESIDENTE STATE 001,2008-06-01,74,0,8595,48,179,3805674,12618
300153203800,30-015-32038,EL PRESIDENTE STATE 001,2008-07-01,75,0,9312,52,179,3814986,12670
300153203800,30-015-32038,EL PRESIDENTE STATE 001,2008-08-01,76,0,8835,62,179,3823821,12732
300153203800,30-015-32038,EL PRESIDENTE STATE 001,2008-09-01,77,0,7266,8,179,3831087,12740
300153203800,30-015-32038,EL PRESIDENTE STATE 001,2008-10-01,78,0,5119,0,179,3836206,12740
300153203800,30-015-32038,EL PRESIDENTE STATE 001,2008-11-01,79,0,6507,14,179,3842713,12754
300153203800,30-015-32038,EL PRESIDENTE STATE 001,2008-12-01,80,0,6089,32,179,3848802,12786
300153203800,30-015-32038,EL PRESIDENTE STATE 001,2009-01-01,81,0,7830,52,179,3856632,12838
300153203800,30-015-32038,EL PRESIDENTE STATE 001,2009-02-01,82,0,7689,32,179,3864321,12870
300153203800,30-015-32038,EL PRESIDENTE STATE 001,2009-03-01,83,0,8572,53,179,3872893,12923
300153203800,30-015-32038,EL PRESIDENTE STATE 001,2009-04-01,84,0,8040,40,179,3880933,12963
300153203800,30-015-32038,EL PRESIDENTE STATE 001,2009-05-01,85,0,5043,46,179,3885976,13009
300153203800,30-015-32038,EL PRESIDENTE STATE 001,2009-06-01,86,0,7340,39,179,3893316,13048
300153203800,30-015-32038,EL PRESIDENTE STATE 001,2009-07-01,87,0,6769,64,179,3900085,13112
300153203800,30-015-32038,EL PRESIDENTE STATE 001,2009-08-01,88,0,5537,62,179,3905622,13174
300153203800,30-015-32038,EL PRESIDENTE STATE 001,2009-09-01,89,0,6072,60,179,3911694,13234
300153203800,30-015-32038,EL PRESIDENTE STATE 001,2009-10-01,90,0,5694,60,179,3917388,13294
300153203800,30-015-32038,EL PRESIDENTE STATE 001,2009-11-01,91,0,6709,53,179,3924097,13347
300153203800,30-015-32038,EL PRESIDENTE STATE 001,2009-12-01,92,0,2588,45,179,3926685,13392
300153203800,30-015-32038,EL PRESIDENTE STATE 001,2010-01-01,93,0,3847,40,179,3930532,13432
300153203800,30-015-32038,EL PRESIDENTE STATE 001,2010-02-01,94,0,4178,47,179,3934710,13479
300153203800,30-015-32038,EL PRESIDENTE STATE 001,2010-03-01,95,0,4114,35,179,3938824,13514
300153203800,30-015-32038,EL PRESIDENTE STATE 001,2010-04-01,96,0,7517,81,179,3946341,13595
300153203800,30-015-32038,EL PRESIDENTE STATE 001,2010-05-01,97,0,7403,93,179,3953744,13688
300153203800,30-015-32038,EL PRESIDENTE STATE 001,2010-06-01,98,0,2567,37,179,3956311,13725
300153203800,30-015-32038,EL PRESIDENTE STATE 001,2010-07-01,99,0,4355,38,179,3960666,13763
300153203800,30-015-32038,EL PRESIDENTE STATE 001,2010-08-01,100,0,4160,85,179,3964826,13848
300153203800,30-015-32038,EL PRESIDENTE STATE 001,2010-09-01,101,0,3136,90,179,3967962,13938
300153203800,30-015-32038,EL PRESIDENTE STATE 001,2010-10-01,102,0,1935,25,179,3969897,13963
300153203800,30-015-32038,EL PRESIDENTE STATE 001,2010-11-01,103,0,2613,30,179,3972510,13993
300153203800,30-015-32038,EL PRESIDENTE STATE 001,2010-12-01,104,0,2566,42,179,3975076,14035
300153203800,30-015-32038,EL PRESIDENTE STATE 001,2011-01-01,105,0,2400,60,179,3977476,14095
300153203800,30-015-32038,EL PRESIDENTE STATE 001,2011-02-01,106,0,1089,0,179,3978565,14095
300153203800,30-015-32038,EL PRESIDENTE STATE 001,2011-03-01,107,0,1282,0,179,3979847,14095
300153203800,30-015-32038,EL PRESIDENTE STATE 001,2011-04-01,108,0,1743,0,179,3981590,14095
300153203800,30-015-32038,EL PRESIDENTE STATE 001,2011-05-01,109,0,2528,0,179,3984118,14095
300153203800,30-015-32038,EL PRESIDENTE STATE 001,2011-06-01,110,0,2980,0,179,3987098,14095
300153203800,30-015-32038,EL PRESIDENTE STATE 001,2011-07-01,111,0,3552,0,179,3990650,14095
300153203800,30-015-32038,EL PRESIDENTE STATE 001,2011-08-01,112,0,2871,0,179,3993521,14095
300153203800,30-015-32038,EL PRESIDENTE STATE 001,2011-09-01,113,0,25,0,179,3993546,14095
300153203800,30-015-32038,EL PRESIDENTE STATE 001,2011-10-01,114,0,1164,0,179,3994710,14095
300153203800,30-015-32038,EL PRESIDENTE STATE 001,2011-11-01,115,0,1902,0,179,3996612,14095
300153203800,30-015-32038,EL PRESIDENTE STATE 001,2011-12-01,116,0,1613,0,179,3998225,14095
300153203800,30-015-32038,EL PRESIDENTE STATE 001,2012-01-01,117,0,2251,0,179,4000476,14095
300153203800,30-015-32038,EL PRESIDENTE STATE 001,2012-02-01,118,0,2051,0,179,4002527,14095
300153203800,30-015-32038,EL PRESIDENTE STATE 001,2012-03-01,119,0,1954,0,179,4004481,14095
300153203800,30-015-32038,EL PRESIDENTE STATE 001,2012-04-01,120,0,2402,0,179,4006883,14095
300153203800,30-015-32038,EL PRESIDENTE STATE 001,2012-05-01,121,0,1851,0,179,4008734,14095
300153203800,30-015-32038,EL PRESIDENTE STATE 001,2012-06-01,122,0,1841,0,179,4010575,14095
300153203800,30-015-32038,EL PRESIDENTE STATE 001,2012-07-01,123,0,1686,0,179,4012261,14095
300153203800,30-015-32038,EL PRESIDENTE STATE 001,2012-08-01,124,0,1396,0,179,4013657,14095
300153203800,30-015-32038,EL PRESIDENTE STATE 001,2012-09-01,125,9,1035,0,188,4014692,14095
300153203800,30-015-32038,EL PRESIDENTE STATE 001,2012-10-01,126,0,1235,0,188,4015927,14095
300153203800,30-015-32038,EL PRESIDENTE STATE 001,2012-11-01,127,0,1372,0,188,4017299,14095
300153203800,30-015-32038,EL PRESIDENTE STATE 001,2012-12-01,128,0,1453,0,188,4018752,14095
300153203800,30-015-32038,EL PRESIDENTE STATE 001,2013-01-01,129,0,1332,0,188,4020084,14095
300153203800,30-015-32038,EL PRESIDENTE STATE 001,2013-02-01,130,0,545,0,188,4020629,14095
300153203800,30-015-32038,EL PRESIDENTE STATE 001,2013-03-01,131,0,529,0,188,4021158,14095
300153203800,30-015-32038,EL PRESIDENTE STATE 001,2013-04-01,132,0,457,0,188,4021615,14095
300153203800,30-015-32038,EL PRESIDENTE STATE 001,2013-05-01,133,0,520,0,188,4022135,14095
300153203800,30-015-32038,EL PRESIDENTE STATE 001,2013-06-01,134,0,965,0,188,4023100,14095
300153203800,30-015-32038,EL PRESIDENTE STATE 001,2013-07-01,135,0,905,0,188,4024005,14095
300153203800,30-015-32038,EL PRESIDENTE STATE 001,2013-08-01,136,0,366,0,188,4024371,14095
300153203800,30-015-32038,EL PRESIDENTE STATE 001,2013-09-01,137,0,365,0,188,4024736,14095
300153203800,30-015-32038,EL PRESIDENTE STATE 001,2013-10-01,138,0,745,0,188,4025481,14095
300153203800,30-015-32038,EL PRESIDENTE STATE 001,2013-11-01,139,0,175,0,188,4025656,14095
300153203800,30-015-32038,EL PRESIDENTE STATE 001,2013-12-01,140,0,588,0,188,4026244,14095
300153203800,30-015-32038,EL PRESIDENTE STATE 001,2014-01-01,141,0,449,0,188,4026693,14095
300153203800,30-015-32038,EL PRESIDENTE STATE 001,2014-02-01,142,0,857,0,188,4027550,14095
300153203800,30-015-32038,EL PRESIDENTE STATE 001,2014-03-01,143,0,1081,0,188,4028631,14095
300153203800,30-015-32038,EL PRESIDENTE STATE 001,2014-04-01,144,40,685,0,228,4029316,14095
300153203800,30-015-32038,EL PRESIDENTE STATE 001,2014-05-01,145,0,1087,0,228,4030403,14095
300153203800,30-015-32038,EL PRESIDENTE STATE 001,2014-06-01,146,0,1134,0,228,4031537,14095
300153203800,30-015-32038,EL PRESIDENTE STATE 001,2014-07-01,147,0,1409,0,228,4032946,14095
300153203800,30-015-32038,EL PRESIDENTE STATE 001,2014-08-01,148,0,915,0,228,4033861,14095
300153203800,30-015-32038,EL PRESIDENTE STATE 001,2014-09-01,149,0,0,0,228,4033861,14095
300153203800,30-015-32038,EL PRESIDENTE STATE 001,2014-10-01,150,0,0,0,228,4033861,14095
300153203800,30-015-32038,EL PRESIDENTE STATE 001,2014-11-01,151,0,512,0,228,4034373,14095
300153203800,30-015-32038,EL PRESIDENTE STATE 001,2014-12-01,152,0,958,0,228,4035331,14095
300153203800,30-015-32038,EL PRESIDENTE STATE 001,2015-01-01,153,0,937,0,228,4036268,14095
300153203800,30-015-32038,EL PRESIDENTE STATE 001,2015-02-01,154,0,930,0,228,4037198,14095
300153203800,30-015-32038,EL PRESIDENTE STATE 001,2015-03-01,155,0,1022,0,228,4038220,14095
300153203800,30-015-32038,EL PRESIDENTE STATE 001,2015-04-01,156,0,718,0,228,4038938,14095
300153203800,30-015-32038,EL PRESIDENTE STATE 001,2015-05-01,157,0,2610,0,228,4041548,14095
300153203800,30-015-32038,EL PRESIDENTE STATE 001,2015-06-01,158,0,2145,0,228,4043693,14095
300153203800,30-015-32038,EL PRESIDENTE STATE 001,2015-07-01,159,0,1648,0,228,4045341,14095
300153203800,30-015-32038,EL PRESIDENTE STATE 001,2015-08-01,160,0,1908,0,228,4047249,14095
300153203800,30-015-32038,EL PRESIDENTE STATE 001,2015-09-01,161,0,1562,0,228,4048811,14095
300153203800,30-015-32038,EL PRESIDENTE STATE 001,2015-10-01,162,0,1524,0,228,4050335,14095
300153203800,30-015-32038,EL PRESIDENTE STATE 001,2015-11-01,163,0,1527,0,228,4051862,14095
300153203800,30-015-32038,EL PRESIDENTE STATE 001,2015-12-01,164,0,179,0,228,4052041,14095
300153203800,30-015-32038,EL PRESIDENTE STATE 001,2016-01-01,165,0,52,0,228,4052093,14095
300153203800,30-015-32038,EL PRESIDENTE STATE 001,2016-02-01,166,23,648,0,251,4052741,14095
300153203800,30-015-32038,EL PRESIDENTE STATE 001,2016-03-01,167,0,2537,0,251,4055278,14095
300153203800,30-015-32038,EL PRESIDENTE STATE 001,2016-04-01,168,0,1882,0,251,4057160,14095
300153203800,30-015-32038,EL PRESIDENTE STATE 001,2016-05-01,169,0,1867,0,251,4059027,14095
300153203800,30-015-32038,EL PRESIDENTE STATE 001,2016-06-01,170,0,1799,0,251,4060826,14095
300153203800,30-015-32038,EL PRESIDENTE STATE 001,2016-07-01,171,0,1799,0,251,4062625,14095
300153203800,30-015-32038,EL PRESIDENTE STATE 001,2016-08-01,172,0,1863,0,251,4064488,14095
300153203800,30-015-32038,EL PRESIDENTE STATE 001,2016-09-01,173,0,1860,0,251,4066348,14095
300153203800,30-015-32038,EL PRESIDENTE STATE 001,2016-10-01,174,0,3124,0,251,4069472,14095
300153203800,30-015-32038,EL PRESIDENTE STATE 001,2016-11-01,175,0,3353,0,251,4072825,14095
300153203800,30-015-32038,EL PRESIDENTE STATE 001,2016-12-01,176,0,3535,0,251,4076360,14095
300153203800,30-015-32038,EL PRESIDENTE STATE 001,2017-01-01,177,0,3037,0,251,4079397,14095
300153203800,30-015-32038,EL PRESIDENTE STATE 001,2017-02-01,178,0,115,3,251,4079512,14098
300153203800,30-015-32038,EL PRESIDENTE STATE 001,2017-03-01,179,0,3817,40,251,4083329,14138
300153203800,30-015-32038,EL PRESIDENTE STATE 001,2017-04-01,180,0,3594,17,251,4086923,14155
300153203800,30-015-32038,EL PRESIDENTE STATE 001,2017-05-01,181,0,3236,8,251,4090159,14163
300153203800,30-015-32038,EL PRESIDENTE STATE 001,2017-06-01,182,0,1905,12,251,4092064,14175
300153203800,30-015-32038,EL PRESIDENTE STATE 001,2017-07-01,183,14,2021,36,265,4094085,14211
300153203800,30-015-32038,EL PRESIDENTE STATE 001,2017-08-01,184,0,2776,0,265,4096861,14211
300153203800,30-015-32038,EL PRESIDENTE STATE 001,2017-09-01,185,0,2521,13,265,4099382,14224
300153203800,30-015-32038,EL PRESIDENTE STATE 001,2017-10-01,186,0,1952,0,265,4101334,14224
300153203800,30-015-32038,EL PRESIDENTE STATE 001,2017-11-01,187,0,1514,0,265,4102848,14224
300153203800,30-015-32038,EL PRESIDENTE STATE 001,2017-12-01,188,0,1038,0,265,4103886,14224
300153203800,30-015-32038,EL PRESIDENTE STATE 001,2018-01-01,189,0,29,0,265,4103915,14224
300153203800,30-015-32038,EL PRESIDENTE STATE 001,2018-02-01,190,0,33,0,265,4103948,14224
300153203800,30-015-32038,EL PRESIDENTE STATE 001,2018-03-01,191,0,75,0,265,4104023,14224
300153613000,30-015-36130,MUNNYNTHABANK STATE 001H,2009-01-01,1,0,0,256,0,0,256
300153613000,30-015-36130,MUNNYNTHABANK STATE 001H,2009-02-01,2,691,0,2990,691,0,3246
300153613000,30-015-36130,MUNNYNTHABANK STATE 001H,2009-03-01,3,98,0,291,789,0,3537
300153613000,30-015-36130,MUNNYNTHABANK STATE 001H,2009-04-01,4,195,0,807,984,0,4344
300153613000,30-015-36130,MUNNYNTHABANK STATE 001H,2009-05-01,5,176,4877,1179,1160,4877,5523
300153613000,30-015-36130,MUNNYNTHABANK STATE 001H,2009-06-01,6,148,4051,999,1308,8928,6522
300153613000,30-015-36130,MUNNYNTHABANK STATE 001H,2009-07-01,7,80,2751,518,1388,11679,7040
300153613000,30-015-36130,MUNNYNTHABANK STATE 001H,2009-08-01,8,396,2744,1267,1784,14423,8307
300153613000,30-015-36130,MUNNYNTHABANK STATE 001H,2009-09-01,9,343,2994,1311,2127,17417,9618
300153613000,30-015-36130,MUNNYNTHABANK STATE 001H,2009-10-01,10,267,2661,919,2394,20078,10537
300153613000,30-015-36130,MUNNYNTHABANK STATE 001H,2009-11-01,11,164,2325,464,2558,22403,11001
300153613000,30-015-36130,MUNNYNTHABANK STATE 001H,2009-12-01,12,204,1990,647,2762,24393,11648
300153613000,30-015-36130,MUNNYNTHABANK STATE 001H,2010-01-01,13,56,1323,426,2818,25716,12074
300153613000,30-015-36130,MUNNYNTHABANK STATE 001H,2010-02-01,14,0,1834,263,2818,27550,12337
300153613000,30-015-36130,MUNNYNTHABANK STATE 001H,2010-03-01,15,170,1284,549,2988,28834,12886
300153613000,30-015-36130,MUNNYNTHABANK STATE 001H,2010-04-01,16,135,1340,480,3123,30174,13366
300153613000,30-015-36130,MUNNYNTHABANK STATE 001H,2010-05-01,17,181,1314,526,3304,31488,13892
300153613000,30-015-36130,MUNNYNTHABANK STATE 001H,2010-06-01,1,79,787,373,3383,32275,14265
300153613000,30-015-36130,MUNNYNTHABANK STATE 001H,2010-07-01,2,115,2178,2924,3498,34453,17189
300153613000,30-015-36130,MUNNYNTHABANK STATE 001H,2010-08-01,3,142,2977,1820,3640,37430,19009
300153613000,30-015-36130,MUNNYNTHABANK STATE 001H,2010-09-01,4,239,4968,1880,3879,42398,20889
300153613000,30-015-36130,MUNNYNTHABANK STATE 001H,2010-10-01,5,275,5960,1936,4154,48358,22825
300153613000,30-015-36130,MUNNYNTHABANK STATE 001H,2010-11-01,6,218,5862,1734,4372,54220,24559
300153613000,30-015-36130,MUNNYNTHABANK STATE 001H,2010-12-01,7,192,4703,1427,4564,58923,25986
300153613000,30-015-36130,MUNNYNTHABANK STATE 001H,2011-01-01,8,170,3487,856,4734,62410,26842
300153613000,30-015-36130,MUNNYNTHABANK STATE 001H,2011-02-01,9,64,2430,414,4798,64840,27256
300153613000,30-015-36130,MUNNYNTHABANK STATE 001H,2011-03-01,10,101,2925,471,4899,67765,27727
300153613000,30-015-36130,MUNNYNTHABANK STATE 001H,2011-04-01,11,114,1637,270,5013,69402,27997
300153613000,30-015-36130,MUNNYNTHABANK STATE 001H,2011-05-01,12,6,334,28,5019,69736,28025
300153613000,30-015-36130,MUNNYNTHABANK STATE 001H,2011-06-01,13,8,4,14,5027,69740,28039
300153613000,30-015-36130,MUNNYNTHABANK STATE 001H,2011-07-01,14,0,425,0,5027,70165,28039
300153613000,30-015-36130,MUNNYNTHABANK STATE 001H,2011-08-01,15,0,0,0,5027,70165,28039
300153613000,30-015-36130,MUNNYNTHABANK STATE 001H,2011-09-01,16,284,1683,1462,5311,71848,29501
300153613000,30-015-36130,MUNNYNTHABANK STATE 001H,2011-10-01,17,252,2734,1157,5563,74582,30658
300153613000,30-015-36130,MUNNYNTHABANK STATE 001H,2011-11-01,18,182,3618,1697,5745,78200,32355
300153613000,30-015-36130,MUNNYNTHABANK STATE 001H,2011-12-01,19,92,1285,458,5837,79485,32813
300153613000,30-015-36130,MUNNYNTHABANK STATE 001H,2012-01-01,20,230,2977,1124,6067,82462,33937
300153613000,30-015-36130,MUNNYNTHABANK STATE 001H,2012-02-01,21,128,1184,495,6195,83646,34432
300153613000,30-015-36130,MUNNYNTHABANK STATE 001H,2012-03-01,22,84,2360,451,6279,86006,34883
300153613000,30-015-36130,MUNNYNTHABANK STATE 001H,2012-04-01,23,84,1105,439,6363,87111,35322
300153613000,30-015-36130,MUNNYNTHABANK STATE 001H,2012-05-01,24,39,992,211,6402,88103,35533
300153613000,30-015-36130,MUNNYNTHABANK STATE 001H,2012-06-01,25,229,3456,1326,6631,91559,36859
300153613000,30-015-36130,MUNNYNTHABANK STATE 001H,2012-07-01,26,119,2831,863,6750,94390,37722
300153613000,30-015-36130,MUNNYNTHABANK STATE 001H,2012-08-01,27,75,1821,510,6825,96211,38232
300153613000,30-015-36130,MUNNYNTHABANK STATE 001H,2012-09-01,28,8,551,114,6833,96762,38346
300153613000,30-015-36130,MUNNYNTHABANK STATE 001H,2012-10-01,29,55,735,642,6888,97497,38988
300153613000,30-015-36130,MUNNYNTHABANK STATE 001H,2012-11-01,30,58,1638,0,6946,99135,38988
300153613000,30-015-36130,MUNNYNTHABANK STATE 001H,2012-12-01,31,184,2141,0,7130,101276,38988
300153613000,30-015-36130,MUNNYNTHABANK STATE 001H,2013-01-01,32,14,191,0,7144,101467,38988
300153613000,30-015-36130,MUNNYNTHABANK STATE 001H,2013-02-01,33,179,2599,0,7323,104066,38988
300153613000,30-015-36130,MUNNYNTHABANK STATE 001H,2013-03-01,34,123,3306,0,7446,107372,38988
300153613000,30-015-36130,MUNNYNTHABANK STATE 001H,2013-04-01,35,92,1584,0,7538,108956,38988
300153613000,30-015-36130,MUNNYNTHABANK STATE 001H,2013-05-01,36,117,2388,0,7655,111344,38988
300153613000,30-015-36130,MUNNYNTHABANK STATE 001H,2013-06-01,37,80,382,525,7735,111726,39513
300153613000,30-015-36130,MUNNYNTHABANK STATE 001H,2013-07-01,38,0,611,0,7735,112337,39513
300153613000,30-015-36130,MUNNYNTHABANK STATE 001H,2013-08-01,39,0,1115,0,7735,113452,39513
300153613000,30-015-36130,MUNNYNTHABANK STATE 001H,2013-09-01,40,0,573,0,7735,114025,39513
300153613000,30-015-36130,MUNNYNTHABANK STATE 001H,2013-10-01,41,0,475,0,7735,114500,39513
300153613000,30-015-36130,MUNNYNTHABANK STATE 001H,2013-11-01,42,0,387,0,7735,114887,39513
300153613000,30-015-36130,MUNNYNTHABANK STATE 001H,2013-12-01,43,0,373,0,7735,115260,39513
300153613000,30-015-36130,MUNNYNTHABANK STATE 001H,2014-01-01,44,0,347,0,7735,115607,39513
300153613000,30-015-36130,MUNNYNTHABANK STATE 001H,2014-02-01,45,0,286,0,7735,115893,39513
300153613000,30-015-36130,MUNNYNTHABANK STATE 001H,2014-03-01,46,0,299,0,7735,116192,39513
300153613000,30-015-36130,MUNNYNTHABANK STATE 001H,2014-04-01,47,49,261,0,7784,116453,39513
300153613000,30-015-36130,MUNNYNTHABANK STATE 001H,2014-05-01,48,0,237,0,7784,116690,39513
300153613000,30-015-36130,MUNNYNTHABANK STATE 001H,2014-06-01,49,44,793,380,7828,117483,39893
300153613000,30-015-36130,MUNNYNTHABANK STATE 001H,2014-07-01,50,0,291,0,7828,117774,39893
300153613000,30-015-36130,MUNNYNTHABANK STATE 001H,2014-08-01,51,147,717,692,7975,118491,40585
300153613000,30-015-36130,MUNNYNTHABANK STATE 001H,2014-09-01,52,57,145,383,8032,118636,40968
300153613000,30-015-36130,MUNNYNTHABANK STATE 001H,2014-10-01,53,50,252,225,8082,118888,41193
300153613000,30-015-36130,MUNNYNTHABANK STATE 001H,2014-11-01,54,3,706,137,8085,119594,41330
300153613000,30-015-36130,MUNNYNTHABANK STATE 001H,2014-12-01,55,142,761,949,8227,120355,42279
300153613000,30-015-36130,MUNNYNTHABANK STATE 001H,2015-01-01,56,105,557,728,8332,120912,43007
300153613000,30-015-36130,MUNNYNTHABANK STATE 001H,2015-02-01,57,165,1568,1056,8497,122480,44063
300153613000,30-015-36130,MUNNYNTHABANK STATE 001H,2015-03-01,58,20,1226,322,8517,123706,44385
300153613000,30-015-36130,MUNNYNTHABANK STATE 001H,2015-04-01,59,0,732,0,8517,124438,44385
300153613000,30-015-36130,MUNNYNTHABANK STATE 001H,2015-05-01,60,0,1374,0,8517,125812,44385
300153613000,30-015-36130,MUNNYNTHABANK STATE 001H,2015-06-01,61,162,1050,1009,8679,126862,45394
300153613000,30-015-36130,MUNNYNTHABANK STATE 001H,2015-07-01,62,0,478,0,8679,127340,45394
300153613000,30-015-36130,MUNNYNTHABANK STATE 001H,2015-08-01,63,0,257,0,8679,127597,45394
300153613000,30-015-36130,MUNNYNTHABANK STATE 001H,2015-09-01,64,0,118,0,8679,127715,45394
300153613000,30-015-36130,MUNNYNTHABANK STATE 001H,2015-10-01,65,0,187,0,8679,127902,45394
300153613000,30-015-36130,MUNNYNTHABANK STATE 001H,2015-11-01,66,0,140,0,8679,128042,45394
300153613000,30-015-36130,MUNNYNTHABANK STATE 001H,2015-12-01,67,205,1127,880,8884,129169,46274
300153613000,30-015-36130,MUNNYNTHABANK STATE 001H,2016-01-01,68,200,1395,951,9084,130564,47225
300153613000,30-015-36130,MUNNYNTHABANK STATE 001H,2016-02-01,69,150,2183,1110,9234,132747,48335
300153613000,30-015-36130,MUNNYNTHABANK STATE 001H,2016-03-01,70,158,2222,1043,9392,134969,49378
300153613000,30-015-36130,MUNNYNTHABANK STATE 001H,2016-04-01,71,144,2606,1209,9536,137575,50587
300153613000,30-015-36130,MUNNYNTHABANK STATE 001H,2016-05-01,72,109,2428,905,9645,140003,51492
300153613000,30-015-36130,MUNNYNTHABANK STATE 001H,2016-06-01,73,84,2144,545,9729,142147,52037
300153613000,30-015-36130,MUNNYNTHABANK STATE 001H,2016-07-01,74,50,1253,389,9779,143400,52426
300153613000,30-015-36130,MUNNYNTHABANK STATE 001H,2016-08-01,75,55,970,296,9834,144370,52722
300153613000,30-015-36130,MUNNYNTHABANK STATE 001H,2016-09-01,76,62,1170,377,9896,145540,53099
300153613000,30-015-36130,MUNNYNTHABANK STATE 001H,2016-10-01,77,73,1156,376,9969,146696,53475
300153613000,30-015-36130,MUNNYNTHABANK STATE 001H,2016-11-01,78,28,860,290,9997,147556,53765
300153613000,30-015-36130,MUNNYNTHABANK STATE 001H,2016-12-01,79,32,447,324,10029,148003,54089
300153613000,30-015-36130,MUNNYNTHABANK STATE 001H,2017-01-01,80,50,247,206,10079,148250,54295
300153613000,30-015-36130,MUNNYNTHABANK STATE 001H,2017-02-01,81,20,104,147,10099,148354,54442
300153613000,30-015-36130,MUNNYNTHABANK STATE 001H,2017-03-01,82,17,118,90,10116,148472,54532
300153613000,30-015-36130,MUNNYNTHABANK STATE 001H,2017-04-01,83,3,187,78,10119,148659,54610
300153613000,30-015-36130,MUNNYNTHABANK STATE 001H,2017-05-01,84,0,173,8,10119,148832,54618
300153613000,30-015-36130,MUNNYNTHABANK STATE 001H,2017-06-01,85,0,164,0,10119,148996,54618
300153613000,30-015-36130,MUNNYNTHABANK STATE 001H,2017-07-01,86,6,111,142,10125,149107,54760
300153613000,30-015-36130,MUNNYNTHABANK STATE 001H,2017-08-01,87,0,156,0,10125,149263,54760
300153613000,30-015-36130,MUNNYNTHABANK STATE 001H,2017-09-01,88,0,146,0,10125,149409,54760
300153613000,30-015-36130,MUNNYNTHABANK STATE 001H,2017-10-01,89,0,143,0,10125,149552,54760
300153613000,30-015-36130,MUNNYNTHABANK STATE 001H,2017-11-01,90,0,156,0,10125,149708,54760
300153613000,30-015-36130,MUNNYNTHABANK STATE 001H,2017-12-01,91,0,137,0,10125,149845,54760
300153613000,30-015-36130,MUNNYNTHABANK STATE 001H,2018-01-01,92,0,138,0,10125,149983,54760
300153613000,30-015-36130,MUNNYNTHABANK STATE 001H,2018-02-01,93,0,111,0,10125,150094,54760
300153613000,30-015-36130,MUNNYNTHABANK STATE 001H,2018-03-01,94,3,121,0,10128,150215,54760
300153613000,30-015-36130,MUNNYNTHABANK STATE 001H,2018-04-01,95,0,97,0,10128,150312,54760
300153613000,30-015-36130,MUNNYNTHABANK STATE 001H,2018-05-01,96,0,90,0,10128,150402,54760
300153613000,30-015-36130,MUNNYNTHABANK STATE 001H,2018-06-01,97,0,53,0,10128,150455,54760
300153613000,30-015-36130,MUNNYNTHABANK STATE 001H,2018-07-01,98,0,41,0,10128,150496,54760
300153613000,30-015-36130,MUNNYNTHABANK STATE 001H,2018-08-01,99,0,44,0,10128,150540,54760
300153613000,30-015-36130,MUNNYNTHABANK STATE 001H,2018-09-01,100,0,63,0,10128,150603,54760
300153613000,30-015-36130,MUNNYNTHABANK STATE 001H,2018-10-01,101,0,261,0,10128,150864,54760
300153613000,30-015-36130,MUNNYNTHABANK STATE 001H,2018-11-01,102,0,125,0,10128,150989,54760
300153613000,30-015-36130,MUNNYNTHABANK STATE 001H,2018-12-01,103,0,114,0,10128,151103,54760
300153613000,30-015-36130,MUNNYNTHABANK STATE 001H,2019-01-01,104,0,84,0,10128,151187,54760
300153613000,30-015-36130,MUNNYNTHABANK STATE 001H,2019-02-01,105,0,81,0,10128,151268,54760
300153613000,30-015-36130,MUNNYNTHABANK STATE 001H,2019-03-01,106,0,31,0,10128,151299,54760
300153613000,30-015-36130,MUNNYNTHABANK STATE 001H,2019-04-01,107,0,31,0,10128,151330,54760
300153613000,30-015-36130,MUNNYNTHABANK STATE 001H,2019-05-01,108,0,73,0,10128,151403,54760
300153613000,30-015-36130,MUNNYNTHABANK STATE 001H,2019-06-01,109,0,0,0,10128,151403,54760
300153613000,30-015-36130,MUNNYNTHABANK STATE 001H,2019-07-01,110,13,0,0,10141,151403,54760
300153613000,30-015-36130,MUNNYNTHABANK STATE 001H,2019-08-01,111,0,0,0,10141,151403,54760
300153613000,30-015-36130,MUNNYNTHABANK STATE 001H,2019-09-01,112,0,0,0,10141,151403,54760
300153613000,30-015-36130,MUNNYNTHABANK STATE 001H,2019-10-01,113,0,187,0,10141,151590,54760
300153613000,30-015-36130,MUNNYNTHABANK STATE 001H,2019-11-01,114,27,120,33,10168,151710,54793
300153613000,30-015-36130,MUNNYNTHABANK STATE 001H,2019-12-01,115,23,83,0,10191,151793,54793
300153613000,30-015-36130,MUNNYNTHABANK STATE 001H,2020-01-01,116,0,0,0,10191,151793,54793
300153613000,30-015-36130,MUNNYNTHABANK STATE 001H,2020-02-01,117,0,0,0,10191,151793,54793
300153613000,30-015-36130,MUNNYNTHABANK STATE 001H,2020-03-01,118,0,0,0,10191,151793,54793
300153613000,30-015-36130,MUNNYNTHABANK STATE 001H,2020-04-01,119,0,10,0,10191,151803,54793
300153613000,30-015-36130,MUNNYNTHABANK STATE 001H,2020-05-01,120,0,203,33,10191,152006,54826
300153613000,30-015-36130,MUNNYNTHABANK STATE 001H,2020-06-01,121,0,178,0,10191,152184,54826
300153613000,30-015-36130,MUNNYNTHABANK STATE 001H,2020-07-01,122,0,59,0,10191,152243,54826
300153613000,30-015-36130,MUNNYNTHABANK STATE 001H,2020-08-01,123,0,31,0,10191,152274,54826
300153613000,30-015-36130,MUNNYNTHABANK STATE 001H,2020-09-01,124,0,115,0,10191,152389,54826
300153613000,30-015-36130,MUNNYNTHABANK STATE 001H,2020-10-01,125,0,26,0,10191,152415,54826
300153613000,30-015-36130,MUNNYNTHABANK STATE 001H,2020-11-01,126,0,29,0,10191,152444,54826
300153613000,30-015-36130,MUNNYNTHABANK STATE 001H,2020-12-01,127,0,23,0,10191,152467,54826
300153613000,30-015-36130,MUNNYNTHABANK STATE 001H,2021-01-01,128,0,17,0,10191,152484,54826
300153613000,30-015-36130,MUNNYNTHABANK STATE 001H,2021-02-01,129,0,16,0,10191,152500,54826
300153613000,30-015-36130,MUNNYNTHABANK STATE 001H,2021-03-01,130,0,19,0,10191,152519,54826
300153613000,30-015-36130,MUNNYNTHABANK STATE 001H,2021-04-01,131,0,15,0,10191,152534,54826
300153613000,30-015-36130,MUNNYNTHABANK STATE 001H,2021-05-01,132,0,10,0,10191,152544,54826
300153613000,30-015-36130,MUNNYNTHABANK STATE 001H,2021-06-01,133,0,7,0,10191,152551,54826
300153613000,30-015-36130,MUNNYNTHABANK STATE 001H,2021-07-01,134,0,9,0,10191,152560,54826
300153613000,30-015-36130,MUNNYNTHABANK STATE 001H,2021-08-01,135,0,9,0,10191,152569,54826
300153613000,30-015-36130,MUNNYNTHABANK STATE 001H,2021-09-01,136,0,6,0,10191,152575,54826
300153613000,30-015-36130,MUNNYNTHABANK STATE 001H,2021-10-01,137,0,0,0,10191,152575,54826
300153613000,30-015-36130,MUNNYNTHABANK STATE 001H,2021-11-01,138,0,0,0,10191,152575,54826
300153613000,30-015-36130,MUNNYNTHABANK STATE 001H,2021-12-01,139,0,0,0,10191,152575,54826
300153613000,30-015-36130,MUNNYNTHABANK STATE 001H,2022-01-01,140,0,38,0,10191,152613,54826
300153613000,30-015-36130,MUNNYNTHABANK STATE 001H,2022-02-01,141,0,17,0,10191,152630,54826
300153613000,30-015-36130,MUNNYNTHABANK STATE 001H,2022-03-01,142,0,5,0,10191,152635,54826
300153613000,30-015-36130,MUNNYNTHABANK STATE 001H,2022-04-01,143,0,8,0,10191,152643,54826
300153613000,30-015-36130,MUNNYNTHABANK STATE 001H,2022-05-01,144,0,0,0,10191,152643,54826
300153613000,30-015-36130,MUNNYNTHABANK STATE 001H,2022-06-01,145,0,0,0,10191,152643,54826
300153613000,30-015-36130,MUNNYNTHABANK STATE 001H,2022-07-01,146,0,0,0,10191,152643,54826
300153613000,30-015-36130,MUNNYNTHABANK STATE 001H,2022-08-01,147,0,0,0,10191,152643,54826
300153613000,30-015-36130,MUNNYNTHABANK STATE 001H,2022-09-01,148,0,0,0,10191,152643,54826
300153613000,30-015-36130,MUNNYNTHABANK STATE 001H,2022-10-01,149,0,0,0,10191,152643,54826
300153613000,30-015-36130,MUNNYNTHABANK STATE 001H,2022-11-01,150,0,194,0,10191,152837,54826
300153613000,30-015-36130,MUNNYNTHABANK STATE 001H,2022-12-01,151,0,0,0,10191,152837,54826
300153613000,30-015-36130,MUNNYNTHABANK STATE 001H,2023-01-01,152,10,84,0,10201,152921,54826
300153613000,30-015-36130,MUNNYNTHABANK STATE 001H,2023-02-01,153,0,0,0,10201,152921,54826
300153613000,30-015-36130,MUNNYNTHABANK STATE 001H,2023-03-01,154,2,0,0,10203,152921,54826
300153613000,30-015-36130,MUNNYNTHABANK STATE 001H,2023-04-01,155,43,147,3,10246,153068,54829
300153613000,30-015-36130,MUNNYNTHABANK STATE 001H,2023-05-01,156,30,40,5,10276,153108,54834
300154918000,30-015-49180,PERDOMO 25 STATE COM 704H,2023-06-01,1,13262,27603,52277,13262,27603,52277
300154918000,30-015-49180,PERDOMO 25 STATE COM 704H,2023-07-01,2,33303,64920,126872,46565,92523,179149
300153257000,30-015-32570,EL PRESIDENTE STATE 002,2003-06-01,1,0,35997,6,0,35997,6
300153257000,30-015-32570,EL PRESIDENTE STATE 002,2003-07-01,2,0,0,0,0,35997,6
300153257000,30-015-32570,EL PRESIDENTE STATE 002,2003-08-01,3,0,132895,0,0,168892,6
300153257000,30-015-32570,EL PRESIDENTE STATE 002,2003-09-01,4,0,125930,334,0,294822,340
300153257000,30-015-32570,EL PRESIDENTE STATE 002,2003-10-01,5,0,76437,157,0,371259,497
300153257000,30-015-32570,EL PRESIDENTE STATE 002,2003-11-01,6,0,59141,135,0,430400,632
300153257000,30-015-32570,EL PRESIDENTE STATE 002,2003-12-01,7,0,49566,124,0,479966,756
300153257000,30-015-32570,EL PRESIDENTE STATE 002,2004-01-01,8,0,36287,33,0,516253,789
300153257000,30-015-32570,EL PRESIDENTE STATE 002,2004-02-01,9,0,50689,52,0,566942,841
300153257000,30-015-32570,EL PRESIDENTE STATE 002,2004-03-01,10,0,43747,124,0,610689,965
300153257000,30-015-32570,EL PRESIDENTE STATE 002,2004-04-01,11,0,32529,150,0,643218,1115
300153257000,30-015-32570,EL PRESIDENTE STATE 002,2004-05-01,12,0,38185,47,0,681403,1162
300153257000,30-015-32570,EL PRESIDENTE STATE 002,2004-06-01,13,0,36097,78,0,717500,1240
300153257000,30-015-32570,EL PRESIDENTE STATE 002,2004-07-01,14,0,34745,89,0,752245,1329
300153257000,30-015-32570,EL PRESIDENTE STATE 002,2004-08-01,15,0,34737,77,0,786982,1406
300153257000,30-015-32570,EL PRESIDENTE STATE 002,2004-09-01,16,0,26965,56,0,813947,1462
300153257000,30-015-32570,EL PRESIDENTE STATE 002,2004-10-01,17,0,30914,36,0,844861,1498
300153257000,30-015-32570,EL PRESIDENTE STATE 002,2004-11-01,18,0,24280,4,0,869141,1502
300153257000,30-015-32570,EL PRESIDENTE STATE 002,2004-12-01,19,0,27265,45,0,896406,1547
300153257000,30-015-32570,EL PRESIDENTE STATE 002,2005-01-01,20,0,28330,22,0,924736,1569
300153257000,30-015-32570,EL PRESIDENTE STATE 002,2005-02-01,21,0,23329,49,0,948065,1618
300153257000,30-015-32570,EL PRESIDENTE STATE 002,2005-03-01,22,0,24554,64,0,972619,1682
300153257000,30-015-32570,EL PRESIDENTE STATE 002,2005-04-01,23,0,18883,58,0,991502,1740
300153257000,30-015-32570,EL PRESIDENTE STATE 002,2005-05-01,24,0,24729,60,0,1016231,1800
300153257000,30-015-32570,EL PRESIDENTE STATE 002,2005-06-01,25,0,8223,25,0,1024454,1825
300153257000,30-015-32570,EL PRESIDENTE STATE 002,2005-07-01,26,0,10918,29,0,1035372,1854
300153257000,30-015-32570,EL PRESIDENTE STATE 002,2005-08-01,27,8,22263,51,8,1057635,1905
300153257000,30-015-32570,EL PRESIDENTE STATE 002,2005-09-01,28,0,14458,91,8,1072093,1996
300153257000,30-015-32570,EL PRESIDENTE STATE 002,2005-10-01,29,0,19478,54,8,1091571,2050
300153257000,30-015-32570,EL PRESIDENTE STATE 002,2005-11-01,30,0,14704,43,8,1106275,2093
300153257000,30-015-32570,EL PRESIDENTE STATE 002,2005-12-01,31,0,15143,58,8,1121418,2151
300153257000,30-015-32570,EL PRESIDENTE STATE 002,2006-01-01,32,0,18439,62,8,1139857,2213
300153257000,30-015-32570,EL PRESIDENTE STATE 002,2006-02-01,33,0,15399,50,8,1155256,2263
300153257000,30-015-32570,EL PRESIDENTE STATE 002,2006-03-01,34,0,16667,66,8,1171923,2329
300153257000,30-015-32570,EL PRESIDENTE STATE 002,2006-04-01,35,0,11684,62,8,1183607,2391
300153257000,30-015-32570,EL PRESIDENTE STATE 002,2006-05-01,36,0,13864,69,8,1197471,2460
300153257000,30-015-32570,EL PRESIDENTE STATE 002,2006-06-01,37,0,12174,42,8,1209645,2502
300153257000,30-015-32570,EL PRESIDENTE STATE 002,2006-07-01,38,0,10109,25,8,1219754,2527
300153257000,30-015-32570,EL PRESIDENTE STATE 002,2006-08-01,39,0,10732,46,8,1230486,2573
300153257000,30-015-32570,EL PRESIDENTE STATE 002,2006-09-01,40,0,12290,33,8,1242776,2606
300153257000,30-015-32570,EL PRESIDENTE STATE 002,2006-10-01,41,0,8484,31,8,1251260,2637
300153257000,30-015-32570,EL PRESIDENTE STATE 002,2006-11-01,42,0,7381,21,8,1258641,2658
300153257000,30-015-32570,EL PRESIDENTE STATE 002,2006-12-01,43,0,6116,12,8,1264757,2670
300153257000,30-015-32570,EL PRESIDENTE STATE 002,2007-01-01,44,0,5308,22,8,1270065,2692
300153257000,30-015-32570,EL PRESIDENTE STATE 002,2007-02-01,45,0,7146,21,8,1277211,2713
300153257000,30-015-32570,EL PRESIDENTE STATE 002,2007-03-01,46,0,6424,14,8,1283635,2727
300153257000,30-015-32570,EL PRESIDENTE STATE 002,2007-04-01,47,0,5510,1,8,1289145,2728
300153257000,30-015-32570,EL PRESIDENTE STATE 002,2007-05-01,48,0,6214,3,8,1295359,2731
300153257000,30-015-32570,EL PRESIDENTE STATE 002,2007-06-01,49,0,6423,4,8,1301782,2735
300153257000,30-015-32570,EL PRESIDENTE STATE 002,2007-07-01,50,0,5746,12,8,1307528,2747
300153257000,30-015-32570,EL PRESIDENTE STATE 002,2007-08-01,51,0,5337,18,8,1312865,2765
300153257000,30-015-32570,EL PRESIDENTE STATE 002,2007-09-01,52,0,5128,6,8,1317993,2771
300153257000,30-015-32570,EL PRESIDENTE STATE 002,2007-10-01,53,0,4656,18,8,1322649,2789
300153257000,30-015-32570,EL PRESIDENTE STATE 002,2007-11-01,54,0,6119,30,8,1328768,2819
300153257000,30-015-32570,EL PRESIDENTE STATE 002,2007-12-01,55,0,12133,35,8,1340901,2854
300153257000,30-015-32570,EL PRESIDENTE STATE 002,2008-01-01,56,0,9850,22,8,1350751,2876
300153257000,30-015-32570,EL PRESIDENTE STATE 002,2008-02-01,57,0,10169,27,8,1360920,2903
300153257000,30-015-32570,EL PRESIDENTE STATE 002,2008-03-01,58,0,10879,27,8,1371799,2930
300153257000,30-015-32570,EL PRESIDENTE STATE 002,2008-04-01,59,0,10249,50,8,1382048,2980
300153257000,30-015-32570,EL PRESIDENTE STATE 002,2008-05-01,60,0,10494,30,8,1392542,3010
300153257000,30-015-32570,EL PRESIDENTE STATE 002,2008-06-01,61,0,9478,29,8,1402020,3039
300153257000,30-015-32570,EL PRESIDENTE STATE 002,2008-07-01,62,0,9860,25,8,1411880,3064
300153257000,30-015-32570,EL PRESIDENTE STATE 002,2008-08-01,63,0,8077,54,8,1419957,3118
300153257000,30-015-32570,EL PRESIDENTE STATE 002,2008-09-01,64,0,7436,60,8,1427393,3178
300153257000,30-015-32570,EL PRESIDENTE STATE 002,2008-10-01,65,0,6860,28,8,1434253,3206
300153257000,30-015-32570,EL PRESIDENTE STATE 002,2008-11-01,66,0,5910,17,8,1440163,3223
300153257000,30-015-32570,EL PRESIDENTE STATE 002,2008-12-01,67,0,4158,37,8,1444321,3260
300153257000,30-015-32570,EL PRESIDENTE STATE 002,2009-01-01,68,0,2323,16,8,1446644,3276
300153257000,30-015-32570,EL PRESIDENTE STATE 002,2009-02-01,69,0,5834,35,8,1452478,3311
300153257000,30-015-32570,EL PRESIDENTE STATE 002,2009-03-01,70,0,4076,31,8,1456554,3342
300153257000,30-015-32570,EL PRESIDENTE STATE 002,2009-04-01,71,0,5863,30,8,1462417,3372
300153257000,30-015-32570,EL PRESIDENTE STATE 002,2009-05-01,72,0,6490,31,8,1468907,3403
300153257000,30-015-32570,EL PRESIDENTE STATE 002,2009-06-01,73,0,6584,30,8,1475491,3433
300153257000,30-015-32570,EL PRESIDENTE STATE 002,2009-07-01,74,0,5334,50,8,1480825,3483
300153257000,30-015-32570,EL PRESIDENTE STATE 002,2009-08-01,75,0,5351,62,8,1486176,3545
300153257000,30-015-32570,EL PRESIDENTE STATE 002,2009-09-01,76,0,5175,62,8,1491351,3607
300153257000,30-015-32570,EL PRESIDENTE STATE 002,2009-10-01,77,0,4746,62,8,1496097,3669
300153257000,30-015-32570,EL PRESIDENTE STATE 002,2009-11-01,78,0,4925,56,8,1501022,3725
300153257000,30-015-32570,EL PRESIDENTE STATE 002,2009-12-01,79,0,6220,61,8,1507242,3786
300153257000,30-015-32570,EL PRESIDENTE STATE 002,2010-01-01,80,0,3092,44,8,1510334,3830
300153257000,30-015-32570,EL PRESIDENTE STATE 002,2010-02-01,81,0,1912,57,8,1512246,3887
300153257000,30-015-32570,EL PRESIDENTE STATE 002,2010-03-01,82,0,2194,50,8,1514440,3937
300153257000,30-015-32570,EL PRESIDENTE STATE 002,2010-04-01,83,0,767,9,8,1515207,3946
300153257000,30-015-32570,EL PRESIDENTE STATE 002,2010-05-01,84,0,354,5,8,1515561,3951
300153257000,30-015-32570,EL PRESIDENTE STATE 002,2010-06-01,85,0,0,0,8,1515561,3951
300153257000,30-015-32570,EL PRESIDENTE STATE 002,2010-07-01,86,0,0,0,8,1515561,3951
300153257000,30-015-32570,EL PRESIDENTE STATE 002,2010-08-01,87,0,0,0,8,1515561,3951
300153257000,30-015-32570,EL PRESIDENTE STATE 002,2010-09-01,88,0,33257,0,8,1548818,3951
300153257000,30-015-32570,EL PRESIDENTE STATE 002,2010-10-01,89,0,36890,0,8,1585708,3951
300153257000,30-015-32570,EL PRESIDENTE STATE 002,2010-11-01,90,0,357,0,8,1586065,3951
300153257000,30-015-32570,EL PRESIDENTE STATE 002,2010-12-01,91,0,57,0,8,1586122,3951
300153257000,30-015-32570,EL PRESIDENTE STATE 002,2011-01-01,92,0,39,0,8,1586161,3951
300153257000,30-015-32570,EL PRESIDENTE STATE 002,2011-02-01,93,0,22,0,8,1586183,3951
300153257000,30-015-32570,EL PRESIDENTE STATE 002,2011-03-01,94,0,6,0,8,1586189,3951
300153257000,30-015-32570,EL PRESIDENTE STATE 002,2011-04-01,95,0,1,0,8,1586190,3951
300153257000,30-015-32570,EL PRESIDENTE STATE 002,2011-05-01,96,0,11,0,8,1586201,3951
300153257000,30-015-32570,EL PRESIDENTE STATE 002,2011-06-01,97,0,0,0,8,1586201,3951
300153257000,30-015-32570,EL PRESIDENTE STATE 002,2011-07-01,98,0,0,0,8,1586201,3951
300153257000,30-015-32570,EL PRESIDENTE STATE 002,2011-08-01,99,0,0,0,8,1586201,3951
300153257000,30-015-32570,EL PRESIDENTE STATE 002,2011-09-01,100,0,1,0,8,1586202,3951
300153257000,30-015-32570,EL PRESIDENTE STATE 002,2011-10-01,101,0,2,0,8,1586204,3951
300153257000,30-015-32570,EL PRESIDENTE STATE 002,2011-11-01,102,0,48,0,8,1586252,3951
300153257000,30-015-32570,EL PRESIDENTE STATE 002,2011-12-01,103,0,26,0,8,1586278,3951
300153257000,30-015-32570,EL PRESIDENTE STATE 002,2012-01-01,104,0,23,0,8,1586301,3951
300153257000,30-015-32570,EL PRESIDENTE STATE 002,2012-02-01,105,0,42,0,8,1586343,3951
300153257000,30-015-32570,EL PRESIDENTE STATE 002,2012-03-01,106,0,40,0,8,1586383,3951
300153257000,30-015-32570,EL PRESIDENTE STATE 002,2012-04-01,107,0,12,0,8,1586395,3951
300153257000,30-015-32570,EL PRESIDENTE STATE 002,2012-05-01,108,0,10,0,8,1586405,3951
300153257000,30-015-32570,EL PRESIDENTE STATE 002,2012-06-01,109,0,6,0,8,1586411,3951
300153257000,30-015-32570,EL PRESIDENTE STATE 002,2012-07-01,110,0,7,0,8,1586418,3951
300153257000,30-015-32570,EL PRESIDENTE STATE 002,2012-08-01,111,0,0,0,8,1586418,3951
300153257000,30-015-32570,EL PRESIDENTE STATE 002,2012-09-01,112,0,2,0,8,1586420,3951
300153257000,30-015-32570,EL PRESIDENTE STATE 002,2012-10-01,113,0,0,0,8,1586420,3951
300153257000,30-015-32570,EL PRESIDENTE STATE 002,2012-11-01,114,0,0,0,8,1586420,3951
300153257000,30-015-32570,EL PRESIDENTE STATE 002,2012-12-01,115,0,50,0,8,1586470,3951
300153257000,30-015-32570,EL PRESIDENTE STATE 002,2013-01-01,116,0,8,0,8,1586478,3951
300153257000,30-015-32570,EL PRESIDENTE STATE 002,2013-02-01,117,0,1,0,8,1586479,3951
300153257000,30-015-32570,EL PRESIDENTE STATE 002,2013-03-01,118,0,14,0,8,1586493,3951
300153257000,30-015-32570,EL PRESIDENTE STATE 002,2013-04-01,119,0,0,0,8,1586493,3951
300153257000,30-015-32570,EL PRESIDENTE STATE 002,2013-05-01,120,0,0,0,8,1586493,3951
300153257000,30-015-32570,EL PRESIDENTE STATE 002,2013-06-01,121,0,2,0,8,1586495,3951
300153257000,30-015-32570,EL PRESIDENTE STATE 002,2013-07-01,122,0,11,0,8,1586506,3951
300153257000,30-015-32570,EL PRESIDENTE STATE 002,2013-08-01,123,0,2,0,8,1586508,3951
300153257000,30-015-32570,EL PRESIDENTE STATE 002,2013-09-01,124,0,5,0,8,1586513,3951
300153257000,30-015-32570,EL PRESIDENTE STATE 002,2013-10-01,125,0,3,0,8,1586516,3951
300153257000,30-015-32570,EL PRESIDENTE STATE 002,2013-11-01,126,0,0,0,8,1586516,3951
300153257000,30-015-32570,EL PRESIDENTE STATE 002,2013-12-01,127,0,0,0,8,1586516,3951
300153257000,30-015-32570,EL PRESIDENTE STATE 002,2014-01-01,128,0,0,0,8,1586516,3951
300153257000,30-015-32570,EL PRESIDENTE STATE 002,2014-02-01,129,0,0,0,8,1586516,3951
300153257000,30-015-32570,EL PRESIDENTE STATE 002,2014-03-01,130,0,0,0,8,1586516,3951
300153257000,30-015-32570,EL PRESIDENTE STATE 002,2014-04-01,131,0,0,0,8,1586516,3951
300153257000,30-015-32570,EL PRESIDENTE STATE 002,2014-05-01,132,0,0,0,8,1586516,3951
300153257000,30-015-32570,EL PRESIDENTE STATE 002,2014-06-01,133,0,0,0,8,1586516,3951
300153257000,30-015-32570,EL PRESIDENTE STATE 002,2014-07-01,134,0,5,0,8,1586521,3951
300153257000,30-015-32570,EL PRESIDENTE STATE 002,2014-08-01,135,0,3,0,8,1586524,3951
300153257000,30-015-32570,EL PRESIDENTE STATE 002,2014-09-01,136,0,1,0,8,1586525,3951
300153257000,30-015-32570,EL PRESIDENTE STATE 002,2014-10-01,137,0,0,0,8,1586525,3951
300153257000,30-015-32570,EL PRESIDENTE STATE 002,2014-11-01,138,0,4,0,8,1586529,3951
300153257000,30-015-32570,EL PRESIDENTE STATE 002,2014-12-01,139,0,6,0,8,1586535,3951
300153257000,30-015-32570,EL PRESIDENTE STATE 002,2015-01-01,140,0,7,0,8,1586542,3951
300153257000,30-015-32570,EL PRESIDENTE STATE 002,2015-02-01,141,0,3,0,8,1586545,3951
300153257000,30-015-32570,EL PRESIDENTE STATE 002,2015-03-01,142,0,6,0,8,1586551,3951
300153257000,30-015-32570,EL PRESIDENTE STATE 002,2015-04-01,143,0,6,0,8,1586557,3951
300153257000,30-015-32570,EL PRESIDENTE STATE 002,2015-05-01,144,0,4,0,8,1586561,3951
300153257000,30-015-32570,EL PRESIDENTE STATE 002,2015-06-01,145,0,5,0,8,1586566,3951
300153257000,30-015-32570,EL PRESIDENTE STATE 002,2015-07-01,146,0,3,0,8,1586569,3951
300153257000,30-015-32570,EL PRESIDENTE STATE 002,2015-08-01,147,0,3,0,8,1586572,3951
300153257000,30-015-32570,EL PRESIDENTE STATE 002,2015-09-01,148,0,4,0,8,1586576,3951
300153257000,30-015-32570,EL PRESIDENTE STATE 002,2015-10-01,149,0,3,0,8,1586579,3951
300153257000,30-015-32570,EL PRESIDENTE STATE 002,2015-11-01,150,0,2,0,8,1586581,3951
300153257000,30-015-32570,EL PRESIDENTE STATE 002,2015-12-01,151,0,1,0,8,1586582,3951
300153257000,30-015-32570,EL PRESIDENTE STATE 002,2016-01-01,152,0,0,0,8,1586582,3951
300153257000,30-015-32570,EL PRESIDENTE STATE 002,2016-02-01,153,20,0,0,28,1586582,3951
300153257000,30-015-32570,EL PRESIDENTE STATE 002,2016-03-01,154,0,0,7,28,1586582,3958
300153257000,30-015-32570,EL PRESIDENTE STATE 002,2016-04-01,155,0,0,0,28,1586582,3958
300153257000,30-015-32570,EL PRESIDENTE STATE 002,2016-05-01,156,0,0,0,28,1586582,3958
300153257000,30-015-32570,EL PRESIDENTE STATE 002,2016-06-01,157,0,0,0,28,1586582,3958
300153257000,30-015-32570,EL PRESIDENTE STATE 002,2016-07-01,158,0,0,0,28,1586582,3958
300153257000,30-015-32570,EL PRESIDENTE STATE 002,2016-08-01,159,0,3,0,28,1586585,3958
300153257000,30-015-32570,EL PRESIDENTE STATE 002,2016-09-01,160,0,0,0,28,1586585,3958
300153257000,30-015-32570,EL PRESIDENTE STATE 002,2016-10-01,161,0,0,0,28,1586585,3958
300153257000,30-015-32570,EL PRESIDENTE STATE 002,2016-11-01,162,0,0,0,28,1586585,3958
300153257000,30-015-32570,EL PRESIDENTE STATE 002,2016-12-01,163,0,0,0,28,1586585,3958
300153257000,30-015-32570,EL PRESIDENTE STATE 002,2017-01-01,164,0,0,0,28,1586585,3958
300153257000,30-015-32570,EL PRESIDENTE STATE 002,2017-02-01,165,0,0,0,28,1586585,3958
300153257000,30-015-32570,EL PRESIDENTE STATE 002,2017-03-01,166,0,0,0,28,1586585,3958
300153257000,30-015-32570,EL PRESIDENTE STATE 002,2017-04-01,167,0,0,0,28,1586585,3958
300153257000,30-015-32570,EL PRESIDENTE STATE 002,2017-05-01,168,0,0,0,28,1586585,3958
300153257000,30-015-32570,EL PRESIDENTE STATE 002,2017-06-01,169,0,0,0,28,1586585,3958
300153257000,30-015-32570,EL PRESIDENTE STATE 002,2017-07-01,170,0,1,0,28,1586586,3958
300153257000,30-015-32570,EL PRESIDENTE STATE 002,2017-08-01,171,0,1,0,28,1586587,3958
300153257000,30-015-32570,EL PRESIDENTE STATE 002,2017-09-01,172,0,0,0,28,1586587,3958
300153257000,30-015-32570,EL PRESIDENTE STATE 002,2017-10-01,173,0,1,0,28,1586588,3958
300153257000,30-015-32570,EL PRESIDENTE STATE 002,2017-11-01,174,0,10,0,28,1586598,3958
300153257000,30-015-32570,EL PRESIDENTE STATE 002,2017-12-01,175,0,0,0,28,1586598,3958
300153257000,30-015-32570,EL PRESIDENTE STATE 002,2018-01-01,176,0,0,0,28,1586598,3958
300153257000,30-015-32570,EL PRESIDENTE STATE 002,2018-02-01,177,0,0,0,28,1586598,3958
300153257000,30-015-32570,EL PRESIDENTE STATE 002,2018-03-01,178,0,27,0,28,1586625,3958
300154285200,30-015-42852,WEST LOVING 12 W2EH STATE COM 001H,2017-05-01,1,8802,43728,45408,8802,43728,45408
300154285200,30-015-42852,WEST LOVING 12 W2EH STATE COM 001H,2017-06-01,2,19134,117436,89464,27936,161164,134872
300154285200,30-015-42852,WEST LOVING 12 W2EH STATE COM 001H,2017-07-01,3,12441,81445,52706,40377,242609,187578
300154285200,30-015-42852,WEST LOVING 12 W2EH STATE COM 001H,2017-08-01,4,11635,81125,45468,52012,323734,233046
300154285200,30-015-42852,WEST LOVING 12 W2EH STATE COM 001H,2017-09-01,5,8532,61886,32809,60544,385620,265855
300154285200,30-015-42852,WEST LOVING 12 W2EH STATE COM 001H,2017-10-01,6,7389,53819,27879,67933,439439,293734
300154285200,30-015-42852,WEST LOVING 12 W2EH STATE COM 001H,2017-11-01,7,5407,39065,19784,73340,478504,313518
300154285200,30-015-42852,WEST LOVING 12 W2EH STATE COM 001H,2017-12-01,8,5094,35657,17769,78434,514161,331287
300154285200,30-015-42852,WEST LOVING 12 W2EH STATE COM 001H,2018-01-01,9,3116,19948,6225,81550,534109,337512
300154285200,30-015-42852,WEST LOVING 12 W2EH STATE COM 001H,2018-02-01,10,3825,25379,12467,85375,559488,349979
300154285200,30-015-42852,WEST LOVING 12 W2EH STATE COM 001H,2018-03-01,11,4035,26611,13183,89410,586099,363162
300154285200,30-015-42852,WEST LOVING 12 W2EH STATE COM 001H,2018-04-01,12,3440,23633,11559,92850,609732,374721
300154285200,30-015-42852,WEST LOVING 12 W2EH STATE COM 001H,2018-05-01,13,3016,20954,11979,95866,630686,386700
300154285200,30-015-42852,WEST LOVING 12 W2EH STATE COM 001H,2018-06-01,14,3402,28521,17065,99268,659207,403765
300154285200,30-015-42852,WEST LOVING 12 W2EH STATE COM 001H,2018-07-01,15,3344,29743,18116,102612,688950,421881
300154285200,30-015-42852,WEST LOVING 12 W2EH STATE COM 001H,2018-08-01,16,3313,30048,16256,105925,718998,438137
300154285200,30-015-42852,WEST LOVING 12 W2EH STATE COM 001H,2018-09-01,17,2989,27614,14126,108914,746612,452263
300154285200,30-015-42852,WEST LOVING 12 W2EH STATE COM 001H,2018-10-01,18,2932,27390,13658,111846,774002,465921
300154285200,30-015-42852,WEST LOVING 12 W2EH STATE COM 001H,2018-11-01,19,2665,25444,12294,114511,799446,478215
300154285200,30-015-42852,WEST LOVING 12 W2EH STATE COM 001H,2018-12-01,20,1122,10802,5105,115633,810248,483320
300154285200,30-015-42852,WEST LOVING 12 W2EH STATE COM 001H,2019-01-01,21,3508,30553,28389,119141,840801,511709
300154285200,30-015-42852,WEST LOVING 12 W2EH STATE COM 001H,2019-02-01,22,2493,21642,39513,121634,862443,551222
300154285200,30-015-42852,WEST LOVING 12 W2EH STATE COM 001H,2019-03-01,23,1365,9376,12563,122999,871819,563785
300154285200,30-015-42852,WEST LOVING 12 W2EH STATE COM 001H,2019-04-01,24,332,1864,3006,123331,873683,566791
300154285200,30-015-42852,WEST LOVING 12 W2EH STATE COM 001H,2019-05-01,25,831,4847,3028,124162,878530,569819
300154285200,30-015-42852,WEST LOVING 12 W2EH STATE COM 001H,2019-06-01,26,0,43,0,124162,878573,569819
300154285200,30-015-42852,WEST LOVING 12 W2EH STATE COM 001H,2019-07-01,27,1229,6740,5916,125391,885313,575735
300154285200,30-015-42852,WEST LOVING 12 W2EH STATE COM 001H,2019-08-01,28,1359,8437,16254,126750,893750,591989
300154285200,30-015-42852,WEST LOVING 12 W2EH STATE COM 001H,2019-09-01,29,2326,15614,24026,129076,909364,616015
300154285200,30-015-42852,WEST LOVING 12 W2EH STATE COM 001H,2019-10-01,30,1985,15425,16516,131061,924789,632531
300154285200,30-015-42852,WEST LOVING 12 W2EH STATE COM 001H,2019-11-01,31,1877,16462,15677,132938,941251,648208
300154285200,30-015-42852,WEST LOVING 12 W2EH STATE COM 001H,2019-12-01,32,2423,20925,19356,135361,962176,667564
300154285200,30-015-42852,WEST LOVING 12 W2EH STATE COM 001H,2020-01-01,33,2312,20628,16094,137673,982804,683658
300154285200,30-015-42852,WEST LOVING 12 W2EH STATE COM 001H,2020-02-01,34,1862,16270,11969,139535,999074,695627
300154285200,30-015-42852,WEST LOVING 12 W2EH STATE COM 001H,2020-03-01,35,1951,17512,12091,141486,1016586,707718
300154285200,30-015-42852,WEST LOVING 12 W2EH STATE COM 001H,2020-04-01,36,102,1126,720,141588,1017712,708438
300154285200,30-015-42852,WEST LOVING 12 W2EH STATE COM 001H,2020-05-01,37,463,4484,362,142051,1022196,708800
300154285200,30-015-42852,WEST LOVING 12 W2EH STATE COM 001H,2020-06-01,38,2297,18252,14137,144348,1040448,722937
300154285200,30-015-42852,WEST LOVING 12 W2EH STATE COM 001H,2020-07-01,39,1752,16023,11487,146100,1056471,734424
300154285200,30-015-42852,WEST LOVING 12 W2EH STATE COM 001H,2020-08-01,40,1835,16771,11210,147935,1073242,745634
300154285200,30-015-42852,WEST LOVING 12 W2EH STATE COM 001H,2020-09-01,41,1715,16042,10190,149650,1089284,755824
300154285200,30-015-42852,WEST LOVING 12 W2EH STATE COM 001H,2020-10-01,42,1632,14894,9408,151282,1104178,765232
300154285200,30-015-42852,WEST LOVING 12 W2EH STATE COM 001H,2020-11-01,43,1578,15121,9498,152860,1119299,774730
300154285200,30-015-42852,WEST LOVING 12 W2EH STATE COM 001H,2020-12-01,44,1361,12505,7163,154221,1131804,781893
300154285200,30-015-42852,WEST LOVING 12 W2EH STATE COM 001H,2021-01-01,45,1429,13154,7786,155650,1144958,789679
300154285200,30-015-42852,WEST LOVING 12 W2EH STATE COM 001H,2021-02-01,46,1276,10443,6642,156926,1155401,796321
300154285200,30-015-42852,WEST LOVING 12 W2EH STATE COM 001H,2021-03-01,47,1561,14155,8846,158487,1169556,805167
300154285200,30-015-42852,WEST LOVING 12 W2EH STATE COM 001H,2021-04-01,48,1395,12566,8409,159882,1182122,813576
300154285200,30-015-42852,WEST LOVING 12 W2EH STATE COM 001H,2021-05-01,49,1404,13286,9036,161286,1195408,822612
300154285200,30-015-42852,WEST LOVING 12 W2EH STATE COM 001H,2021-06-01,50,1375,13244,11896,162661,1208652,834508
300154285200,30-015-42852,WEST LOVING 12 W2EH STATE COM 001H,2021-07-01,51,1097,8219,10373,163758,1216871,844881
300154285200,30-015-42852,WEST LOVING 12 W2EH STATE COM 001H,2021-08-01,52,953,8604,10240,164711,1225475,855121
300154285200,30-015-42852,WEST LOVING 12 W2EH STATE COM 001H,2021-09-01,53,823,8418,18364,165534,1233893,873485
300154285200,30-015-42852,WEST LOVING 12 W2EH STATE COM 001H,2021-10-01,54,953,9840,15907,166487,1243733,889392
300154285200,30-015-42852,WEST LOVING 12 W2EH STATE COM 001H,2021-11-01,55,1042,11061,9289,167529,1254794,898681
300154285200,30-015-42852,WEST LOVING 12 W2EH STATE COM 001H,2021-12-01,56,1029,10695,7327,168558,1265489,906008
300154285200,30-015-42852,WEST LOVING 12 W2EH STATE COM 001H,2022-01-01,57,948,9788,7288,169506,1275277,913296
300154285200,30-015-42852,WEST LOVING 12 W2EH STATE COM 001H,2022-02-01,58,793,6687,5486,170299,1281964,918782
300154285200,30-015-42852,WEST LOVING 12 W2EH STATE COM 001H,2022-03-01,59,843,9939,6442,171142,1291903,925224
300154285200,30-015-42852,WEST LOVING 12 W2EH STATE COM 001H,2022-04-01,60,475,6017,2789,171617,1297920,928013
300154285200,30-015-42852,WEST LOVING 12 W2EH STATE COM 001H,2022-05-01,61,640,8156,5750,172257,1306076,933763
300154285200,30-015-42852,WEST LOVING 12 W2EH STATE COM 001H,2022-06-01,62,1059,8741,6920,173316,1314817,940683
300154285200,30-015-42852,WEST LOVING 12 W2EH STATE COM 001H,2022-07-01,63,1006,10519,6358,174322,1325336,947041
300154285200,30-015-42852,WEST LOVING 12 W2EH STATE COM 001H,2022-08-01,64,865,10933,4643,175187,1336269,951684
300154285200,30-015-42852,WEST LOVING 12 W2EH STATE COM 001H,2022-09-01,65,940,11608,6039,176127,1347877,957723
300154285200,30-015-42852,WEST LOVING 12 W2EH STATE COM 001H,2022-10-01,66,912,11729,7408,177039,1359606,965131
300154285200,30-015-42852,WEST LOVING 12 W2EH STATE COM 001H,2022-11-01,67,845,11106,7291,177884,1370712,972422
300154285200,30-015-42852,WEST LOVING 12 W2EH STATE COM 001H,2022-12-01,68,927,12009,8046,178811,1382721,980468
300154285200,30-015-42852,WEST LOVING 12 W2EH STATE COM 001H,2023-01-01,69,298,4166,3152,179109,1386887,983620
300154285200,30-015-42852,WEST LOVING 12 W2EH STATE COM 001H,2023-02-01,70,805,10671,6489,179914,1397558,990109
300154285200,30-015-42852,WEST LOVING 12 W2EH STATE COM 001H,2023-03-01,71,821,8585,9092,180735,1406143,999201
300154285200,30-015-42852,WEST LOVING 12 W2EH STATE COM 001H,2023-04-01,72,884,9940,9506,181619,1416083,1008707
300154285200,30-015-42852,WEST LOVING 12 W2EH STATE COM 001H,2023-05-01,73,635,9416,6819,182254,1425499,1015526
300154285200,30-015-42852,WEST LOVING 12 W2EH STATE COM 001H,2023-06-01,74,817,11034,8741,183071,1436533,1024267
300154285200,30-015-42852,WEST LOVING 12 W2EH STATE COM 001H,2023-07-01,75,852,11964,8635,183923,1448497,1032902
300154468200,30-015-44682,DAVID EDELSTEIN STATE COM 203H,2018-08-01,1,40532,64762,112901,40532,64762,112901
300154468200,30-015-44682,DAVID EDELSTEIN STATE COM 203H,2018-09-01,2,26142,46125,66663,66674,110887,179564
300154468200,30-015-44682,DAVID EDELSTEIN STATE COM 203H,2018-10-01,3,16618,26378,44561,83292,137265,224125
300154468200,30-015-44682,DAVID EDELSTEIN STATE COM 203H,2018-11-01,4,24469,40211,47674,107761,177476,271799
300154468200,30-015-44682,DAVID EDELSTEIN STATE COM 203H,2018-12-01,5,11092,18737,26308,118853,196213,298107
300154468200,30-015-44682,DAVID EDELSTEIN STATE COM 203H,2019-01-01,6,9308,27064,50975,128161,223277,349082
300154468200,30-015-44682,DAVID EDELSTEIN STATE COM 203H,2019-02-01,7,19320,39160,64652,147481,262437,413734
300154468200,30-015-44682,DAVID EDELSTEIN STATE COM 203H,2019-03-01,8,26777,46990,74458,174258,309427,488192
300154468200,30-015-44682,DAVID EDELSTEIN STATE COM 203H,2019-04-01,9,25997,50838,83663,200255,360265,571855
300154468200,30-015-44682,DAVID EDELSTEIN STATE COM 203H,2019-05-01,10,22333,43698,65766,222588,403963,637621
300154468200,30-015-44682,DAVID EDELSTEIN STATE COM 203H,2019-06-01,11,17544,34692,51408,240132,438655,689029
300154468200,30-015-44682,DAVID EDELSTEIN STATE COM 203H,2019-07-01,12,18598,37172,52082,258730,475827,741111
300154468200,30-015-44682,DAVID EDELSTEIN STATE COM 203H,2019-08-01,13,16287,39061,52220,275017,514888,793331
300154468200,30-015-44682,DAVID EDELSTEIN STATE COM 203H,2019-09-01,14,15198,41505,54108,290215,556393,847439
300154468200,30-015-44682,DAVID EDELSTEIN STATE COM 203H,2019-10-01,15,15187,36556,49527,305402,592949,896966
300154468200,30-015-44682,DAVID EDELSTEIN STATE COM 203H,2019-11-01,16,13975,34414,45922,319377,627363,942888
300154468200,30-015-44682,DAVID EDELSTEIN STATE COM 203H,2019-12-01,17,14639,33250,44584,334016,660613,987472
300154468200,30-015-44682,DAVID EDELSTEIN STATE COM 203H,2020-01-01,18,13521,33183,42777,347537,693796,1030249
300154468200,30-015-44682,DAVID EDELSTEIN STATE COM 203H,2020-02-01,19,10968,25995,36218,358505,719791,1066467
300154468200,30-015-44682,DAVID EDELSTEIN STATE COM 203H,2020-03-01,20,8929,20504,26719,367434,740295,1093186
300154468200,30-015-44682,DAVID EDELSTEIN STATE COM 203H,2020-04-01,21,11009,32831,36365,378443,773126,1129551
300154468200,30-015-44682,DAVID EDELSTEIN STATE COM 203H,2020-05-01,22,11040,35855,39693,389483,808981,1169244
300154468200,30-015-44682,DAVID EDELSTEIN STATE COM 203H,2020-06-01,23,10646,32989,37424,400129,841970,1206668
300154468200,30-015-44682,DAVID EDELSTEIN STATE COM 203H,2020-07-01,24,10581,34970,39722,410710,876940,1246390
300154468200,30-015-44682,DAVID EDELSTEIN STATE COM 203H,2020-08-01,25,9082,29810,36509,419792,906750,1282899
300154468200,30-015-44682,DAVID EDELSTEIN STATE COM 203H,2020-09-01,26,8810,32052,35494,428602,938802,1318393
300154468200,30-015-44682,DAVID EDELSTEIN STATE COM 203H,2020-10-01,27,8442,31805,33254,437044,970607,1351647
300154468200,30-015-44682,DAVID EDELSTEIN STATE COM 203H,2020-11-01,28,8172,29075,29030,445216,999682,1380677
300154468200,30-015-44682,DAVID EDELSTEIN STATE COM 203H,2020-12-01,29,7242,31223,29658,452458,1030905,1410335
300154468200,30-015-44682,DAVID EDELSTEIN STATE COM 203H,2021-01-01,30,6930,27789,27754,459388,1058694,1438089
300154468200,30-015-44682,DAVID EDELSTEIN STATE COM 203H,2021-02-01,31,5378,16318,21549,464766,1075012,1459638
300154468200,30-015-44682,DAVID EDELSTEIN STATE COM 203H,2021-03-01,32,6895,22054,31988,471661,1097066,1491626
300154468200,30-015-44682,DAVID EDELSTEIN STATE COM 203H,2021-04-01,33,6182,18951,27590,477843,1116017,1519216
300154468200,30-015-44682,DAVID EDELSTEIN STATE COM 203H,2021-05-01,34,6052,19141,29216,483895,1135158,1548432
300154468200,30-015-44682,DAVID EDELSTEIN STATE COM 203H,2021-06-01,35,5998,18470,27093,489893,1153628,1575525
300154468200,30-015-44682,DAVID EDELSTEIN STATE COM 203H,2021-07-01,36,5768,20069,27462,495661,1173697,1602987
300154468200,30-015-44682,DAVID EDELSTEIN STATE COM 203H,2021-08-01,37,4018,14505,17752,499679,1188202,1620739
300154468200,30-015-44682,DAVID EDELSTEIN STATE COM 203H,2021-09-01,38,458,807,3146,500137,1189009,1623885
300154468200,30-015-44682,DAVID EDELSTEIN STATE COM 203H,2021-10-01,39,661,1684,2973,500798,1190693,1626858
300154468200,30-015-44682,DAVID EDELSTEIN STATE COM 203H,2021-11-01,40,51,0,22315,500849,1190693,1649173
300154468200,30-015-44682,DAVID EDELSTEIN STATE COM 203H,2021-12-01,41,484,2356,37705,501333,1193049,1686878
300154468200,30-015-44682,DAVID EDELSTEIN STATE COM 203H,2022-01-01,42,2760,4886,31824,504093,1197935,1718702
300154468200,30-015-44682,DAVID EDELSTEIN STATE COM 203H,2022-02-01,43,2698,4758,29244,506791,1202693,1747946
300154468200,30-015-44682,DAVID EDELSTEIN STATE COM 203H,2022-03-01,44,3690,6279,34254,510481,1208972,1782200
300154468200,30-015-44682,DAVID EDELSTEIN STATE COM 203H,2022-04-01,45,3565,7052,32946,514046,1216024,1815146
300154468200,30-015-44682,DAVID EDELSTEIN STATE COM 203H,2022-05-01,46,3594,7754,30358,517640,1223778,1845504
300154468200,30-015-44682,DAVID EDELSTEIN STATE COM 203H,2022-06-01,47,3368,7507,27611,521008,1231285,1873115
300154468200,30-015-44682,DAVID EDELSTEIN STATE COM 203H,2022-07-01,48,3631,7331,24218,524639,1238616,1897333
300154468200,30-015-44682,DAVID EDELSTEIN STATE COM 203H,2022-08-01,49,4638,9483,28090,529277,1248099,1925423
300154468200,30-015-44682,DAVID EDELSTEIN STATE COM 203H,2022-09-01,50,4404,8836,24645,533681,1256935,1950068
300154468200,30-015-44682,DAVID EDELSTEIN STATE COM 203H,2022-10-01,51,3690,8554,20591,537371,1265489,1970659
300154468200,30-015-44682,DAVID EDELSTEIN STATE COM 203H,2022-11-01,52,4296,9702,21530,541667,1275191,1992189
300154468200,30-015-44682,DAVID EDELSTEIN STATE COM 203H,2022-12-01,53,3938,12497,23425,545605,1287688,2015614
300154468200,30-015-44682,DAVID EDELSTEIN STATE COM 203H,2023-01-01,54,3863,13608,23322,549468,1301296,2038936
300154468200,30-015-44682,DAVID EDELSTEIN STATE COM 203H,2023-02-01,55,3060,11052,16886,552528,1312348,2055822
300154468200,30-015-44682,DAVID EDELSTEIN STATE COM 203H,2023-03-01,56,3955,14121,22262,556483,1326469,2078084
300154468200,30-015-44682,DAVID EDELSTEIN STATE COM 203H,2023-04-01,57,3622,13317,20881,560105,1339786,2098965
300154468200,30-015-44682,DAVID EDELSTEIN STATE COM 203H,2023-05-01,58,3925,15275,24280,564030,1355061,2123245
300154468200,30-015-44682,DAVID EDELSTEIN STATE COM 203H,2023-06-01,59,3052,11345,16141,567082,1366406,2139386
300154612500,30-015-46125,QUIEN SABE FEDERAL COM 801H,2020-02-01,1,23968,50859,92104,23968,50859,92104
300154612500,30-015-46125,QUIEN SABE FEDERAL COM 801H,2020-03-01,2,58544,116839,144898,82512,167698,237002
300154612500,30-015-46125,QUIEN SABE FEDERAL COM 801H,2020-04-01,3,52382,107781,124821,134894,275479,361823
300154612500,30-015-46125,QUIEN SABE FEDERAL COM 801H,2020-05-01,4,49620,98809,113336,184514,374288,475159
300154612500,30-015-46125,QUIEN SABE FEDERAL COM 801H,2020-06-01,5,36952,70820,84608,221466,445108,559767
300154612500,30-015-46125,QUIEN SABE FEDERAL COM 801H,2020-07-01,6,36741,75267,88007,258207,520375,647774
300154612500,30-015-46125,QUIEN SABE FEDERAL COM 801H,2020-08-01,7,31626,63842,79101,289833,584217,726875
300154612500,30-015-46125,QUIEN SABE FEDERAL COM 801H,2020-09-01,8,26167,56609,67138,316000,640826,794013
300154612500,30-015-46125,QUIEN SABE FEDERAL COM 801H,2020-10-01,9,25195,57466,66906,341195,698292,860919
300154612500,30-015-46125,QUIEN SABE FEDERAL COM 801H,2020-11-01,10,21959,51852,61441,363154,750144,922360
300154612500,30-015-46125,QUIEN SABE FEDERAL COM 801H,2020-12-01,11,20524,53768,60163,383678,803912,982523
300154612500,30-015-46125,QUIEN SABE FEDERAL COM 801H,2021-01-01,12,15230,38719,42185,398908,842631,1024708
300154612500,30-015-46125,QUIEN SABE FEDERAL COM 801H,2021-02-01,13,17403,42404,50453,416311,885035,1075161
300154612500,30-015-46125,QUIEN SABE FEDERAL COM 801H,2021-03-01,14,18560,59542,64059,434871,944577,1139220
300154612500,30-015-46125,QUIEN SABE FEDERAL COM 801H,2021-04-01,15,16004,60786,58918,450875,1005363,1198138
300154612500,30-015-46125,QUIEN SABE FEDERAL COM 801H,2021-05-01,16,14114,57199,54469,464989,1062562,1252607
300154612500,30-015-46125,QUIEN SABE FEDERAL COM 801H,2021-06-01,17,13388,31483,44099,478377,1094045,1296706
300154612500,30-015-46125,QUIEN SABE FEDERAL COM 801H,2021-07-01,18,14402,54848,56740,492779,1148893,1353446
300154612500,30-015-46125,QUIEN SABE FEDERAL COM 801H,2021-08-01,19,11132,57274,53662,503911,1206167,1407108
300154612500,30-015-46125,QUIEN SABE FEDERAL COM 801H,2021-09-01,20,9893,49354,48116,513804,1255521,1455224
300154612500,30-015-46125,QUIEN SABE FEDERAL COM 801H,2021-10-01,21,8352,50579,47122,522156,1306100,1502346
300154612500,30-015-46125,QUIEN SABE FEDERAL COM 801H,2021-11-01,22,7211,40226,41549,529367,1346326,1543895
300154612500,30-015-46125,QUIEN SABE FEDERAL COM 801H,2021-12-01,23,7418,37391,37619,536785,1383717,1581514
300154612500,30-015-46125,QUIEN SABE FEDERAL COM 801H,2022-01-01,24,6031,29710,30623,542816,1413427,1612137
300154612500,30-015-46125,QUIEN SABE FEDERAL COM 801H,2022-02-01,25,4518,17013,19468,547334,1430440,1631605
300154612500,30-015-46125,QUIEN SABE FEDERAL COM 801H,2022-03-01,26,2298,485,10500,549632,1430925,1642105
300154612500,30-015-46125,QUIEN SABE FEDERAL COM 801H,2022-04-01,27,9616,26513,33330,559248,1457438,1675435
300154612500,30-015-46125,QUIEN SABE FEDERAL COM 801H,2022-05-01,28,4749,10928,15598,563997,1468366,1691033
300154612500,30-015-46125,QUIEN SABE FEDERAL COM 801H,2022-06-01,29,6483,21321,24099,570480,1489687,1715132
300154612500,30-015-46125,QUIEN SABE FEDERAL COM 801H,2022-07-01,30,3149,21205,25408,573629,1510892,1740540
300154612500,30-015-46125,QUIEN SABE FEDERAL COM 801H,2022-08-01,31,3728,23214,26172,577357,1534106,1766712
300154612500,30-015-46125,QUIEN SABE FEDERAL COM 801H,2022-09-01,32,4206,25072,26242,581563,1559178,1792954
300154612500,30-015-46125,QUIEN SABE FEDERAL COM 801H,2022-10-01,33,3918,21589,24215,585481,1580767,1817169
300154612500,30-015-46125,QUIEN SABE FEDERAL COM 801H,2022-11-01,34,3599,19229,10201,589080,1599996,1827370
300154612500,30-015-46125,QUIEN SABE FEDERAL COM 801H,2022-12-01,35,3189,12553,12551,592269,1612549,1839921
300154612500,30-015-46125,QUIEN SABE FEDERAL COM 801H,2023-01-01,36,5987,18327,19774,598256,1630876,1859695
300154612500,30-015-46125,QUIEN SABE FEDERAL COM 801H,2023-02-01,37,5346,18331,20651,603602,1649207,1880346
300154612500,30-015-46125,QUIEN SABE FEDERAL COM 801H,2023-03-01,38,5956,21509,24120,609558,1670716,1904466
300154612500,30-015-46125,QUIEN SABE FEDERAL COM 801H,2023-04-01,39,5340,19181,16937,614898,1689897,1921403
300154612500,30-015-46125,QUIEN SABE FEDERAL COM 801H,2023-05-01,40,2019,11819,8253,616917,1701716,1929656
300154612500,30-015-46125,QUIEN SABE FEDERAL COM 801H,2023-06-01,41,1391,8008,7253,618308,1709724,1936909
300154612500,30-015-46125,QUIEN SABE FEDERAL COM 801H,2023-07-01,42,5561,13879,19244,623869,1723603,1956153
300154245800,30-015-42458,BLACK RIVER STATE 004H,2014-12-01,1,1724,8444,38831,1724,8444,38831
300154245800,30-015-42458,BLACK RIVER STATE 004H,2015-01-01,2,8403,62098,52799,10127,70542,91630
300154245800,30-015-42458,BLACK RIVER STATE 004H,2015-02-01,3,3697,28839,16710,13824,99381,108340
300154245800,30-015-42458,BLACK RIVER STATE 004H,2015-03-01,4,1284,1302,1098,15108,100683,109438
300154245800,30-015-42458,BLACK RIVER STATE 004H,2015-04-01,5,2903,19793,3548,18011,120476,112986
300154245800,30-015-42458,BLACK RIVER STATE 004H,2015-05-01,6,6458,80441,27815,24469,200917,140801
300154245800,30-015-42458,BLACK RIVER STATE 004H,2015-06-01,7,2151,28374,8141,26620,229291,148942
300154245800,30-015-42458,BLACK RIVER STATE 004H,2015-07-01,8,0,0,0,26620,229291,148942
300154245800,30-015-42458,BLACK RIVER STATE 004H,2015-08-01,9,647,2395,0,27267,231686,148942
300154245800,30-015-42458,BLACK RIVER STATE 004H,2015-09-01,10,6579,46453,11700,33846,278139,160642
300154245800,30-015-42458,BLACK RIVER STATE 004H,2015-10-01,11,8364,64427,32448,42210,342566,193090
300154245800,30-015-42458,BLACK RIVER STATE 004H,2015-11-01,12,6723,51056,26021,48933,393622,219111
300154245800,30-015-42458,BLACK RIVER STATE 004H,2015-12-01,13,5228,42840,19860,54161,436462,238971
300154245800,30-015-42458,BLACK RIVER STATE 004H,2016-01-01,14,5026,42623,15812,59187,479085,254783
300154245800,30-015-42458,BLACK RIVER STATE 004H,2016-02-01,15,5688,49426,21128,64875,528511,275911
300154245800,30-015-42458,BLACK RIVER STATE 004H,2016-03-01,16,5829,51977,21559,70704,580488,297470
300154245800,30-015-42458,BLACK RIVER STATE 004H,2016-04-01,17,4799,47359,17909,75503,627847,315379
300154245800,30-015-42458,BLACK RIVER STATE 004H,2016-05-01,18,4826,48641,17318,80329,676488,332697
300154245800,30-015-42458,BLACK RIVER STATE 004H,2016-06-01,19,4268,43963,14928,84597,720451,347625
300154245800,30-015-42458,BLACK RIVER STATE 004H,2016-07-01,20,4078,42684,14838,88675,763135,362463
300154245800,30-015-42458,BLACK RIVER STATE 004H,2016-08-01,21,3915,41396,13134,92590,804531,375597
300154245800,30-015-42458,BLACK RIVER STATE 004H,2016-09-01,22,3602,38837,12390,96192,843368,387987
300154245800,30-015-42458,BLACK RIVER STATE 004H,2016-10-01,23,3579,38555,11266,99771,881923,399253
300154245800,30-015-42458,BLACK RIVER STATE 004H,2016-11-01,24,2991,35143,10675,102762,917066,409928
300154245800,30-015-42458,BLACK RIVER STATE 004H,2016-12-01,25,2957,32635,9462,105719,949701,419390
300154245800,30-015-42458,BLACK RIVER STATE 004H,2017-01-01,26,2949,32298,10070,108668,981999,429460
300154245800,30-015-42458,BLACK RIVER STATE 004H,2017-02-01,27,2623,29913,8816,111291,1011912,438276
300154245800,30-015-42458,BLACK RIVER STATE 004H,2017-03-01,28,2821,32308,9143,114112,1044220,447419
300154245800,30-015-42458,BLACK RIVER STATE 004H,2017-04-01,29,2624,29410,8364,116736,1073630,455783
300154245800,30-015-42458,BLACK RIVER STATE 004H,2017-05-01,30,2650,29334,8169,119386,1102964,463952
300154245800,30-015-42458,BLACK RIVER STATE 004H,2017-06-01,31,2501,26474,7906,121887,1129438,471858
300154245800,30-015-42458,BLACK RIVER STATE 004H,2017-07-01,32,2497,28112,7817,124384,1157550,479675
300154245800,30-015-42458,BLACK RIVER STATE 004H,2017-08-01,33,2504,29082,8394,126888,1186632,488069
300154245800,30-015-42458,BLACK RIVER STATE 004H,2017-09-01,34,2325,26163,7418,129213,1212795,495487
300154245800,30-015-42458,BLACK RIVER STATE 004H,2017-10-01,35,2329,26908,7510,131542,1239703,502997
300154245800,30-015-42458,BLACK RIVER STATE 004H,2017-11-01,36,2284,25302,7158,133826,1265005,510155
300154245800,30-015-42458,BLACK RIVER STATE 004H,2017-12-01,37,2173,25169,6814,135999,1290174,516969
300154245800,30-015-42458,BLACK RIVER STATE 004H,2018-01-01,38,2339,24557,6787,138338,1314731,523756
300154245800,30-015-42458,BLACK RIVER STATE 004H,2018-02-01,39,2021,22564,6211,140359,1337295,529967
300154245800,30-015-42458,BLACK RIVER STATE 004H,2018-03-01,40,2317,26085,6779,142676,1363380,536746
300154245800,30-015-42458,BLACK RIVER STATE 004H,2018-04-01,41,2261,27457,8942,144937,1390837,545688
300154245800,30-015-42458,BLACK RIVER STATE 004H,2018-05-01,42,2260,27998,8645,147197,1418835,554333
300154245800,30-015-42458,BLACK RIVER STATE 004H,2018-06-01,43,2107,26395,8139,149304,1445230,562472
300154245800,30-015-42458,BLACK RIVER STATE 004H,2018-07-01,44,2014,23267,6588,151318,1468497,569060
300154245800,30-015-42458,BLACK RIVER STATE 004H,2018-08-01,45,2073,23288,6171,153391,1491785,575231
300154245800,30-015-42458,BLACK RIVER STATE 004H,2018-09-01,46,2040,24048,6521,155431,1515833,581752
300154245800,30-015-42458,BLACK RIVER STATE 004H,2018-10-01,47,1952,22649,5966,157383,1538482,587718
300154245800,30-015-42458,BLACK RIVER STATE 004H,2018-11-01,48,1920,21522,5255,159303,1560004,592973
300154245800,30-015-42458,BLACK RIVER STATE 004H,2018-12-01,49,2040,22654,6031,161343,1582658,599004
300154245800,30-015-42458,BLACK RIVER STATE 004H,2019-01-01,50,1975,22615,6289,163318,1605273,605293
300154245800,30-015-42458,BLACK RIVER STATE 004H,2019-02-01,51,1869,21172,6676,165187,1626445,611969
300154245800,30-015-42458,BLACK RIVER STATE 004H,2019-03-01,52,2011,23842,7158,167198,1650287,619127
300154245800,30-015-42458,BLACK RIVER STATE 004H,2019-04-01,53,1875,22747,6093,169073,1673034,625220
300154245800,30-015-42458,BLACK RIVER STATE 004H,2019-05-01,54,729,12298,3302,169802,1685332,628522
300154245800,30-015-42458,BLACK RIVER STATE 004H,2019-06-01,55,1415,16349,7472,171217,1701681,635994
300154245800,30-015-42458,BLACK RIVER STATE 004H,2019-07-01,56,930,11712,1709,172147,1713393,637703
300154245800,30-015-42458,BLACK RIVER STATE 004H,2019-08-01,57,1779,16474,5734,173926,1729867,643437
300154245800,30-015-42458,BLACK RIVER STATE 004H,2019-09-01,58,1717,17123,5779,175643,1746990,649216
300154245800,30-015-42458,BLACK RIVER STATE 004H,2019-10-01,59,1790,18112,5681,177433,1765102,654897
300154245800,30-015-42458,BLACK RIVER STATE 004H,2019-11-01,60,1587,17782,4901,179020,1782884,659798
300154245800,30-015-42458,BLACK RIVER STATE 004H,2019-12-01,61,1767,18833,5281,180787,1801717,665079
300154245800,30-015-42458,BLACK RIVER STATE 004H,2020-01-01,62,1677,18600,5114,182464,1820317,670193
300154245800,30-015-42458,BLACK RIVER STATE 004H,2020-02-01,63,1588,17203,4643,184052,1837520,674836
300154245800,30-015-42458,BLACK RIVER STATE 004H,2020-03-01,64,1605,18003,4843,185657,1855523,679679
300154245800,30-015-42458,BLACK RIVER STATE 004H,2020-04-01,65,1502,17017,4720,187159,1872540,684399
300154245800,30-015-42458,BLACK RIVER STATE 004H,2020-05-01,66,1534,17227,4830,188693,1889767,689229
300154245800,30-015-42458,BLACK RIVER STATE 004H,2020-06-01,67,1311,15058,4025,190004,1904825,693254
300154245800,30-015-42458,BLACK RIVER STATE 004H,2020-07-01,68,1497,18129,5137,191501,1922954,698391
300154245800,30-015-42458,BLACK RIVER STATE 004H,2020-08-01,69,1430,17582,4999,192931,1940536,703390
300154245800,30-015-42458,BLACK RIVER STATE 004H,2020-09-01,70,1373,16200,4344,194304,1956736,707734
300154245800,30-015-42458,BLACK RIVER STATE 004H,2020-10-01,71,1355,16084,4277,195659,1972820,712011
300154245800,30-015-42458,BLACK RIVER STATE 004H,2020-11-01,72,1342,15190,3920,197001,1988010,715931
300154245800,30-015-42458,BLACK RIVER STATE 004H,2020-12-01,73,1402,15271,4003,198403,2003281,719934
300154245800,30-015-42458,BLACK RIVER STATE 004H,2021-01-01,74,1337,14759,3745,199740,2018040,723679
300154245800,30-015-42458,BLACK RIVER STATE 004H,2021-02-01,75,1289,13308,3496,201029,2031348,727175
300154245800,30-015-42458,BLACK RIVER STATE 004H,2021-03-01,76,1339,14939,4111,202368,2046287,731286
300154245800,30-015-42458,BLACK RIVER STATE 004H,2021-04-01,77,1293,14765,4116,203661,2061052,735402
300154245800,30-015-42458,BLACK RIVER STATE 004H,2021-05-01,78,1285,14949,4122,204946,2076001,739524
300154245800,30-015-42458,BLACK RIVER STATE 004H,2021-06-01,79,1245,14498,4047,206191,2090499,743571
300154245800,30-015-42458,BLACK RIVER STATE 004H,2021-07-01,80,1224,14369,4189,207415,2104868,747760
300154245800,30-015-42458,BLACK RIVER STATE 004H,2021-08-01,81,1229,13979,3713,208644,2118847,751473
300154245800,30-015-42458,BLACK RIVER STATE 004H,2021-09-01,82,1278,13382,3251,209922,2132229,754724
300154245800,30-015-42458,BLACK RIVER STATE 004H,2021-10-01,83,1180,13644,3224,211102,2145873,757948
300154245800,30-015-42458,BLACK RIVER STATE 004H,2021-11-01,84,1158,12780,2845,212260,2158653,760793
300154245800,30-015-42458,BLACK RIVER STATE 004H,2021-12-01,85,1244,13295,3188,213504,2171948,763981
300154245800,30-015-42458,BLACK RIVER STATE 004H,2022-01-01,86,1174,13224,3111,214678,2185172,767092
300154245800,30-015-42458,BLACK RIVER STATE 004H,2022-02-01,87,1094,11883,2691,215772,2197055,769783
300154245800,30-015-42458,BLACK RIVER STATE 004H,2022-03-01,88,580,6278,818,216352,2203333,770601
300154245800,30-015-42458,BLACK RIVER STATE 004H,2022-04-01,89,1164,13628,3706,217516,2216961,774307
300154245800,30-015-42458,BLACK RIVER STATE 004H,2022-05-01,90,1170,13416,3557,218686,2230377,777864
300154245800,30-015-42458,BLACK RIVER STATE 004H,2022-06-01,91,1054,13215,3138,219740,2243592,781002
300154245800,30-015-42458,BLACK RIVER STATE 004H,2022-07-01,92,939,12828,2908,220679,2256420,783910
300154245800,30-015-42458,BLACK RIVER STATE 004H,2022-08-01,93,1038,12453,3174,221717,2268873,787084
300154245800,30-015-42458,BLACK RIVER STATE 004H,2022-09-01,94,1002,11591,2238,222719,2280464,789322
300154245800,30-015-42458,BLACK RIVER STATE 004H,2022-10-01,95,804,9130,1360,223523,2289594,790682
300154245800,30-015-42458,BLACK RIVER STATE 004H,2022-11-01,96,716,5290,277,224239,2294884,790959
300154245800,30-015-42458,BLACK RIVER STATE 004H,2022-12-01,97,334,9093,916,224573,2303977,791875
300154245800,30-015-42458,BLACK RIVER STATE 004H,2023-01-01,98,852,11155,606,225425,2315132,792481
300154245800,30-015-42458,BLACK RIVER STATE 004H,2023-02-01,99,252,2658,225,225677,2317790,792706
300154245800,30-015-42458,BLACK RIVER STATE 004H,2023-03-01,100,917,12496,607,226594,2330286,793313
300154245800,30-015-42458,BLACK RIVER STATE 004H,2023-04-01,101,1356,15483,1779,227950,2345769,795092
300154245800,30-015-42458,BLACK RIVER STATE 004H,2023-05-01,102,551,6947,2660,228501,2352716,797752
300154245800,30-015-42458,BLACK RIVER STATE 004H,2023-06-01,103,777,9495,657,229278,2362211,798409
300154245800,30-015-42458,BLACK RIVER STATE 004H,2023-07-01,104,1026,11892,1322,230304,2374103,799731
300152359900,30-015-23599,HUMIDOR BMO STATE COM 003,2006-10-01,1,0,1451,258,0,1451,258
300152359900,30-015-23599,HUMIDOR BMO STATE COM 003,2006-11-01,2,0,14813,1617,0,16264,1875
300152359900,30-015-23599,HUMIDOR BMO STATE COM 003,2006-12-01,3,0,14011,1047,0,30275,2922
300152359900,30-015-23599,HUMIDOR BMO STATE COM 003,2007-01-01,4,0,12355,810,0,42630,3732
300152359900,30-015-23599,HUMIDOR BMO STATE COM 003,2007-02-01,5,0,9154,656,0,51784,4388
300152359900,30-015-23599,HUMIDOR BMO STATE COM 003,2007-03-01,6,0,9022,705,0,60806,5093
300152359900,30-015-23599,HUMIDOR BMO STATE COM 003,2007-04-01,7,0,8150,625,0,68956,5718
300152359900,30-015-23599,HUMIDOR BMO STATE COM 003,2007-05-01,8,0,7879,666,0,76835,6384
300152359900,30-015-23599,HUMIDOR BMO STATE COM 003,2007-06-01,9,0,7133,591,0,83968,6975
300152359900,30-015-23599,HUMIDOR BMO STATE COM 003,2007-07-01,10,0,5596,465,0,89564,7440
300152359900,30-015-23599,HUMIDOR BMO STATE COM 003,2007-08-01,11,0,7632,628,0,97196,8068
300152359900,30-015-23599,HUMIDOR BMO STATE COM 003,2007-09-01,12,0,6642,358,0,103838,8426
300152359900,30-015-23599,HUMIDOR BMO STATE COM 003,2007-10-01,13,0,7402,388,0,111240,8814
300152359900,30-015-23599,HUMIDOR BMO STATE COM 003,2007-11-01,14,0,5868,321,0,117108,9135
300152359900,30-015-23599,HUMIDOR BMO STATE COM 003,2007-12-01,15,0,6366,309,0,123474,9444
300152359900,30-015-23599,HUMIDOR BMO STATE COM 003,2008-01-01,16,0,6574,262,0,130048,9706
300152359900,30-015-23599,HUMIDOR BMO STATE COM 003,2008-02-01,17,0,5785,264,0,135833,9970
300152359900,30-015-23599,HUMIDOR BMO STATE COM 003,2008-03-01,18,0,6251,249,0,142084,10219
300152359900,30-015-23599,HUMIDOR BMO STATE COM 003,2008-04-01,19,0,6100,135,0,148184,10354
300152359900,30-015-23599,HUMIDOR BMO STATE COM 003,2008-05-01,20,0,5141,120,0,153325,10474
300152359900,30-015-23599,HUMIDOR BMO STATE COM 003,2008-06-01,21,0,5247,123,0,158572,10597
300152359900,30-015-23599,HUMIDOR BMO STATE COM 003,2008-07-01,22,0,5064,82,0,163636,10679
300152359900,30-015-23599,HUMIDOR BMO STATE COM 003,2008-08-01,23,0,5757,213,0,169393,10892
300152359900,30-015-23599,HUMIDOR BMO STATE COM 003,2008-09-01,24,0,5761,222,0,175154,11114
300152359900,30-015-23599,HUMIDOR BMO STATE COM 003,2008-10-01,25,0,4720,315,0,179874,11429
300152359900,30-015-23599,HUMIDOR BMO STATE COM 003,2008-11-01,26,0,4615,282,0,184489,11711
300152359900,30-015-23599,HUMIDOR BMO STATE COM 003,2008-12-01,27,0,4759,305,0,189248,12016
300152359900,30-015-23599,HUMIDOR BMO STATE COM 003,2009-01-01,28,0,4590,261,0,193838,12277
300152359900,30-015-23599,HUMIDOR BMO STATE COM 003,2009-02-01,29,0,4976,267,0,198814,12544
300152359900,30-015-23599,HUMIDOR BMO STATE COM 003,2009-03-01,30,0,4932,264,0,203746,12808
300152359900,30-015-23599,HUMIDOR BMO STATE COM 003,2009-04-01,31,0,4460,216,0,208206,13024
300152359900,30-015-23599,HUMIDOR BMO STATE COM 003,2009-05-01,32,0,4485,204,0,212691,13228
300152359900,30-015-23599,HUMIDOR BMO STATE COM 003,2009-06-01,33,0,4515,192,0,217206,13420
300152359900,30-015-23599,HUMIDOR BMO STATE COM 003,2009-07-01,34,0,5421,213,0,222627,13633
300152359900,30-015-23599,HUMIDOR BMO STATE COM 003,2009-08-01,35,0,4556,189,0,227183,13822
300152359900,30-015-23599,HUMIDOR BMO STATE COM 003,2009-09-01,36,0,4845,204,0,232028,14026
300152359900,30-015-23599,HUMIDOR BMO STATE COM 003,2009-10-01,37,0,3947,159,0,235975,14185
300152359900,30-015-23599,HUMIDOR BMO STATE COM 003,2009-11-01,38,0,3802,126,0,239777,14311
300152359900,30-015-23599,HUMIDOR BMO STATE COM 003,2009-12-01,39,0,3751,309,0,243528,14620
300152359900,30-015-23599,HUMIDOR BMO STATE COM 003,2010-01-01,40,0,4411,448,0,247939,15068
300152359900,30-015-23599,HUMIDOR BMO STATE COM 003,2010-02-01,41,0,3858,619,0,251797,15687
300152359900,30-015-23599,HUMIDOR BMO STATE COM 003,2010-03-01,42,0,3800,728,0,255597,16415
300152359900,30-015-23599,HUMIDOR BMO STATE COM 003,2010-04-01,43,0,3813,764,0,259410,17179
300152359900,30-015-23599,HUMIDOR BMO STATE COM 003,2010-05-01,44,0,3618,745,0,263028,17924
300152359900,30-015-23599,HUMIDOR BMO STATE COM 003,2010-06-01,45,0,3549,561,0,266577,18485
300152359900,30-015-23599,HUMIDOR BMO STATE COM 003,2010-07-01,46,0,2859,229,0,269436,18714
300152359900,30-015-23599,HUMIDOR BMO STATE COM 003,2010-08-01,47,0,2542,147,0,271978,18861
300152359900,30-015-23599,HUMIDOR BMO STATE COM 003,2010-09-01,48,0,1572,18,0,273550,18879
300152359900,30-015-23599,HUMIDOR BMO STATE COM 003,2010-10-01,49,0,1655,0,0,275205,18879
300152359900,30-015-23599,HUMIDOR BMO STATE COM 003,2010-11-01,50,0,1420,0,0,276625,18879
300152359900,30-015-23599,HUMIDOR BMO STATE COM 003,2010-12-01,51,0,1894,0,0,278519,18879
300152359900,30-015-23599,HUMIDOR BMO STATE COM 003,2011-01-01,52,0,1712,0,0,280231,18879
300152359900,30-015-23599,HUMIDOR BMO STATE COM 003,2011-02-01,53,0,1284,111,0,281515,18990
300152359900,30-015-23599,HUMIDOR BMO STATE COM 003,2011-03-01,54,0,2090,0,0,283605,18990
300152359900,30-015-23599,HUMIDOR BMO STATE COM 003,2011-04-01,55,0,5342,284,0,288947,19274
300152359900,30-015-23599,HUMIDOR BMO STATE COM 003,2011-05-01,56,0,6442,242,0,295389,19516
300152359900,30-015-23599,HUMIDOR BMO STATE COM 003,2011-06-01,57,0,5192,207,0,300581,19723
300152359900,30-015-23599,HUMIDOR BMO STATE COM 003,2011-07-01,58,0,3406,89,0,303987,19812
300152359900,30-015-23599,HUMIDOR BMO STATE COM 003,2011-08-01,59,0,4599,72,0,308586,19884
300152359900,30-015-23599,HUMIDOR BMO STATE COM 003,2011-09-01,60,0,3179,119,0,311765,20003
300152359900,30-015-23599,HUMIDOR BMO STATE COM 003,2011-10-01,61,0,4406,63,0,316171,20066
300152359900,30-015-23599,HUMIDOR BMO STATE COM 003,2011-11-01,62,0,3655,35,0,319826,20101
300152359900,30-015-23599,HUMIDOR BMO STATE COM 003,2011-12-01,63,0,3716,152,0,323542,20253
300152359900,30-015-23599,HUMIDOR BMO STATE COM 003,2012-01-01,64,0,3654,131,0,327196,20384
300152359900,30-015-23599,HUMIDOR BMO STATE COM 003,2012-02-01,65,0,604,33,0,327800,20417
300152359900,30-015-23599,HUMIDOR BMO STATE COM 003,2012-03-01,66,0,376,0,0,328176,20417
300152359900,30-015-23599,HUMIDOR BMO STATE COM 003,2012-04-01,67,0,2946,132,0,331122,20549
300152359900,30-015-23599,HUMIDOR BMO STATE COM 003,2012-05-01,68,0,5047,75,0,336169,20624
300152359900,30-015-23599,HUMIDOR BMO STATE COM 003,2012-06-01,69,0,4123,46,0,340292,20670
300152359900,30-015-23599,HUMIDOR BMO STATE COM 003,2012-07-01,70,0,3755,46,0,344047,20716
300152359900,30-015-23599,HUMIDOR BMO STATE COM 003,2012-08-01,71,0,2400,142,0,346447,20858
300152359900,30-015-23599,HUMIDOR BMO STATE COM 003,2012-09-01,72,0,2601,69,0,349048,20927
300152359900,30-015-23599,HUMIDOR BMO STATE COM 003,2012-10-01,73,0,3113,0,0,352161,20927
300152359900,30-015-23599,HUMIDOR BMO STATE COM 003,2012-11-01,74,0,2960,9,0,355121,20936
300152359900,30-015-23599,HUMIDOR BMO STATE COM 003,2012-12-01,75,0,3157,45,0,358278,20981
300152359900,30-015-23599,HUMIDOR BMO STATE COM 003,2013-01-01,76,0,1801,0,0,360079,20981
300152359900,30-015-23599,HUMIDOR BMO STATE COM 003,2013-02-01,77,0,2350,9,0,362429,20990
300152359900,30-015-23599,HUMIDOR BMO STATE COM 003,2013-03-01,78,0,495,0,0,362924,20990
300152359900,30-015-23599,HUMIDOR BMO STATE COM 003,2013-04-01,79,0,3145,357,0,366069,21347
300152359900,30-015-23599,HUMIDOR BMO STATE COM 003,2013-05-01,80,0,3199,131,0,369268,21478
300152359900,30-015-23599,HUMIDOR BMO STATE COM 003,2013-06-01,81,0,2576,9,0,371844,21487
300152359900,30-015-23599,HUMIDOR BMO STATE COM 003,2013-07-01,82,0,1713,60,0,373557,21547
300152359900,30-015-23599,HUMIDOR BMO STATE COM 003,2013-08-01,83,0,3954,94,0,377511,21641
300152359900,30-015-23599,HUMIDOR BMO STATE COM 003,2013-09-01,84,0,1888,50,0,379399,21691
300152359900,30-015-23599,HUMIDOR BMO STATE COM 003,2013-10-01,85,0,3825,0,0,383224,21691
300152359900,30-015-23599,HUMIDOR BMO STATE COM 003,2013-11-01,86,0,1296,44,0,384520,21735
300152359900,30-015-23599,HUMIDOR BMO STATE COM 003,2013-12-01,87,0,3382,203,0,387902,21938
300152359900,30-015-23599,HUMIDOR BMO STATE COM 003,2014-01-01,88,0,1550,143,0,389452,22081
300152359900,30-015-23599,HUMIDOR BMO STATE COM 003,2014-02-01,89,0,1292,51,0,390744,22132
300152359900,30-015-23599,HUMIDOR BMO STATE COM 003,2014-03-01,90,0,1220,6,0,391964,22138
300152359900,30-015-23599,HUMIDOR BMO STATE COM 003,2014-04-01,91,0,1987,0,0,393951,22138
300152359900,30-015-23599,HUMIDOR BMO STATE COM 003,2014-05-01,92,0,4437,0,0,398388,22138
300152359900,30-015-23599,HUMIDOR BMO STATE COM 003,2014-06-01,93,0,1310,0,0,399698,22138
300152359900,30-015-23599,HUMIDOR BMO STATE COM 003,2014-07-01,94,0,1801,0,0,401499,22138
300152359900,30-015-23599,HUMIDOR BMO STATE COM 003,2014-08-01,95,0,2764,0,0,404263,22138
300152359900,30-015-23599,HUMIDOR BMO STATE COM 003,2014-09-01,96,0,749,0,0,405012,22138
300152359900,30-015-23599,HUMIDOR BMO STATE COM 003,2014-10-01,97,0,1042,0,0,406054,22138
300152359900,30-015-23599,HUMIDOR BMO STATE COM 003,2014-11-01,98,0,2986,0,0,409040,22138
300152359900,30-015-23599,HUMIDOR BMO STATE COM 003,2014-12-01,99,0,2567,0,0,411607,22138
300152359900,30-015-23599,HUMIDOR BMO STATE COM 003,2015-01-01,100,28,1102,8,28,412709,22146
300152359900,30-015-23599,HUMIDOR BMO STATE COM 003,2015-02-01,101,0,1447,0,28,414156,22146
300152359900,30-015-23599,HUMIDOR BMO STATE COM 003,2015-03-01,102,0,1519,0,28,415675,22146
300152359900,30-015-23599,HUMIDOR BMO STATE COM 003,2015-04-01,103,0,1443,0,28,417118,22146
300152359900,30-015-23599,HUMIDOR BMO STATE COM 003,2015-05-01,104,0,1500,0,28,418618,22146
300152359900,30-015-23599,HUMIDOR BMO STATE COM 003,2015-06-01,105,0,1414,0,28,420032,22146
300152359900,30-015-23599,HUMIDOR BMO STATE COM 003,2015-07-01,106,0,365,0,28,420397,22146
300152359900,30-015-23599,HUMIDOR BMO STATE COM 003,2015-08-01,107,0,0,0,28,420397,22146
300152359900,30-015-23599,HUMIDOR BMO STATE COM 003,2015-09-01,108,8,5,0,36,420402,22146
300152359900,30-015-23599,HUMIDOR BMO STATE COM 003,2015-10-01,109,3,5,0,39,420407,22146
300152359900,30-015-23599,HUMIDOR BMO STATE COM 003,2015-11-01,110,0,5,0,39,420412,22146
300152359900,30-015-23599,HUMIDOR BMO STATE COM 003,2015-12-01,111,0,0,0,39,420412,22146
300152359900,30-015-23599,HUMIDOR BMO STATE COM 003,2016-01-01,112,0,0,0,39,420412,22146
300152359900,30-015-23599,HUMIDOR BMO STATE COM 003,2016-02-01,113,0,437,0,39,420849,22146
300152359900,30-015-23599,HUMIDOR BMO STATE COM 003,2016-03-01,114,0,5124,0,39,425973,22146
300152359900,30-015-23599,HUMIDOR BMO STATE COM 003,2016-04-01,115,0,3485,0,39,429458,22146
300152359900,30-015-23599,HUMIDOR BMO STATE COM 003,2016-05-01,116,0,1903,0,39,431361,22146
300152359900,30-015-23599,HUMIDOR BMO STATE COM 003,2016-06-01,117,0,1252,0,39,432613,22146
300152359900,30-015-23599,HUMIDOR BMO STATE COM 003,2016-07-01,118,0,1248,0,39,433861,22146
300152359900,30-015-23599,HUMIDOR BMO STATE COM 003,2016-08-01,119,0,1218,0,39,435079,22146
300152359900,30-015-23599,HUMIDOR BMO STATE COM 003,2016-09-01,120,0,742,0,39,435821,22146
300152359900,30-015-23599,HUMIDOR BMO STATE COM 003,2016-10-01,121,0,591,0,39,436412,22146
300152359900,30-015-23599,HUMIDOR BMO STATE COM 003,2016-11-01,122,0,774,0,39,437186,22146
300152359900,30-015-23599,HUMIDOR BMO STATE COM 003,2016-12-01,123,0,454,0,39,437640,22146
300152359900,30-015-23599,HUMIDOR BMO STATE COM 003,2017-01-01,124,0,146,0,39,437786,22146
300152359900,30-015-23599,HUMIDOR BMO STATE COM 003,2017-02-01,125,0,934,0,39,438720,22146
300152359900,30-015-23599,HUMIDOR BMO STATE COM 003,2017-03-01,126,0,705,0,39,439425,22146
300152359900,30-015-23599,HUMIDOR BMO STATE COM 003,2017-04-01,127,0,3757,0,39,443182,22146
300152359900,30-015-23599,HUMIDOR BMO STATE COM 003,2017-05-01,128,0,4164,0,39,447346,22146
300152359900,30-015-23599,HUMIDOR BMO STATE COM 003,2017-06-01,129,0,3745,0,39,451091,22146
300152359900,30-015-23599,HUMIDOR BMO STATE COM 003,2017-07-01,130,0,4138,0,39,455229,22146
300152359900,30-015-23599,HUMIDOR BMO STATE COM 003,2017-08-01,131,0,4346,0,39,459575,22146
300152359900,30-015-23599,HUMIDOR BMO STATE COM 003,2017-09-01,132,0,3926,0,39,463501,22146
300152359900,30-015-23599,HUMIDOR BMO STATE COM 003,2017-10-01,133,0,3880,0,39,467381,22146
300152359900,30-015-23599,HUMIDOR BMO STATE COM 003,2017-11-01,134,0,4074,0,39,471455,22146
300152359900,30-015-23599,HUMIDOR BMO STATE COM 003,2017-12-01,135,0,4049,0,39,475504,22146
300152359900,30-015-23599,HUMIDOR BMO STATE COM 003,2018-01-01,136,0,4205,0,39,479709,22146
300152359900,30-015-23599,HUMIDOR BMO STATE COM 003,2018-02-01,137,0,3544,0,39,483253,22146
300152359900,30-015-23599,HUMIDOR BMO STATE COM 003,2018-03-01,138,0,3925,0,39,487178,22146
300152359900,30-015-23599,HUMIDOR BMO STATE COM 003,2018-04-01,139,0,3764,0,39,490942,22146
300152359900,30-015-23599,HUMIDOR BMO STATE COM 003,2018-05-01,140,0,3553,12,39,494495,22158
300152359900,30-015-23599,HUMIDOR BMO STATE COM 003,2018-06-01,141,0,3275,0,39,497770,22158
300152359900,30-015-23599,HUMIDOR BMO STATE COM 003,2018-07-01,142,0,3803,0,39,501573,22158
300152359900,30-015-23599,HUMIDOR BMO STATE COM 003,2018-08-01,143,0,3775,0,39,505348,22158
300152359900,30-015-23599,HUMIDOR BMO STATE COM 003,2018-09-01,144,0,3449,0,39,508797,22158
300152359900,30-015-23599,HUMIDOR BMO STATE COM 003,2018-10-01,145,0,3544,0,39,512341,22158
300152359900,30-015-23599,HUMIDOR BMO STATE COM 003,2018-11-01,146,0,3610,0,39,515951,22158
300152359900,30-015-23599,HUMIDOR BMO STATE COM 003,2018-12-01,147,0,3676,0,39,519627,22158
300152359900,30-015-23599,HUMIDOR BMO STATE COM 003,2019-01-01,148,0,3210,0,39,522837,22158
300152359900,30-015-23599,HUMIDOR BMO STATE COM 003,2019-02-01,149,0,2890,0,39,525727,22158
300152359900,30-015-23599,HUMIDOR BMO STATE COM 003,2019-03-01,150,0,3196,0,39,528923,22158
300152359900,30-015-23599,HUMIDOR BMO STATE COM 003,2019-04-01,151,0,2788,0,39,531711,22158
300152359900,30-015-23599,HUMIDOR BMO STATE COM 003,2019-05-01,152,0,2481,0,39,534192,22158
300152359900,30-015-23599,HUMIDOR BMO STATE COM 003,2019-06-01,153,0,3739,147,39,537931,22305
300152359900,30-015-23599,HUMIDOR BMO STATE COM 003,2019-07-01,154,0,3495,81,39,541426,22386
300152359900,30-015-23599,HUMIDOR BMO STATE COM 003,2019-08-01,155,0,2927,72,39,544353,22458
300152359900,30-015-23599,HUMIDOR BMO STATE COM 003,2019-09-01,156,0,3039,0,39,547392,22458
300152359900,30-015-23599,HUMIDOR BMO STATE COM 003,2019-10-01,157,0,3201,0,39,550593,22458
300152359900,30-015-23599,HUMIDOR BMO STATE COM 003,2019-11-01,158,0,2826,0,39,553419,22458
300152359900,30-015-23599,HUMIDOR BMO STATE COM 003,2019-12-01,159,0,2839,0,39,556258,22458
300152359900,30-015-23599,HUMIDOR BMO STATE COM 003,2020-01-01,160,0,2972,0,39,559230,22458
300152359900,30-015-23599,HUMIDOR BMO STATE COM 003,2020-02-01,161,0,2696,0,39,561926,22458
300152359900,30-015-23599,HUMIDOR BMO STATE COM 003,2020-03-01,162,0,2823,0,39,564749,22458
300152359900,30-015-23599,HUMIDOR BMO STATE COM 003,2020-04-01,163,0,2646,0,39,567395,22458
300152359900,30-015-23599,HUMIDOR BMO STATE COM 003,2020-05-01,164,0,847,0,39,568242,22458
300152359900,30-015-23599,HUMIDOR BMO STATE COM 003,2020-06-01,165,0,3830,0,39,572072,22458
300152359900,30-015-23599,HUMIDOR BMO STATE COM 003,2020-07-01,166,0,1905,0,39,573977,22458
300152359900,30-015-23599,HUMIDOR BMO STATE COM 003,2020-08-01,167,0,3432,3,39,577409,22461
300152359900,30-015-23599,HUMIDOR BMO STATE COM 003,2020-09-01,168,0,2644,6,39,580053,22467
300152359900,30-015-23599,HUMIDOR BMO STATE COM 003,2020-10-01,169,0,1935,90,39,581988,22557
300152359900,30-015-23599,HUMIDOR BMO STATE COM 003,2020-11-01,170,0,2523,120,39,584511,22677
300152359900,30-015-23599,HUMIDOR BMO STATE COM 003,2020-12-01,171,0,2191,88,39,586702,22765
300152359900,30-015-23599,HUMIDOR BMO STATE COM 003,2021-01-01,172,0,2236,69,39,588938,22834
300152359900,30-015-23599,HUMIDOR BMO STATE COM 003,2021-02-01,173,0,1873,36,39,590811,22870
300152359900,30-015-23599,HUMIDOR BMO STATE COM 003,2021-03-01,174,0,2372,84,39,593183,22954
300152359900,30-015-23599,HUMIDOR BMO STATE COM 003,2021-04-01,175,0,1954,87,39,595137,23041
300152359900,30-015-23599,HUMIDOR BMO STATE COM 003,2021-05-01,176,0,2489,90,39,597626,23131
300152359900,30-015-23599,HUMIDOR BMO STATE COM 003,2021-06-01,177,0,1703,86,39,599329,23217
300152359900,30-015-23599,HUMIDOR BMO STATE COM 003,2021-07-01,178,0,3134,127,39,602463,23344
300152359900,30-015-23599,HUMIDOR BMO STATE COM 003,2021-08-01,179,0,2207,81,39,604670,23425
300152359900,30-015-23599,HUMIDOR BMO STATE COM 003,2021-09-01,180,0,2496,98,39,607166,23523
300152359900,30-015-23599,HUMIDOR BMO STATE COM 003,2021-10-01,181,0,2588,99,39,609754,23622
300152359900,30-015-23599,HUMIDOR BMO STATE COM 003,2021-11-01,182,0,2982,102,39,612736,23724
300152359900,30-015-23599,HUMIDOR BMO STATE COM 003,2021-12-01,183,0,2637,6,39,615373,23730
300152359900,30-015-23599,HUMIDOR BMO STATE COM 003,2022-01-01,184,0,1992,0,39,617365,23730
300152359900,30-015-23599,HUMIDOR BMO STATE COM 003,2022-02-01,185,0,1267,2,39,618632,23732
300152359900,30-015-23599,HUMIDOR BMO STATE COM 003,2022-03-01,186,0,1293,5,39,619925,23737
300152359900,30-015-23599,HUMIDOR BMO STATE COM 003,2022-04-01,187,0,1183,0,39,621108,23737
300152359900,30-015-23599,HUMIDOR BMO STATE COM 003,2022-05-01,188,0,1086,0,39,622194,23737
300152359900,30-015-23599,HUMIDOR BMO STATE COM 003,2022-06-01,189,0,1022,0,39,623216,23737
300152359900,30-015-23599,HUMIDOR BMO STATE COM 003,2022-07-01,190,0,1073,0,39,624289,23737
300152359900,30-015-23599,HUMIDOR BMO STATE COM 003,2022-08-01,191,0,1092,0,39,625381,23737
300152359900,30-015-23599,HUMIDOR BMO STATE COM 003,2022-09-01,192,0,1048,0,39,626429,23737
300152359900,30-015-23599,HUMIDOR BMO STATE COM 003,2022-10-01,193,0,1086,0,39,627515,23737
300152359900,30-015-23599,HUMIDOR BMO STATE COM 003,2022-11-01,194,0,1094,0,39,628609,23737
300152359900,30-015-23599,HUMIDOR BMO STATE COM 003,2022-12-01,195,0,1168,0,39,629777,23737
300152359900,30-015-23599,HUMIDOR BMO STATE COM 003,2023-01-01,196,0,1176,0,39,630953,23737
300152359900,30-015-23599,HUMIDOR BMO STATE COM 003,2023-02-01,197,0,1101,0,39,632054,23737
300152359900,30-015-23599,HUMIDOR BMO STATE COM 003,2023-03-01,198,0,1154,0,39,633208,23737
300152359900,30-015-23599,HUMIDOR BMO STATE COM 003,2023-04-01,199,0,1085,0,39,634293,23737
300152359900,30-015-23599,HUMIDOR BMO STATE COM 003,2023-05-01,200,0,1182,0,39,635475,23737
300152359900,30-015-23599,HUMIDOR BMO STATE COM 003,2023-06-01,201,0,1136,0,39,636611,23737
300152359900,30-015-23599,HUMIDOR BMO STATE COM 003,2023-07-01,202,0,1159,0,39,637770,23737
300154407001,30-015-44070,BLACK RIVER 15 10 STATE COM X 005H,2018-02-01,1,0,0,259,0,0,259
300154407001,30-015-44070,BLACK RIVER 15 10 STATE COM X 005H,2018-03-01,2,21596,134786,86564,21596,134786,86823
300154407001,30-015-44070,BLACK RIVER 15 10 STATE COM X 005H,2018-04-01,3,18979,40786,40954,40575,175572,127777
300154407001,30-015-44070,BLACK RIVER 15 10 STATE COM X 005H,2018-05-01,4,22632,53139,60290,63207,228711,188067
300154407001,30-015-44070,BLACK RIVER 15 10 STATE COM X 005H,2018-06-01,5,14321,30493,35917,77528,259204,223984
300154407001,30-015-44070,BLACK RIVER 15 10 STATE COM X 005H,2018-07-01,6,15382,43878,49018,92910,303082,273002
300154407001,30-015-44070,BLACK RIVER 15 10 STATE COM X 005H,2018-08-01,7,12278,32227,36952,105188,335309,309954
300154407001,30-015-44070,BLACK RIVER 15 10 STATE COM X 005H,2018-09-01,8,11483,47640,45751,116671,382949,355705
300154407001,30-015-44070,BLACK RIVER 15 10 STATE COM X 005H,2018-10-01,9,8573,34493,34657,125244,417442,390362
300154407001,30-015-44070,BLACK RIVER 15 10 STATE COM X 005H,2018-11-01,10,8240,28985,30690,133484,446427,421052
300154407001,30-015-44070,BLACK RIVER 15 10 STATE COM X 005H,2018-12-01,11,7505,47371,42153,140989,493798,463205
300154407001,30-015-44070,BLACK RIVER 15 10 STATE COM X 005H,2019-01-01,12,7523,54635,33554,148512,548433,496759
300154407001,30-015-44070,BLACK RIVER 15 10 STATE COM X 005H,2019-02-01,13,6669,39402,28782,155181,587835,525541
300154407001,30-015-44070,BLACK RIVER 15 10 STATE COM X 005H,2019-03-01,14,7434,51532,43074,162615,639367,568615
300154407001,30-015-44070,BLACK RIVER 15 10 STATE COM X 005H,2019-04-01,15,4033,12584,8411,166648,651951,577026
300154407001,30-015-44070,BLACK RIVER 15 10 STATE COM X 005H,2019-05-01,16,5151,30734,20315,171799,682685,597341
300154407001,30-015-44070,BLACK RIVER 15 10 STATE COM X 005H,2019-06-01,17,4861,26883,14894,176660,709568,612235
300154407001,30-015-44070,BLACK RIVER 15 10 STATE COM X 005H,2019-07-01,18,5212,31441,19090,181872,741009,631325
300154407001,30-015-44070,BLACK RIVER 15 10 STATE COM X 005H,2019-08-01,19,6044,27627,24426,187916,768636,655751
300154407001,30-015-44070,BLACK RIVER 15 10 STATE COM X 005H,2019-09-01,20,5128,32246,28493,193044,800882,684244
300154407001,30-015-44070,BLACK RIVER 15 10 STATE COM X 005H,2019-10-01,21,5227,51157,35576,198271,852039,719820
300154407001,30-015-44070,BLACK RIVER 15 10 STATE COM X 005H,2019-11-01,22,4898,42122,29439,203169,894161,749259
300154407001,30-015-44070,BLACK RIVER 15 10 STATE COM X 005H,2019-12-01,23,4158,50475,32076,207327,944636,781335
300154407001,30-015-44070,BLACK RIVER 15 10 STATE COM X 005H,2020-01-01,24,3367,43542,19780,210694,988178,801115
300154407001,30-015-44070,BLACK RIVER 15 10 STATE COM X 005H,2020-02-01,25,3686,38443,15252,214380,1026621,816367
300154407001,30-015-44070,BLACK RIVER 15 10 STATE COM X 005H,2020-03-01,26,4293,49844,26513,218673,1076465,842880
300154407001,30-015-44070,BLACK RIVER 15 10 STATE COM X 005H,2020-04-01,27,4076,50468,30720,222749,1126933,873600
300154407001,30-015-44070,BLACK RIVER 15 10 STATE COM X 005H,2020-05-01,28,3737,51630,29035,226486,1178563,902635
300154407001,30-015-44070,BLACK RIVER 15 10 STATE COM X 005H,2020-06-01,29,3338,37541,22736,229824,1216104,925371
300154407001,30-015-44070,BLACK RIVER 15 10 STATE COM X 005H,2020-07-01,30,2847,22618,17521,232671,1238722,942892
300154407001,30-015-44070,BLACK RIVER 15 10 STATE COM X 005H,2020-08-01,31,3712,32373,27481,236383,1271095,970373
300154407001,30-015-44070,BLACK RIVER 15 10 STATE COM X 005H,2020-09-01,32,2785,28992,17886,239168,1300087,988259
300154407001,30-015-44070,BLACK RIVER 15 10 STATE COM X 005H,2020-10-01,33,2476,10572,13140,241644,1310659,1001399
300154407001,30-015-44070,BLACK RIVER 15 10 STATE COM X 005H,2020-11-01,34,2481,22087,10859,244125,1332746,1012258
300154407001,30-015-44070,BLACK RIVER 15 10 STATE COM X 005H,2020-12-01,35,2487,19173,9971,246612,1351919,1022229
300154407001,30-015-44070,BLACK RIVER 15 10 STATE COM X 005H,2021-01-01,36,2097,18706,10289,248709,1370625,1032518
300154407001,30-015-44070,BLACK RIVER 15 10 STATE COM X 005H,2021-02-01,37,1987,14011,4936,250696,1384636,1037454
300154407001,30-015-44070,BLACK RIVER 15 10 STATE COM X 005H,2021-03-01,38,3136,27594,13997,253832,1412230,1051451
300154407001,30-015-44070,BLACK RIVER 15 10 STATE COM X 005H,2021-04-01,39,2908,27374,15865,256740,1439604,1067316
300154407001,30-015-44070,BLACK RIVER 15 10 STATE COM X 005H,2021-05-01,40,2810,22796,10267,259550,1462400,1077583
300154407001,30-015-44070,BLACK RIVER 15 10 STATE COM X 005H,2021-06-01,41,2161,24394,15378,261711,1486794,1092961
300154407001,30-015-44070,BLACK RIVER 15 10 STATE COM X 005H,2021-07-01,42,2784,26511,17642,264495,1513305,1110603
300154407001,30-015-44070,BLACK RIVER 15 10 STATE COM X 005H,2021-08-01,43,2406,29885,18614,266901,1543190,1129217
300154407001,30-015-44070,BLACK RIVER 15 10 STATE COM X 005H,2021-09-01,44,1719,21674,7998,268620,1564864,1137215
300154407001,30-015-44070,BLACK RIVER 15 10 STATE COM X 005H,2021-10-01,45,2486,22503,10936,271106,1587367,1148151
300154407001,30-015-44070,BLACK RIVER 15 10 STATE COM X 005H,2021-11-01,46,2890,20428,14858,273996,1607795,1163009
300154407001,30-015-44070,BLACK RIVER 15 10 STATE COM X 005H,2021-12-01,47,890,17766,8646,274886,1625561,1171655
300154407001,30-015-44070,BLACK RIVER 15 10 STATE COM X 005H,2022-01-01,48,1638,13543,7220,276524,1639104,1178875
300154407001,30-015-44070,BLACK RIVER 15 10 STATE COM X 005H,2022-02-01,49,1956,17405,9120,278480,1656509,1187995
300154407001,30-015-44070,BLACK RIVER 15 10 STATE COM X 005H,2022-03-01,50,2452,22435,13423,280932,1678944,1201418
300154407001,30-015-44070,BLACK RIVER 15 10 STATE COM X 005H,2022-04-01,51,2503,20130,14689,283435,1699074,1216107
300154407001,30-015-44070,BLACK RIVER 15 10 STATE COM X 005H,2022-05-01,52,2495,23451,18461,285930,1722525,1234568
300154407001,30-015-44070,BLACK RIVER 15 10 STATE COM X 005H,2022-06-01,53,2044,22973,16997,287974,1745498,1251565
300154407001,30-015-44070,BLACK RIVER 15 10 STATE COM X 005H,2022-07-01,54,1827,19998,14383,289801,1765496,1265948
300154407001,30-015-44070,BLACK RIVER 15 10 STATE COM X 005H,2022-08-01,55,934,24146,17247,290735,1789642,1283195
300154407001,30-015-44070,BLACK RIVER 15 10 STATE COM X 005H,2022-09-01,56,1951,20782,16350,292686,1810424,1299545
300154407001,30-015-44070,BLACK RIVER 15 10 STATE COM X 005H,2022-10-01,57,2026,23183,17808,294712,1833607,1317353
300154407001,30-015-44070,BLACK RIVER 15 10 STATE COM X 005H,2022-11-01,58,2004,23425,18830,296716,1857032,1336183
300154407001,30-015-44070,BLACK RIVER 15 10 STATE COM X 005H,2022-12-01,59,1351,18132,8150,298067,1875164,1344333
300154407001,30-015-44070,BLACK RIVER 15 10 STATE COM X 005H,2023-01-01,60,1958,20132,15727,300025,1895296,1360060
300154407001,30-015-44070,BLACK RIVER 15 10 STATE COM X 005H,2023-02-01,61,1881,21587,17988,301906,1916883,1378048
300154407001,30-015-44070,BLACK RIVER 15 10 STATE COM X 005H,2023-03-01,62,1852,21589,16411,303758,1938472,1394459
300154407001,30-015-44070,BLACK RIVER 15 10 STATE COM X 005H,2023-04-01,63,1781,21244,16786,305539,1959716,1411245
300154407001,30-015-44070,BLACK RIVER 15 10 STATE COM X 005H,2023-05-01,64,1846,21896,17420,307385,1981612,1428665
300154407001,30-015-44070,BLACK RIVER 15 10 STATE COM X 005H,2023-06-01,65,1530,18940,14234,308915,2000552,1442899
300154596500,30-015-45965,TONY LA RUSSA STATE COM 202H,2019-08-01,1,24,59,21290,24,59,21290
300154596500,30-015-45965,TONY LA RUSSA STATE COM 202H,2019-09-01,2,21643,43712,130514,21667,43771,151804
300154596500,30-015-45965,TONY LA RUSSA STATE COM 202H,2019-10-01,3,19872,37897,74657,41539,81668,226461
300154596500,30-015-45965,TONY LA RUSSA STATE COM 202H,2019-11-01,4,14975,30158,52556,56514,111826,279017
300154596500,30-015-45965,TONY LA RUSSA STATE COM 202H,2019-12-01,5,12430,26433,47306,68944,138259,326323
300154596500,30-015-45965,TONY LA RUSSA STATE COM 202H,2020-01-01,6,10519,27973,43344,79463,166232,369667
300154596500,30-015-45965,TONY LA RUSSA STATE COM 202H,2020-02-01,7,8185,22763,34066,87648,188995,403733
300154596500,30-015-45965,TONY LA RUSSA STATE COM 202H,2020-03-01,8,7419,21982,32901,95067,210977,436634
300154596500,30-015-45965,TONY LA RUSSA STATE COM 202H,2020-04-01,9,6569,18547,28621,101636,229524,465255
300154596500,30-015-45965,TONY LA RUSSA STATE COM 202H,2020-05-01,10,6337,18071,24417,107973,247595,489672
300154596500,30-015-45965,TONY LA RUSSA STATE COM 202H,2020-06-01,11,5531,17289,22759,113504,264884,512431
300154596500,30-015-45965,TONY LA RUSSA STATE COM 202H,2020-07-01,12,5513,17464,22588,119017,282348,535019
300154596500,30-015-45965,TONY LA RUSSA STATE COM 202H,2020-08-01,13,5178,18057,22736,124195,300405,557755
300154596500,30-015-45965,TONY LA RUSSA STATE COM 202H,2020-09-01,14,4853,16936,21044,129048,317341,578799
300154596500,30-015-45965,TONY LA RUSSA STATE COM 202H,2020-10-01,15,4832,15688,19585,133880,333029,598384
300154596500,30-015-45965,TONY LA RUSSA STATE COM 202H,2020-11-01,16,4034,12847,16963,137914,345876,615347
300154596500,30-015-45965,TONY LA RUSSA STATE COM 202H,2020-12-01,17,3661,13240,13393,141575,359116,628740
300154596500,30-015-45965,TONY LA RUSSA STATE COM 202H,2021-01-01,18,4259,14358,19562,145834,373474,648302
300154596500,30-015-45965,TONY LA RUSSA STATE COM 202H,2021-02-01,19,3158,11158,14544,148992,384632,662846
300154596500,30-015-45965,TONY LA RUSSA STATE COM 202H,2021-03-01,20,3955,12273,16934,152947,396905,679780
300154596500,30-015-45965,TONY LA RUSSA STATE COM 202H,2021-04-01,21,3504,12498,16907,156451,409403,696687
300154596500,30-015-45965,TONY LA RUSSA STATE COM 202H,2021-05-01,22,3385,12651,17161,159836,422054,713848
300154596500,30-015-45965,TONY LA RUSSA STATE COM 202H,2021-06-01,23,3200,13098,17464,163036,435152,731312
300154596500,30-015-45965,TONY LA RUSSA STATE COM 202H,2021-07-01,24,3201,13713,19985,166237,448865,751297
300154596500,30-015-45965,TONY LA RUSSA STATE COM 202H,2021-08-01,25,3134,12853,18402,169371,461718,769699
300154596500,30-015-45965,TONY LA RUSSA STATE COM 202H,2021-09-01,26,2936,11187,16071,172307,472905,785770
300154596500,30-015-45965,TONY LA RUSSA STATE COM 202H,2021-10-01,27,3104,12949,18367,175411,485854,804137
300154596500,30-015-45965,TONY LA RUSSA STATE COM 202H,2021-11-01,28,2808,12297,16634,178219,498151,820771
300154596500,30-015-45965,TONY LA RUSSA STATE COM 202H,2021-12-01,29,2902,12481,16910,181121,510632,837681
300154596500,30-015-45965,TONY LA RUSSA STATE COM 202H,2022-01-01,30,2623,10281,14397,183744,520913,852078
300154596500,30-015-45965,TONY LA RUSSA STATE COM 202H,2022-02-01,31,2440,9832,13903,186184,530745,865981
300154596500,30-015-45965,TONY LA RUSSA STATE COM 202H,2022-03-01,32,2361,9415,12744,188545,540160,878725
300154596500,30-015-45965,TONY LA RUSSA STATE COM 202H,2022-04-01,33,2537,9913,13814,191082,550073,892539
300154596500,30-015-45965,TONY LA RUSSA STATE COM 202H,2022-05-01,34,2521,10365,14066,193603,560438,906605
300154596500,30-015-45965,TONY LA RUSSA STATE COM 202H,2022-06-01,35,1632,7448,10330,195235,567886,916935
300154596500,30-015-45965,TONY LA RUSSA STATE COM 202H,2022-07-01,36,716,1577,16619,195951,569463,933554
300154596500,30-015-45965,TONY LA RUSSA STATE COM 202H,2022-08-01,37,2012,3763,24174,197963,573226,957728
300154596500,30-015-45965,TONY LA RUSSA STATE COM 202H,2022-09-01,38,1614,6225,18026,199577,579451,975754
300154596500,30-015-45965,TONY LA RUSSA STATE COM 202H,2022-10-01,39,1549,1389,14576,201126,580840,990330
300154596500,30-015-45965,TONY LA RUSSA STATE COM 202H,2022-11-01,40,288,1142,7749,201414,581982,998079
300154596500,30-015-45965,TONY LA RUSSA STATE COM 202H,2022-12-01,41,2192,4891,18389,203606,586873,1016468
300154596500,30-015-45965,TONY LA RUSSA STATE COM 202H,2023-01-01,42,2579,5927,18790,206185,592800,1035258
300154596500,30-015-45965,TONY LA RUSSA STATE COM 202H,2023-02-01,43,2753,7838,20031,208938,600638,1055289
300154596500,30-015-45965,TONY LA RUSSA STATE COM 202H,2023-03-01,44,2323,6629,18736,211261,607267,1074025
300154596500,30-015-45965,TONY LA RUSSA STATE COM 202H,2023-04-01,45,2161,6130,18363,213422,613397,1092388
300154596500,30-015-45965,TONY LA RUSSA STATE COM 202H,2023-05-01,46,2118,5959,17631,215540,619356,1110019
300154596500,30-015-45965,TONY LA RUSSA STATE COM 202H,2023-06-01,47,2086,5058,14651,217626,624414,1124670
300154612700,30-015-46127,QUIEN SABE FEDERAL COM 602H,2020-02-01,1,25346,50340,95945,25346,50340,95945
300154612700,30-015-46127,QUIEN SABE FEDERAL COM 602H,2020-03-01,2,50974,108846,143604,76320,159186,239549
300154612700,30-015-46127,QUIEN SABE FEDERAL COM 602H,2020-04-01,3,42163,93552,122632,118483,252738,362181
300154612700,30-015-46127,QUIEN SABE FEDERAL COM 602H,2020-05-01,4,35360,78330,110063,153843,331068,472244
300154612700,30-015-46127,QUIEN SABE FEDERAL COM 602H,2020-06-01,5,25471,54202,80262,179314,385270,552506
300154612700,30-015-46127,QUIEN SABE FEDERAL COM 602H,2020-07-01,6,23919,50271,81197,203233,435541,633703
300154612700,30-015-46127,QUIEN SABE FEDERAL COM 602H,2020-08-01,7,19890,50197,68397,223123,485738,702100
300154612700,30-015-46127,QUIEN SABE FEDERAL COM 602H,2020-09-01,8,16241,42355,57254,239364,528093,759354
300154612700,30-015-46127,QUIEN SABE FEDERAL COM 602H,2020-10-01,9,16609,47918,61202,255973,576011,820556
300154612700,30-015-46127,QUIEN SABE FEDERAL COM 602H,2020-11-01,10,13609,43711,56234,269582,619722,876790
300154612700,30-015-46127,QUIEN SABE FEDERAL COM 602H,2020-12-01,11,12140,47221,56731,281722,666943,933521
300154612700,30-015-46127,QUIEN SABE FEDERAL COM 602H,2021-01-01,12,11357,41634,53566,293079,708577,987087
300154612700,30-015-46127,QUIEN SABE FEDERAL COM 602H,2021-02-01,13,8121,26901,34284,301200,735478,1021371
300154612700,30-015-46127,QUIEN SABE FEDERAL COM 602H,2021-03-01,14,10408,38334,49325,311608,773812,1070696
300154612700,30-015-46127,QUIEN SABE FEDERAL COM 602H,2021-04-01,15,8542,37946,43361,320150,811758,1114057
300154612700,30-015-46127,QUIEN SABE FEDERAL COM 602H,2021-05-01,16,8518,37313,48870,328668,849071,1162927
300154612700,30-015-46127,QUIEN SABE FEDERAL COM 602H,2021-06-01,17,5722,35806,35312,334390,884877,1198239
300154612700,30-015-46127,QUIEN SABE FEDERAL COM 602H,2021-07-01,18,7455,32866,41489,341845,917743,1239728
300154612700,30-015-46127,QUIEN SABE FEDERAL COM 602H,2021-08-01,19,7982,28893,38146,349827,946636,1277874
300154612700,30-015-46127,QUIEN SABE FEDERAL COM 602H,2021-09-01,20,7121,31133,37926,356948,977769,1315800
300154612700,30-015-46127,QUIEN SABE FEDERAL COM 602H,2021-10-01,21,7781,31601,38149,364729,1009370,1353949
300154612700,30-015-46127,QUIEN SABE FEDERAL COM 602H,2021-11-01,22,7548,26311,32667,372277,1035681,1386616
300154612700,30-015-46127,QUIEN SABE FEDERAL COM 602H,2021-12-01,23,7358,26202,34261,379635,1061883,1420877
300154612700,30-015-46127,QUIEN SABE FEDERAL COM 602H,2022-01-01,24,7110,30056,35367,386745,1091939,1456244
300154612700,30-015-46127,QUIEN SABE FEDERAL COM 602H,2022-02-01,25,3915,20202,21133,390660,1112141,1477377
300154612700,30-015-46127,QUIEN SABE FEDERAL COM 602H,2022-03-01,26,2173,13917,9714,392833,1126058,1487091
300154612700,30-015-46127,QUIEN SABE FEDERAL COM 602H,2022-04-01,27,4884,19901,23601,397717,1145959,1510692
300154612700,30-015-46127,QUIEN SABE FEDERAL COM 602H,2022-05-01,28,4032,19864,23406,401749,1165823,1534098
300154612700,30-015-46127,QUIEN SABE FEDERAL COM 602H,2022-06-01,29,6120,25367,30620,407869,1191190,1564718
300154612700,30-015-46127,QUIEN SABE FEDERAL COM 602H,2022-07-01,30,5498,28904,29235,413367,1220094,1593953
300154612700,30-015-46127,QUIEN SABE FEDERAL COM 602H,2022-08-01,31,5309,27310,30237,418676,1247404,1624190
300154612700,30-015-46127,QUIEN SABE FEDERAL COM 602H,2022-09-01,32,4885,27816,30648,423561,1275220,1654838
300154612700,30-015-46127,QUIEN SABE FEDERAL COM 602H,2022-10-01,33,4787,27340,28896,428348,1302560,1683734
300154612700,30-015-46127,QUIEN SABE FEDERAL COM 602H,2022-11-01,34,5080,20791,28079,433428,1323351,1711813
300154612700,30-015-46127,QUIEN SABE FEDERAL COM 602H,2022-12-01,35,1566,11129,12243,434994,1334480,1724056
300154612700,30-015-46127,QUIEN SABE FEDERAL COM 602H,2023-01-01,36,2929,15130,15444,437923,1349610,1739500
300154612700,30-015-46127,QUIEN SABE FEDERAL COM 602H,2023-02-01,37,4499,15460,20968,442422,1365070,1760468
300154612700,30-015-46127,QUIEN SABE FEDERAL COM 602H,2023-03-01,38,4585,21706,25458,447007,1386776,1785926
300154612700,30-015-46127,QUIEN SABE FEDERAL COM 602H,2023-04-01,39,1941,5407,4340,448948,1392183,1790266
300154612700,30-015-46127,QUIEN SABE FEDERAL COM 602H,2023-05-01,40,15527,24033,9864,464475,1416216,1800130
300154612700,30-015-46127,QUIEN SABE FEDERAL COM 602H,2023-06-01,41,8306,19446,10685,472781,1435662,1810815
300154612700,30-015-46127,QUIEN SABE FEDERAL COM 602H,2023-07-01,42,8260,16936,22508,481041,1452598,1833323
300153249900,30-015-32499,WEST LOVING 11 FEDERAL COM 001,2003-01-01,1,0,21150,175,0,21150,175
300153249900,30-015-32499,WEST LOVING 11 FEDERAL COM 001,2003-02-01,2,0,19994,93,0,41144,268
300153249900,30-015-32499,WEST LOVING 11 FEDERAL COM 001,2003-03-01,3,0,20550,124,0,61694,392
300153249900,30-015-32499,WEST LOVING 11 FEDERAL COM 001,2003-04-01,4,0,14799,47,0,76493,439
300153249900,30-015-32499,WEST LOVING 11 FEDERAL COM 001,2003-05-01,5,0,12517,19,0,89010,458
300153249900,30-015-32499,WEST LOVING 11 FEDERAL COM 001,2003-06-01,6,0,9868,56,0,98878,514
300153249900,30-015-32499,WEST LOVING 11 FEDERAL COM 001,2003-07-01,7,0,10433,50,0,109311,564
300153249900,30-015-32499,WEST LOVING 11 FEDERAL COM 001,2003-08-01,8,0,9702,10,0,119013,574
300153249900,30-015-32499,WEST LOVING 11 FEDERAL COM 001,2003-09-01,9,0,6179,0,0,125192,574
300153249900,30-015-32499,WEST LOVING 11 FEDERAL COM 001,2003-10-01,10,0,4476,0,0,129668,574
300153249900,30-015-32499,WEST LOVING 11 FEDERAL COM 001,2003-11-01,11,0,7195,48,0,136863,622
300153249900,30-015-32499,WEST LOVING 11 FEDERAL COM 001,2003-12-01,12,22,10116,70,22,146979,692
300153249900,30-015-32499,WEST LOVING 11 FEDERAL COM 001,2004-01-01,13,0,9699,29,22,156678,721
300153249900,30-015-32499,WEST LOVING 11 FEDERAL COM 001,2004-02-01,14,0,9688,44,22,166366,765
300153249900,30-015-32499,WEST LOVING 11 FEDERAL COM 001,2004-03-01,15,0,11244,42,22,177610,807
300153249900,30-015-32499,WEST LOVING 11 FEDERAL COM 001,2004-04-01,16,0,11556,55,22,189166,862
300153249900,30-015-32499,WEST LOVING 11 FEDERAL COM 001,2004-05-01,17,0,8910,23,22,198076,885
300153249900,30-015-32499,WEST LOVING 11 FEDERAL COM 001,2004-06-01,18,0,6629,17,22,204705,902
300153249900,30-015-32499,WEST LOVING 11 FEDERAL COM 001,2004-07-01,19,0,5143,19,22,209848,921
300153249900,30-015-32499,WEST LOVING 11 FEDERAL COM 001,2004-08-01,20,0,8491,52,22,218339,973
300153249900,30-015-32499,WEST LOVING 11 FEDERAL COM 001,2004-09-01,21,0,9015,18,22,227354,991
300153249900,30-015-32499,WEST LOVING 11 FEDERAL COM 001,2004-10-01,22,0,7909,7,22,235263,998
300153249900,30-015-32499,WEST LOVING 11 FEDERAL COM 001,2004-11-01,23,0,7187,21,22,242450,1019
300153249900,30-015-32499,WEST LOVING 11 FEDERAL COM 001,2004-12-01,24,0,7123,7,22,249573,1026
300153249900,30-015-32499,WEST LOVING 11 FEDERAL COM 001,2005-01-01,25,0,6265,76,22,255838,1102
300153249900,30-015-32499,WEST LOVING 11 FEDERAL COM 001,2005-02-01,26,0,5856,26,22,261694,1128
300153249900,30-015-32499,WEST LOVING 11 FEDERAL COM 001,2005-03-01,27,0,6101,11,22,267795,1139
300153249900,30-015-32499,WEST LOVING 11 FEDERAL COM 001,2005-04-01,28,0,5265,2,22,273060,1141
300153249900,30-015-32499,WEST LOVING 11 FEDERAL COM 001,2005-05-01,29,0,4560,14,22,277620,1155
300153249900,30-015-32499,WEST LOVING 11 FEDERAL COM 001,2005-06-01,30,0,7695,53,22,285315,1208
300153249900,30-015-32499,WEST LOVING 11 FEDERAL COM 001,2005-07-01,31,0,6421,73,22,291736,1281
300153249900,30-015-32499,WEST LOVING 11 FEDERAL COM 001,2005-08-01,32,0,6017,11,22,297753,1292
300153249900,30-015-32499,WEST LOVING 11 FEDERAL COM 001,2005-09-01,33,0,3343,0,22,301096,1292
300153249900,30-015-32499,WEST LOVING 11 FEDERAL COM 001,2005-10-01,34,0,3846,1,22,304942,1293
300153249900,30-015-32499,WEST LOVING 11 FEDERAL COM 001,2005-11-01,35,0,3432,2,22,308374,1295
300153249900,30-015-32499,WEST LOVING 11 FEDERAL COM 001,2005-12-01,36,0,2605,0,22,310979,1295
300153249900,30-015-32499,WEST LOVING 11 FEDERAL COM 001,2006-01-01,37,0,5017,18,22,315996,1313
300153249900,30-015-32499,WEST LOVING 11 FEDERAL COM 001,2006-02-01,38,0,4302,19,22,320298,1332
300153249900,30-015-32499,WEST LOVING 11 FEDERAL COM 001,2006-03-01,39,0,6445,1,22,326743,1333
300153249900,30-015-32499,WEST LOVING 11 FEDERAL COM 001,2006-04-01,40,0,6097,11,22,332840,1344
300153249900,30-015-32499,WEST LOVING 11 FEDERAL COM 001,2006-05-01,41,0,2961,0,22,335801,1344
300153249900,30-015-32499,WEST LOVING 11 FEDERAL COM 001,2006-06-01,42,0,5188,0,22,340989,1344
300153249900,30-015-32499,WEST LOVING 11 FEDERAL COM 001,2006-07-01,43,0,3850,9,22,344839,1353
300153249900,30-015-32499,WEST LOVING 11 FEDERAL COM 001,2006-08-01,44,0,8209,109,22,353048,1462
300153249900,30-015-32499,WEST LOVING 11 FEDERAL COM 001,2006-09-01,45,0,8797,114,22,361845,1576
300153249900,30-015-32499,WEST LOVING 11 FEDERAL COM 001,2006-10-01,46,0,7799,16,22,369644,1592
300153249900,30-015-32499,WEST LOVING 11 FEDERAL COM 001,2006-11-01,47,0,7471,9,22,377115,1601
300153249900,30-015-32499,WEST LOVING 11 FEDERAL COM 001,2006-12-01,48,0,6860,2,22,383975,1603
300153249900,30-015-32499,WEST LOVING 11 FEDERAL COM 001,2007-01-01,49,0,5992,7,22,389967,1610
300153249900,30-015-32499,WEST LOVING 11 FEDERAL COM 001,2007-02-01,50,0,5332,123,22,395299,1733
300153249900,30-015-32499,WEST LOVING 11 FEDERAL COM 001,2007-03-01,51,0,5338,0,22,400637,1733
300153249900,30-015-32499,WEST LOVING 11 FEDERAL COM 001,2007-04-01,52,0,7033,3,22,407670,1736
300153249900,30-015-32499,WEST LOVING 11 FEDERAL COM 001,2007-05-01,53,0,8399,0,22,416069,1736
300153249900,30-015-32499,WEST LOVING 11 FEDERAL COM 001,2007-06-01,54,0,7865,42,22,423934,1778
300153249900,30-015-32499,WEST LOVING 11 FEDERAL COM 001,2007-07-01,55,0,7834,8,22,431768,1786
300153249900,30-015-32499,WEST LOVING 11 FEDERAL COM 001,2007-08-01,56,0,7876,17,22,439644,1803
300153249900,30-015-32499,WEST LOVING 11 FEDERAL COM 001,2007-09-01,57,0,6892,5,22,446536,1808
300153249900,30-015-32499,WEST LOVING 11 FEDERAL COM 001,2007-10-01,58,0,6756,6,22,453292,1814
300153249900,30-015-32499,WEST LOVING 11 FEDERAL COM 001,2007-11-01,59,0,6036,10,22,459328,1824
300153249900,30-015-32499,WEST LOVING 11 FEDERAL COM 001,2007-12-01,60,0,6645,14,22,465973,1838
300153249900,30-015-32499,WEST LOVING 11 FEDERAL COM 001,2008-01-01,61,0,6426,12,22,472399,1850
300153249900,30-015-32499,WEST LOVING 11 FEDERAL COM 001,2008-02-01,62,0,6268,10,22,478667,1860
300153249900,30-015-32499,WEST LOVING 11 FEDERAL COM 001,2008-03-01,63,0,6756,0,22,485423,1860
300153249900,30-015-32499,WEST LOVING 11 FEDERAL COM 001,2008-04-01,64,0,5291,6,22,490714,1866
300153249900,30-015-32499,WEST LOVING 11 FEDERAL COM 001,2008-05-01,65,0,7223,10,22,497937,1876
300153249900,30-015-32499,WEST LOVING 11 FEDERAL COM 001,2008-06-01,66,0,6330,4,22,504267,1880
300153249900,30-015-32499,WEST LOVING 11 FEDERAL COM 001,2008-07-01,67,0,6322,3,22,510589,1883
300153249900,30-015-32499,WEST LOVING 11 FEDERAL COM 001,2008-08-01,68,0,6753,5,22,517342,1888
300153249900,30-015-32499,WEST LOVING 11 FEDERAL COM 001,2008-09-01,69,0,6078,5,22,523420,1893
300153249900,30-015-32499,WEST LOVING 11 FEDERAL COM 001,2008-10-01,70,0,4569,1,22,527989,1894
300153249900,30-015-32499,WEST LOVING 11 FEDERAL COM 001,2008-11-01,71,0,4397,0,22,532386,1894
300153249900,30-015-32499,WEST LOVING 11 FEDERAL COM 001,2008-12-01,72,0,4970,0,22,537356,1894
300153249900,30-015-32499,WEST LOVING 11 FEDERAL COM 001,2009-01-01,73,0,4302,1,22,541658,1895
300153249900,30-015-32499,WEST LOVING 11 FEDERAL COM 001,2009-02-01,74,0,5679,0,22,547337,1895
300153249900,30-015-32499,WEST LOVING 11 FEDERAL COM 001,2009-03-01,75,0,6535,0,22,553872,1895
300153249900,30-015-32499,WEST LOVING 11 FEDERAL COM 001,2009-04-01,76,0,1144,1,22,555016,1896
300153249900,30-015-32499,WEST LOVING 11 FEDERAL COM 001,2009-05-01,77,0,2760,0,22,557776,1896
300153249900,30-015-32499,WEST LOVING 11 FEDERAL COM 001,2009-06-01,78,0,5968,0,22,563744,1896
300153249900,30-015-32499,WEST LOVING 11 FEDERAL COM 001,2009-07-01,79,0,5904,0,22,569648,1896
300153249900,30-015-32499,WEST LOVING 11 FEDERAL COM 001,2009-08-01,80,0,6131,0,22,575779,1896
300153249900,30-015-32499,WEST LOVING 11 FEDERAL COM 001,2009-09-01,81,0,4807,142,22,580586,2038
300153249900,30-015-32499,WEST LOVING 11 FEDERAL COM 001,2009-10-01,82,0,5706,43,22,586292,2081
300153249900,30-015-32499,WEST LOVING 11 FEDERAL COM 001,2009-11-01,83,0,6076,6,22,592368,2087
300153249900,30-015-32499,WEST LOVING 11 FEDERAL COM 001,2009-12-01,84,0,6324,3,22,598692,2090
300153249900,30-015-32499,WEST LOVING 11 FEDERAL COM 001,2010-01-01,85,0,3507,0,22,602199,2090
300153249900,30-015-32499,WEST LOVING 11 FEDERAL COM 001,2010-02-01,86,0,5346,53,22,607545,2143
300153249900,30-015-32499,WEST LOVING 11 FEDERAL COM 001,2010-03-01,87,0,5287,9,22,612832,2152
300153249900,30-015-32499,WEST LOVING 11 FEDERAL COM 001,2010-04-01,88,0,4272,6,22,617104,2158
300153249900,30-015-32499,WEST LOVING 11 FEDERAL COM 001,2010-05-01,89,0,5288,16,22,622392,2174
300153249900,30-015-32499,WEST LOVING 11 FEDERAL COM 001,2010-06-01,90,0,5655,26,22,628047,2200
300153249900,30-015-32499,WEST LOVING 11 FEDERAL COM 001,2010-07-01,91,0,6535,12,22,634582,2212
300153249900,30-015-32499,WEST LOVING 11 FEDERAL COM 001,2010-08-01,92,0,6714,6,22,641296,2218
300153249900,30-015-32499,WEST LOVING 11 FEDERAL COM 001,2010-09-01,93,0,6317,47,22,647613,2265
300153249900,30-015-32499,WEST LOVING 11 FEDERAL COM 001,2010-10-01,94,0,6622,28,22,654235,2293
300153249900,30-015-32499,WEST LOVING 11 FEDERAL COM 001,2010-11-01,95,0,6541,33,22,660776,2326
300153249900,30-015-32499,WEST LOVING 11 FEDERAL COM 001,2010-12-01,96,0,6182,22,22,666958,2348
300153249900,30-015-32499,WEST LOVING 11 FEDERAL COM 001,2011-01-01,97,0,4511,3,22,671469,2351
300153249900,30-015-32499,WEST LOVING 11 FEDERAL COM 001,2011-02-01,98,0,4703,17,22,676172,2368
300153249900,30-015-32499,WEST LOVING 11 FEDERAL COM 001,2011-03-01,99,0,6730,38,22,682902,2406
300153249900,30-015-32499,WEST LOVING 11 FEDERAL COM 001,2011-04-01,100,0,5283,18,22,688185,2424
300153249900,30-015-32499,WEST LOVING 11 FEDERAL COM 001,2011-05-01,101,0,2412,0,22,690597,2424
300153249900,30-015-32499,WEST LOVING 11 FEDERAL COM 001,2011-06-01,102,0,4190,19,22,694787,2443
300153249900,30-015-32499,WEST LOVING 11 FEDERAL COM 001,2011-07-01,103,0,2296,2,22,697083,2445
300153249900,30-015-32499,WEST LOVING 11 FEDERAL COM 001,2011-08-01,104,0,7048,0,22,704131,2445
300153249900,30-015-32499,WEST LOVING 11 FEDERAL COM 001,2011-09-01,105,0,5998,0,22,710129,2445
300153249900,30-015-32499,WEST LOVING 11 FEDERAL COM 001,2011-10-01,106,0,6870,0,22,716999,2445
300153249900,30-015-32499,WEST LOVING 11 FEDERAL COM 001,2011-11-01,107,0,6068,1,22,723067,2446
300153249900,30-015-32499,WEST LOVING 11 FEDERAL COM 001,2011-12-01,108,0,5262,8,22,728329,2454
300153249900,30-015-32499,WEST LOVING 11 FEDERAL COM 001,2012-01-01,109,0,6305,17,22,734634,2471
300153249900,30-015-32499,WEST LOVING 11 FEDERAL COM 001,2012-02-01,110,0,6209,14,22,740843,2485
300153249900,30-015-32499,WEST LOVING 11 FEDERAL COM 001,2012-03-01,111,0,3689,11,22,744532,2496
300153249900,30-015-32499,WEST LOVING 11 FEDERAL COM 001,2012-04-01,112,0,5284,6,22,749816,2502
300153249900,30-015-32499,WEST LOVING 11 FEDERAL COM 001,2012-05-01,113,0,5168,14,22,754984,2516
300153249900,30-015-32499,WEST LOVING 11 FEDERAL COM 001,2012-06-01,114,0,6213,8,22,761197,2524
300153249900,30-015-32499,WEST LOVING 11 FEDERAL COM 001,2012-07-01,115,0,6306,11,22,767503,2535
300153249900,30-015-32499,WEST LOVING 11 FEDERAL COM 001,2012-08-01,116,0,5933,9,22,773436,2544
300153249900,30-015-32499,WEST LOVING 11 FEDERAL COM 001,2012-09-01,117,0,5516,9,22,778952,2553
300153249900,30-015-32499,WEST LOVING 11 FEDERAL COM 001,2012-10-01,118,0,4141,7,22,783093,2560
300153249900,30-015-32499,WEST LOVING 11 FEDERAL COM 001,2012-11-01,119,0,5949,10,22,789042,2570
300153249900,30-015-32499,WEST LOVING 11 FEDERAL COM 001,2012-12-01,120,0,6032,12,22,795074,2582
300153249900,30-015-32499,WEST LOVING 11 FEDERAL COM 001,2013-01-01,121,0,6440,9,22,801514,2591
300153249900,30-015-32499,WEST LOVING 11 FEDERAL COM 001,2013-02-01,122,0,5568,18,22,807082,2609
300153249900,30-015-32499,WEST LOVING 11 FEDERAL COM 001,2013-03-01,123,0,6268,9,22,813350,2618
300153249900,30-015-32499,WEST LOVING 11 FEDERAL COM 001,2013-04-01,124,0,6044,19,22,819394,2637
300153249900,30-015-32499,WEST LOVING 11 FEDERAL COM 001,2013-05-01,125,0,4833,34,22,824227,2671
300153249900,30-015-32499,WEST LOVING 11 FEDERAL COM 001,2013-06-01,126,0,5966,0,22,830193,2671
300153249900,30-015-32499,WEST LOVING 11 FEDERAL COM 001,2013-07-01,127,0,5062,0,22,835255,2671
300153249900,30-015-32499,WEST LOVING 11 FEDERAL COM 001,2013-08-01,128,0,4430,0,22,839685,2671
300153249900,30-015-32499,WEST LOVING 11 FEDERAL COM 001,2013-09-01,129,0,5372,0,22,845057,2671
300153249900,30-015-32499,WEST LOVING 11 FEDERAL COM 001,2013-10-01,130,0,5585,0,22,850642,2671
300153249900,30-015-32499,WEST LOVING 11 FEDERAL COM 001,2013-11-01,131,0,5856,10,22,856498,2681
300153249900,30-015-32499,WEST LOVING 11 FEDERAL COM 001,2013-12-01,132,0,4643,0,22,861141,2681
300153249900,30-015-32499,WEST LOVING 11 FEDERAL COM 001,2014-01-01,133,0,6567,0,22,867708,2681
300153249900,30-015-32499,WEST LOVING 11 FEDERAL COM 001,2014-02-01,134,0,7118,1,22,874826,2682
300153249900,30-015-32499,WEST LOVING 11 FEDERAL COM 001,2014-03-01,135,0,4803,0,22,879629,2682
300153249900,30-015-32499,WEST LOVING 11 FEDERAL COM 001,2014-04-01,136,0,2859,0,22,882488,2682
300153249900,30-015-32499,WEST LOVING 11 FEDERAL COM 001,2014-05-01,137,0,4939,6,22,887427,2688
300153249900,30-015-32499,WEST LOVING 11 FEDERAL COM 001,2014-06-01,138,0,4441,3,22,891868,2691
300153249900,30-015-32499,WEST LOVING 11 FEDERAL COM 001,2014-07-01,139,0,5990,0,22,897858,2691
300153249900,30-015-32499,WEST LOVING 11 FEDERAL COM 001,2014-08-01,140,0,5171,7,22,903029,2698
300153249900,30-015-32499,WEST LOVING 11 FEDERAL COM 001,2014-09-01,141,0,2560,0,22,905589,2698
300153249900,30-015-32499,WEST LOVING 11 FEDERAL COM 001,2014-10-01,142,0,5085,6,22,910674,2704
300153249900,30-015-32499,WEST LOVING 11 FEDERAL COM 001,2014-11-01,143,0,4498,1,22,915172,2705
300153249900,30-015-32499,WEST LOVING 11 FEDERAL COM 001,2014-12-01,144,0,4472,0,22,919644,2705
300153249900,30-015-32499,WEST LOVING 11 FEDERAL COM 001,2015-01-01,145,0,2224,0,22,921868,2705
300153249900,30-015-32499,WEST LOVING 11 FEDERAL COM 001,2015-02-01,146,0,3920,5,22,925788,2710
300153249900,30-015-32499,WEST LOVING 11 FEDERAL COM 001,2015-03-01,147,0,5197,5,22,930985,2715
300153249900,30-015-32499,WEST LOVING 11 FEDERAL COM 001,2015-04-01,148,0,2460,1,22,933445,2716
300153249900,30-015-32499,WEST LOVING 11 FEDERAL COM 001,2015-05-01,149,0,4141,1,22,937586,2717
300153249900,30-015-32499,WEST LOVING 11 FEDERAL COM 001,2015-06-01,150,0,2903,1,22,940489,2718
300153249900,30-015-32499,WEST LOVING 11 FEDERAL COM 001,2015-07-01,151,0,3031,0,22,943520,2718
300153249900,30-015-32499,WEST LOVING 11 FEDERAL COM 001,2015-08-01,152,0,5672,21,22,949192,2739
300153249900,30-015-32499,WEST LOVING 11 FEDERAL COM 001,2015-09-01,153,0,6949,17,22,956141,2756
300153249900,30-015-32499,WEST LOVING 11 FEDERAL COM 001,2015-10-01,154,0,6453,25,22,962594,2781
300153249900,30-015-32499,WEST LOVING 11 FEDERAL COM 001,2015-11-01,155,0,7857,24,22,970451,2805
300153249900,30-015-32499,WEST LOVING 11 FEDERAL COM 001,2015-12-01,156,0,4451,29,22,974902,2834
300153249900,30-015-32499,WEST LOVING 11 FEDERAL COM 001,2016-01-01,157,0,5698,21,22,980600,2855
300153249900,30-015-32499,WEST LOVING 11 FEDERAL COM 001,2016-02-01,158,0,6720,29,22,987320,2884
300153249900,30-015-32499,WEST LOVING 11 FEDERAL COM 001,2016-03-01,159,0,6072,16,22,993392,2900
300153249900,30-015-32499,WEST LOVING 11 FEDERAL COM 001,2016-04-01,160,0,4961,26,22,998353,2926
300153249900,30-015-32499,WEST LOVING 11 FEDERAL COM 001,2016-05-01,161,0,4775,27,22,1003128,2953
300153249900,30-015-32499,WEST LOVING 11 FEDERAL COM 001,2016-06-01,162,0,5091,10,22,1008219,2963
300153249900,30-015-32499,WEST LOVING 11 FEDERAL COM 001,2016-07-01,163,0,5130,26,22,1013349,2989
300153249900,30-015-32499,WEST LOVING 11 FEDERAL COM 001,2016-08-01,164,0,4501,18,22,1017850,3007
300153249900,30-015-32499,WEST LOVING 11 FEDERAL COM 001,2016-09-01,165,0,4152,11,22,1022002,3018
300153249900,30-015-32499,WEST LOVING 11 FEDERAL COM 001,2016-10-01,166,0,4367,17,22,1026369,3035
300153249900,30-015-32499,WEST LOVING 11 FEDERAL COM 001,2016-11-01,167,0,3952,23,22,1030321,3058
300153249900,30-015-32499,WEST LOVING 11 FEDERAL COM 001,2016-12-01,168,0,4331,18,22,1034652,3076
300153249900,30-015-32499,WEST LOVING 11 FEDERAL COM 001,2017-01-01,169,0,4424,12,22,1039076,3088
300153249900,30-015-32499,WEST LOVING 11 FEDERAL COM 001,2017-02-01,170,0,5110,0,22,1044186,3088
300153249900,30-015-32499,WEST LOVING 11 FEDERAL COM 001,2017-03-01,171,0,5261,14,22,1049447,3102
300153249900,30-015-32499,WEST LOVING 11 FEDERAL COM 001,2017-04-01,172,0,5136,6,22,1054583,3108
300153249900,30-015-32499,WEST LOVING 11 FEDERAL COM 001,2017-05-01,173,0,4891,2,22,1059474,3110
300153249900,30-015-32499,WEST LOVING 11 FEDERAL COM 001,2017-06-01,174,0,5158,3,22,1064632,3113
300153249900,30-015-32499,WEST LOVING 11 FEDERAL COM 001,2017-07-01,175,0,5209,8,22,1069841,3121
300153249900,30-015-32499,WEST LOVING 11 FEDERAL COM 001,2017-08-01,176,0,4952,6,22,1074793,3127
300153249900,30-015-32499,WEST LOVING 11 FEDERAL COM 001,2017-09-01,177,0,4851,5,22,1079644,3132
300153249900,30-015-32499,WEST LOVING 11 FEDERAL COM 001,2017-10-01,178,0,5204,9,22,1084848,3141
300153249900,30-015-32499,WEST LOVING 11 FEDERAL COM 001,2017-11-01,179,0,4515,10,22,1089363,3151
300153249900,30-015-32499,WEST LOVING 11 FEDERAL COM 001,2017-12-01,180,0,5453,11,22,1094816,3162
300153249900,30-015-32499,WEST LOVING 11 FEDERAL COM 001,2018-01-01,181,0,5071,25,22,1099887,3187
300153249900,30-015-32499,WEST LOVING 11 FEDERAL COM 001,2018-02-01,182,0,4619,12,22,1104506,3199
300153249900,30-015-32499,WEST LOVING 11 FEDERAL COM 001,2018-03-01,183,0,4469,8,22,1108975,3207
300153249900,30-015-32499,WEST LOVING 11 FEDERAL COM 001,2018-04-01,184,0,63,0,22,1109038,3207
300153249900,30-015-32499,WEST LOVING 11 FEDERAL COM 001,2018-05-01,185,0,6010,14,22,1115048,3221
300153249900,30-015-32499,WEST LOVING 11 FEDERAL COM 001,2018-06-01,186,0,5172,5,22,1120220,3226
300153249900,30-015-32499,WEST LOVING 11 FEDERAL COM 001,2018-07-01,187,0,4894,15,22,1125114,3241
300153249900,30-015-32499,WEST LOVING 11 FEDERAL COM 001,2018-08-01,188,0,4567,0,22,1129681,3241
300153249900,30-015-32499,WEST LOVING 11 FEDERAL COM 001,2018-09-01,189,0,2884,0,22,1132565,3241
300153249900,30-015-32499,WEST LOVING 11 FEDERAL COM 001,2018-10-01,190,0,4386,0,22,1136951,3241
300153249900,30-015-32499,WEST LOVING 11 FEDERAL COM 001,2018-11-01,191,0,3363,8,22,1140314,3249
300153249900,30-015-32499,WEST LOVING 11 FEDERAL COM 001,2018-12-01,192,0,2801,0,22,1143115,3249
300153249900,30-015-32499,WEST LOVING 11 FEDERAL COM 001,2019-01-01,193,0,2524,0,22,1145639,3249
300153249900,30-015-32499,WEST LOVING 11 FEDERAL COM 001,2019-02-01,194,0,2329,0,22,1147968,3249
300153249900,30-015-32499,WEST LOVING 11 FEDERAL COM 001,2019-03-01,195,0,2134,0,22,1150102,3249
300153249900,30-015-32499,WEST LOVING 11 FEDERAL COM 001,2019-04-01,196,0,132,0,22,1150234,3249
300153249900,30-015-32499,WEST LOVING 11 FEDERAL COM 001,2019-05-01,197,0,745,0,22,1150979,3249
300153249900,30-015-32499,WEST LOVING 11 FEDERAL COM 001,2019-06-01,198,0,547,0,22,1151526,3249
300153249900,30-015-32499,WEST LOVING 11 FEDERAL COM 001,2019-07-01,199,0,615,0,22,1152141,3249
300153249900,30-015-32499,WEST LOVING 11 FEDERAL COM 001,2019-08-01,200,0,580,0,22,1152721,3249
300153249900,30-015-32499,WEST LOVING 11 FEDERAL COM 001,2019-09-01,201,0,4125,0,22,1156846,3249
300153249900,30-015-32499,WEST LOVING 11 FEDERAL COM 001,2019-10-01,202,0,3133,0,22,1159979,3249
300153249900,30-015-32499,WEST LOVING 11 FEDERAL COM 001,2019-11-01,203,0,2856,0,22,1162835,3249
300153249900,30-015-32499,WEST LOVING 11 FEDERAL COM 001,2019-12-01,204,0,2573,0,22,1165408,3249
300153249900,30-015-32499,WEST LOVING 11 FEDERAL COM 001,2020-01-01,205,0,2333,0,22,1167741,3249
300153249900,30-015-32499,WEST LOVING 11 FEDERAL COM 001,2020-02-01,206,0,1684,0,22,1169425,3249
300153249900,30-015-32499,WEST LOVING 11 FEDERAL COM 001,2020-03-01,207,0,262,0,22,1169687,3249
300153249900,30-015-32499,WEST LOVING 11 FEDERAL COM 001,2020-04-01,208,0,245,0,22,1169932,3249
300153249900,30-015-32499,WEST LOVING 11 FEDERAL COM 001,2020-05-01,209,0,2997,0,22,1172929,3249
300153249900,30-015-32499,WEST LOVING 11 FEDERAL COM 001,2020-06-01,210,0,2280,0,22,1175209,3249
300153249900,30-015-32499,WEST LOVING 11 FEDERAL COM 001,2020-07-01,211,0,3444,0,22,1178653,3249
300153249900,30-015-32499,WEST LOVING 11 FEDERAL COM 001,2020-08-01,212,0,617,0,22,1179270,3249
300153249900,30-015-32499,WEST LOVING 11 FEDERAL COM 001,2020-09-01,213,0,5394,0,22,1184664,3249
300153249900,30-015-32499,WEST LOVING 11 FEDERAL COM 001,2020-10-01,214,0,7994,17,22,1192658,3266
300153249900,30-015-32499,WEST LOVING 11 FEDERAL COM 001,2020-11-01,215,0,8515,51,22,1201173,3317
300153249900,30-015-32499,WEST LOVING 11 FEDERAL COM 001,2020-12-01,216,0,9003,45,22,1210176,3362
300153249900,30-015-32499,WEST LOVING 11 FEDERAL COM 001,2021-01-01,217,0,7189,36,22,1217365,3398
300153249900,30-015-32499,WEST LOVING 11 FEDERAL COM 001,2021-02-01,218,0,4889,10,22,1222254,3408
300153249900,30-015-32499,WEST LOVING 11 FEDERAL COM 001,2021-03-01,219,0,8247,15,22,1230501,3423
300153249900,30-015-32499,WEST LOVING 11 FEDERAL COM 001,2021-04-01,220,0,8143,23,22,1238644,3446
300153249900,30-015-32499,WEST LOVING 11 FEDERAL COM 001,2021-05-01,221,0,7161,26,22,1245805,3472
300153249900,30-015-32499,WEST LOVING 11 FEDERAL COM 001,2021-06-01,222,0,6165,32,22,1251970,3504
300153249900,30-015-32499,WEST LOVING 11 FEDERAL COM 001,2021-07-01,223,0,6402,25,22,1258372,3529
300153249900,30-015-32499,WEST LOVING 11 FEDERAL COM 001,2021-08-01,224,0,5624,23,22,1263996,3552
300153249900,30-015-32499,WEST LOVING 11 FEDERAL COM 001,2021-09-01,225,0,6713,25,22,1270709,3577
300153249900,30-015-32499,WEST LOVING 11 FEDERAL COM 001,2021-10-01,226,0,7434,33,22,1278143,3610
300153249900,30-015-32499,WEST LOVING 11 FEDERAL COM 001,2021-11-01,227,0,7771,38,22,1285914,3648
300153249900,30-015-32499,WEST LOVING 11 FEDERAL COM 001,2021-12-01,228,0,929,6,22,1286843,3654
300153249900,30-015-32499,WEST LOVING 11 FEDERAL COM 001,2022-01-01,229,0,6929,18,22,1293772,3672
300153249900,30-015-32499,WEST LOVING 11 FEDERAL COM 001,2022-02-01,230,0,5523,21,22,1299295,3693
300153249900,30-015-32499,WEST LOVING 11 FEDERAL COM 001,2022-03-01,231,0,6426,30,22,1305721,3723
300153249900,30-015-32499,WEST LOVING 11 FEDERAL COM 001,2022-04-01,232,0,6565,24,22,1312286,3747
300153249900,30-015-32499,WEST LOVING 11 FEDERAL COM 001,2022-05-01,233,0,5964,21,22,1318250,3768
300153249900,30-015-32499,WEST LOVING 11 FEDERAL COM 001,2022-06-01,234,0,7296,16,22,1325546,3784
300153249900,30-015-32499,WEST LOVING 11 FEDERAL COM 001,2022-07-01,235,0,5564,11,22,1331110,3795
300153249900,30-015-32499,WEST LOVING 11 FEDERAL COM 001,2022-08-01,236,0,74,1,22,1331184,3796
300153249900,30-015-32499,WEST LOVING 11 FEDERAL COM 001,2022-09-01,237,0,2498,77,22,1333682,3873
300153249900,30-015-32499,WEST LOVING 11 FEDERAL COM 001,2022-10-01,238,0,2913,10,22,1336595,3883
300153249900,30-015-32499,WEST LOVING 11 FEDERAL COM 001,2022-11-01,239,0,5647,23,22,1342242,3906
300153249900,30-015-32499,WEST LOVING 11 FEDERAL COM 001,2022-12-01,240,0,3638,7,22,1345880,3913
300153249900,30-015-32499,WEST LOVING 11 FEDERAL COM 001,2023-01-01,241,0,2126,0,22,1348006,3913
300153249900,30-015-32499,WEST LOVING 11 FEDERAL COM 001,2023-02-01,242,0,3846,1,22,1351852,3914
300153249900,30-015-32499,WEST LOVING 11 FEDERAL COM 001,2023-03-01,243,0,4906,0,22,1356758,3914
300153249900,30-015-32499,WEST LOVING 11 FEDERAL COM 001,2023-04-01,244,0,716,0,22,1357474,3914
300153249900,30-015-32499,WEST LOVING 11 FEDERAL COM 001,2023-05-01,245,0,688,14,22,1358162,3928
300153249900,30-015-32499,WEST LOVING 11 FEDERAL COM 001,2023-06-01,246,0,2167,0,22,1360329,3928
300153249900,30-015-32499,WEST LOVING 11 FEDERAL COM 001,2023-07-01,247,0,3133,0,22,1363462,3928
300154074200,30-015-40742,BOLIVAR BRD FEDERAL COM 001H,2013-06-01,1,8161,11117,31579,8161,11117,31579
300154074200,30-015-40742,BOLIVAR BRD FEDERAL COM 001H,2013-07-01,2,7365,25464,22566,15526,36581,54145
300154074200,30-015-40742,BOLIVAR BRD FEDERAL COM 001H,2013-08-01,3,4575,17915,15418,20101,54496,69563
300154074200,30-015-40742,BOLIVAR BRD FEDERAL COM 001H,2013-09-01,4,3557,14930,12518,23658,69426,82081
300154074200,30-015-40742,BOLIVAR BRD FEDERAL COM 001H,2013-10-01,5,3142,14232,10893,26800,83658,92974
300154074200,30-015-40742,BOLIVAR BRD FEDERAL COM 001H,2013-11-01,6,1776,12191,9372,28576,95849,102346
300154074200,30-015-40742,BOLIVAR BRD FEDERAL COM 001H,2013-12-01,7,3278,10420,9346,31854,106269,111692
300154074200,30-015-40742,BOLIVAR BRD FEDERAL COM 001H,2014-01-01,8,2253,10264,7593,34107,116533,119285
300154074200,30-015-40742,BOLIVAR BRD FEDERAL COM 001H,2014-02-01,9,2088,8582,6645,36195,125115,125930
300154074200,30-015-40742,BOLIVAR BRD FEDERAL COM 001H,2014-03-01,10,1694,7386,5501,37889,132501,131431
300154074200,30-015-40742,BOLIVAR BRD FEDERAL COM 001H,2014-04-01,11,1768,7836,6197,39657,140337,137628
300154074200,30-015-40742,BOLIVAR BRD FEDERAL COM 001H,2014-05-01,12,1739,7763,6106,41396,148100,143734
300154074200,30-015-40742,BOLIVAR BRD FEDERAL COM 001H,2014-06-01,13,1560,6187,5195,42956,154287,148929
300154074200,30-015-40742,BOLIVAR BRD FEDERAL COM 001H,2014-07-01,14,1572,5416,5076,44528,159703,154005
300154074200,30-015-40742,BOLIVAR BRD FEDERAL COM 001H,2014-08-01,15,1415,5779,4553,45943,165482,158558
300154074200,30-015-40742,BOLIVAR BRD FEDERAL COM 001H,2014-09-01,16,901,4104,3045,46844,169586,161603
300154074200,30-015-40742,BOLIVAR BRD FEDERAL COM 001H,2014-10-01,17,1264,3426,3039,48108,173012,164642
300154074200,30-015-40742,BOLIVAR BRD FEDERAL COM 001H,2014-11-01,18,1547,5149,5108,49655,178161,169750
300154074200,30-015-40742,BOLIVAR BRD FEDERAL COM 001H,2014-12-01,19,1360,4197,4865,51015,182358,174615
300154074200,30-015-40742,BOLIVAR BRD FEDERAL COM 001H,2015-01-01,20,1234,5654,4194,52249,188012,178809
300154074200,30-015-40742,BOLIVAR BRD FEDERAL COM 001H,2015-02-01,21,1094,3584,3753,53343,191596,182562
300154074200,30-015-40742,BOLIVAR BRD FEDERAL COM 001H,2015-03-01,22,1204,3672,4127,54547,195268,186689
300154074200,30-015-40742,BOLIVAR BRD FEDERAL COM 001H,2015-04-01,23,1117,4866,3866,55664,200134,190555
300154074200,30-015-40742,BOLIVAR BRD FEDERAL COM 001H,2015-05-01,24,1006,5170,3765,56670,205304,194320
300154074200,30-015-40742,BOLIVAR BRD FEDERAL COM 001H,2015-06-01,25,878,3287,2983,57548,208591,197303
300154074200,30-015-40742,BOLIVAR BRD FEDERAL COM 001H,2015-07-01,26,433,0,1357,57981,208591,198660
300154074200,30-015-40742,BOLIVAR BRD FEDERAL COM 001H,2015-08-01,27,873,1442,2831,58854,210033,201491
300154074200,30-015-40742,BOLIVAR BRD FEDERAL COM 001H,2015-09-01,28,448,1793,1284,59302,211826,202775
300154074200,30-015-40742,BOLIVAR BRD FEDERAL COM 001H,2015-10-01,29,340,1017,791,59642,212843,203566
300154074200,30-015-40742,BOLIVAR BRD FEDERAL COM 001H,2015-11-01,30,1189,3634,2383,60831,216477,205949
300154074200,30-015-40742,BOLIVAR BRD FEDERAL COM 001H,2015-12-01,31,1006,3760,2902,61837,220237,208851
300154074200,30-015-40742,BOLIVAR BRD FEDERAL COM 001H,2016-01-01,32,625,2365,1960,62462,222602,210811
300154074200,30-015-40742,BOLIVAR BRD FEDERAL COM 001H,2016-02-01,33,932,3596,3596,63394,226198,214407
300154074200,30-015-40742,BOLIVAR BRD FEDERAL COM 001H,2016-03-01,34,1348,5041,4445,64742,231239,218852
300154074200,30-015-40742,BOLIVAR BRD FEDERAL COM 001H,2016-04-01,35,1126,5204,3998,65868,236443,222850
300154074200,30-015-40742,BOLIVAR BRD FEDERAL COM 001H,2016-05-01,36,1041,5632,4311,66909,242075,227161
300154074200,30-015-40742,BOLIVAR BRD FEDERAL COM 001H,2016-06-01,37,915,4848,3432,67824,246923,230593
300154074200,30-015-40742,BOLIVAR BRD FEDERAL COM 001H,2016-07-01,38,855,4671,2839,68679,251594,233432
300154074200,30-015-40742,BOLIVAR BRD FEDERAL COM 001H,2016-08-01,39,746,3914,2677,69425,255508,236109
300154074200,30-015-40742,BOLIVAR BRD FEDERAL COM 001H,2016-09-01,40,872,4526,3083,70297,260034,239192
300154074200,30-015-40742,BOLIVAR BRD FEDERAL COM 001H,2016-10-01,41,777,3525,2903,71074,263559,242095
300154074200,30-015-40742,BOLIVAR BRD FEDERAL COM 001H,2016-11-01,42,742,2733,2618,71816,266292,244713
300154074200,30-015-40742,BOLIVAR BRD FEDERAL COM 001H,2016-12-01,43,735,3231,2709,72551,269523,247422
300154074200,30-015-40742,BOLIVAR BRD FEDERAL COM 001H,2017-01-01,44,707,4400,2583,73258,273923,250005
300154074200,30-015-40742,BOLIVAR BRD FEDERAL COM 001H,2017-02-01,45,632,3939,2316,73890,277862,252321
300154074200,30-015-40742,BOLIVAR BRD FEDERAL COM 001H,2017-03-01,46,142,799,515,74032,278661,252836
300154074200,30-015-40742,BOLIVAR BRD FEDERAL COM 001H,2017-04-01,47,0,0,0,74032,278661,252836
300154074200,30-015-40742,BOLIVAR BRD FEDERAL COM 001H,2017-05-01,48,1089,6635,4146,75121,285296,256982
300154074200,30-015-40742,BOLIVAR BRD FEDERAL COM 001H,2017-06-01,49,843,4553,3045,75964,289849,260027
300154074200,30-015-40742,BOLIVAR BRD FEDERAL COM 001H,2017-07-01,50,767,4467,2662,76731,294316,262689
300154074200,30-015-40742,BOLIVAR BRD FEDERAL COM 001H,2017-08-01,51,646,3880,2439,77377,298196,265128
300154074200,30-015-40742,BOLIVAR BRD FEDERAL COM 001H,2017-09-01,52,654,4101,2276,78031,302297,267404
300154074200,30-015-40742,BOLIVAR BRD FEDERAL COM 001H,2017-10-01,53,669,4209,2102,78700,306506,269506
300154074200,30-015-40742,BOLIVAR BRD FEDERAL COM 001H,2017-11-01,54,610,4236,2335,79310,310742,271841
300154074200,30-015-40742,BOLIVAR BRD FEDERAL COM 001H,2017-12-01,55,586,4260,2268,79896,315002,274109
300154074200,30-015-40742,BOLIVAR BRD FEDERAL COM 001H,2018-01-01,56,621,4089,2069,80517,319091,276178
300154074200,30-015-40742,BOLIVAR BRD FEDERAL COM 001H,2018-02-01,57,349,2711,709,80866,321802,276887
300154074200,30-015-40742,BOLIVAR BRD FEDERAL COM 001H,2018-03-01,58,55,328,43,80921,322130,276930
300154074200,30-015-40742,BOLIVAR BRD FEDERAL COM 001H,2018-04-01,59,0,5,0,80921,322135,276930
300154074200,30-015-40742,BOLIVAR BRD FEDERAL COM 001H,2018-05-01,60,903,5956,1864,81824,328091,278794
300154074200,30-015-40742,BOLIVAR BRD FEDERAL COM 001H,2018-06-01,61,662,3720,1477,82486,331811,280271
300154074200,30-015-40742,BOLIVAR BRD FEDERAL COM 001H,2018-07-01,62,695,4027,1491,83181,335838,281762
300154074200,30-015-40742,BOLIVAR BRD FEDERAL COM 001H,2018-08-01,63,540,3546,1300,83721,339384,283062
300154074200,30-015-40742,BOLIVAR BRD FEDERAL COM 001H,2018-09-01,64,478,3147,1094,84199,342531,284156
300154074200,30-015-40742,BOLIVAR BRD FEDERAL COM 001H,2018-10-01,65,415,2807,917,84614,345338,285073
300154074200,30-015-40742,BOLIVAR BRD FEDERAL COM 001H,2018-11-01,66,393,2511,640,85007,347849,285713
300154074200,30-015-40742,BOLIVAR BRD FEDERAL COM 001H,2018-12-01,67,229,1776,278,85236,349625,285991
300154074200,30-015-40742,BOLIVAR BRD FEDERAL COM 001H,2019-01-01,68,238,1988,200,85474,351613,286191
300154074200,30-015-40742,BOLIVAR BRD FEDERAL COM 001H,2019-02-01,69,281,1952,294,85755,353565,286485
300154074200,30-015-40742,BOLIVAR BRD FEDERAL COM 001H,2019-03-01,70,450,2582,488,86205,356147,286973
300154074200,30-015-40742,BOLIVAR BRD FEDERAL COM 001H,2019-04-01,71,652,2278,435,86857,358425,287408
300154074200,30-015-40742,BOLIVAR BRD FEDERAL COM 001H,2019-05-01,72,797,3510,1751,87654,361935,289159
300154074200,30-015-40742,BOLIVAR BRD FEDERAL COM 001H,2019-06-01,73,737,3558,1981,88391,365493,291140
300154074200,30-015-40742,BOLIVAR BRD FEDERAL COM 001H,2019-07-01,74,616,3412,1177,89007,368905,292317
300154074200,30-015-40742,BOLIVAR BRD FEDERAL COM 001H,2019-08-01,75,526,3070,1039,89533,371975,293356
300154074200,30-015-40742,BOLIVAR BRD FEDERAL COM 001H,2019-09-01,76,518,3035,1143,90051,375010,294499
300154074200,30-015-40742,BOLIVAR BRD FEDERAL COM 001H,2019-10-01,77,619,2921,1649,90670,377931,296148
300154074200,30-015-40742,BOLIVAR BRD FEDERAL COM 001H,2019-11-01,78,614,3580,2319,91284,381511,298467
300154074200,30-015-40742,BOLIVAR BRD FEDERAL COM 001H,2019-12-01,79,502,3451,2278,91786,384962,300745
300154074200,30-015-40742,BOLIVAR BRD FEDERAL COM 001H,2020-01-01,80,599,3907,1463,92385,388869,302208
300154074200,30-015-40742,BOLIVAR BRD FEDERAL COM 001H,2020-02-01,81,507,3468,1029,92892,392337,303237
300154074200,30-015-40742,BOLIVAR BRD FEDERAL COM 001H,2020-03-01,82,503,3754,1515,93395,396091,304752
300154074200,30-015-40742,BOLIVAR BRD FEDERAL COM 001H,2020-04-01,83,441,3352,1052,93836,399443,305804
300154074200,30-015-40742,BOLIVAR BRD FEDERAL COM 001H,2020-05-01,84,53,799,80,93889,400242,305884
300154074200,30-015-40742,BOLIVAR BRD FEDERAL COM 001H,2020-06-01,85,561,4250,1273,94450,404492,307157
300154074200,30-015-40742,BOLIVAR BRD FEDERAL COM 001H,2020-07-01,86,578,3688,1773,95028,408180,308930
300154074200,30-015-40742,BOLIVAR BRD FEDERAL COM 001H,2020-08-01,87,449,3349,1757,95477,411529,310687
300154074200,30-015-40742,BOLIVAR BRD FEDERAL COM 001H,2020-09-01,88,435,3311,1872,95912,414840,312559
300154074200,30-015-40742,BOLIVAR BRD FEDERAL COM 001H,2020-10-01,89,473,3369,1861,96385,418209,314420
300154074200,30-015-40742,BOLIVAR BRD FEDERAL COM 001H,2020-11-01,90,451,3294,1921,96836,421503,316341
300154074200,30-015-40742,BOLIVAR BRD FEDERAL COM 001H,2020-12-01,91,431,3227,1361,97267,424730,317702
300154074200,30-015-40742,BOLIVAR BRD FEDERAL COM 001H,2021-01-01,92,431,3241,1455,97698,427971,319157
300154074200,30-015-40742,BOLIVAR BRD FEDERAL COM 001H,2021-02-01,93,355,2787,1039,98053,430758,320196
300154074200,30-015-40742,BOLIVAR BRD FEDERAL COM 001H,2021-03-01,94,368,3079,1064,98421,433837,321260
300154074200,30-015-40742,BOLIVAR BRD FEDERAL COM 001H,2021-04-01,95,415,3096,1141,98836,436933,322401
300154074200,30-015-40742,BOLIVAR BRD FEDERAL COM 001H,2021-05-01,96,380,2898,1461,99216,439831,323862
300154074200,30-015-40742,BOLIVAR BRD FEDERAL COM 001H,2021-06-01,97,350,2846,1284,99566,442677,325146
300154074200,30-015-40742,BOLIVAR BRD FEDERAL COM 001H,2021-07-01,98,415,2988,1182,99981,445665,326328
300154074200,30-015-40742,BOLIVAR BRD FEDERAL COM 001H,2021-08-01,99,393,2983,1213,100374,448648,327541
300154074200,30-015-40742,BOLIVAR BRD FEDERAL COM 001H,2021-09-01,100,384,2852,1582,100758,451500,329123
300154074200,30-015-40742,BOLIVAR BRD FEDERAL COM 001H,2021-10-01,101,352,2872,951,101110,454372,330074
300154074200,30-015-40742,BOLIVAR BRD FEDERAL COM 001H,2021-11-01,102,353,2934,1221,101463,457306,331295
300154074200,30-015-40742,BOLIVAR BRD FEDERAL COM 001H,2021-12-01,103,254,2608,893,101717,459914,332188
300154074200,30-015-40742,BOLIVAR BRD FEDERAL COM 001H,2022-01-01,104,374,3018,1001,102091,462932,333189
300154074200,30-015-40742,BOLIVAR BRD FEDERAL COM 001H,2022-02-01,105,330,2712,1008,102421,465644,334197
300154074200,30-015-40742,BOLIVAR BRD FEDERAL COM 001H,2022-03-01,106,442,3022,1150,102863,468666,335347
300154074200,30-015-40742,BOLIVAR BRD FEDERAL COM 001H,2022-04-01,107,373,2852,843,103236,471518,336190
300154074200,30-015-40742,BOLIVAR BRD FEDERAL COM 001H,2022-05-01,108,350,3028,1360,103586,474546,337550
300154074200,30-015-40742,BOLIVAR BRD FEDERAL COM 001H,2022-06-01,109,299,2615,1020,103885,477161,338570
300154074200,30-015-40742,BOLIVAR BRD FEDERAL COM 001H,2022-07-01,110,321,2793,1023,104206,479954,339593
300154074200,30-015-40742,BOLIVAR BRD FEDERAL COM 001H,2022-08-01,111,352,2824,1066,104558,482778,340659
300154074200,30-015-40742,BOLIVAR BRD FEDERAL COM 001H,2022-09-01,112,245,2373,789,104803,485151,341448
300154074200,30-015-40742,BOLIVAR BRD FEDERAL COM 001H,2022-10-01,113,291,2562,874,105094,487713,342322
300154074200,30-015-40742,BOLIVAR BRD FEDERAL COM 001H,2022-11-01,114,392,2668,1275,105486,490381,343597
300154074200,30-015-40742,BOLIVAR BRD FEDERAL COM 001H,2022-12-01,115,297,2334,749,105783,492715,344346
300154074200,30-015-40742,BOLIVAR BRD FEDERAL COM 001H,2023-01-01,116,178,1730,532,105961,494445,344878
300154074200,30-015-40742,BOLIVAR BRD FEDERAL COM 001H,2023-02-01,117,371,2741,923,106332,497186,345801
300154074200,30-015-40742,BOLIVAR BRD FEDERAL COM 001H,2023-03-01,118,344,2535,884,106676,499721,346685
300154074200,30-015-40742,BOLIVAR BRD FEDERAL COM 001H,2023-04-01,119,301,2161,844,106977,501882,347529
300154074200,30-015-40742,BOLIVAR BRD FEDERAL COM 001H,2023-05-01,120,42,105,66,107019,501987,347595
300154074200,30-015-40742,BOLIVAR BRD FEDERAL COM 001H,2023-06-01,121,17,35,3,107036,502022,347598
300154074200,30-015-40742,BOLIVAR BRD FEDERAL COM 001H,2023-07-01,122,5,47,57,107041,502069,347655
300153776300,30-015-37763,SERRANO 29 FEDERAL 001H,2011-08-01,1,327,55580,4453,327,55580,4453
300153776300,30-015-37763,SERRANO 29 FEDERAL 001H,2011-09-01,2,227,46435,3716,554,102015,8169
300153776300,30-015-37763,SERRANO 29 FEDERAL 001H,2011-10-01,3,175,43356,4156,729,145371,12325
300153776300,30-015-37763,SERRANO 29 FEDERAL 001H,2011-11-01,4,169,37068,3360,898,182439,15685
300153776300,30-015-37763,SERRANO 29 FEDERAL 001H,2011-12-01,5,136,19181,2072,1034,201620,17757
300153776300,30-015-37763,SERRANO 29 FEDERAL 001H,2012-01-01,6,433,36862,2891,1467,238482,20648
300153776300,30-015-37763,SERRANO 29 FEDERAL 001H,2012-02-01,7,213,29284,2299,1680,267766,22947
300153776300,30-015-37763,SERRANO 29 FEDERAL 001H,2012-03-01,8,381,25191,1596,2061,292957,24543
300153776300,30-015-37763,SERRANO 29 FEDERAL 001H,2012-04-01,9,200,25111,1480,2261,318068,26023
300153776300,30-015-37763,SERRANO 29 FEDERAL 001H,2012-05-01,10,153,25686,1576,2414,343754,27599
300153776300,30-015-37763,SERRANO 29 FEDERAL 001H,2012-06-01,11,193,35879,3593,2607,379633,31192
300153776300,30-015-37763,SERRANO 29 FEDERAL 001H,2012-07-01,12,111,32374,3511,2718,412007,34703
300153776300,30-015-37763,SERRANO 29 FEDERAL 001H,2012-08-01,13,78,29439,3150,2796,441446,37853
300153776300,30-015-37763,SERRANO 29 FEDERAL 001H,2012-09-01,14,130,20517,1689,2926,461963,39542
300153776300,30-015-37763,SERRANO 29 FEDERAL 001H,2012-10-01,15,0,15750,638,2926,477713,40180
300153776300,30-015-37763,SERRANO 29 FEDERAL 001H,2012-11-01,16,411,21356,811,3337,499069,40991
300153776300,30-015-37763,SERRANO 29 FEDERAL 001H,2012-12-01,17,119,23614,1974,3456,522683,42965
300153776300,30-015-37763,SERRANO 29 FEDERAL 001H,2013-01-01,18,161,21609,1659,3617,544292,44624
300153776300,30-015-37763,SERRANO 29 FEDERAL 001H,2013-02-01,19,171,18375,1423,3788,562667,46047
300153776300,30-015-37763,SERRANO 29 FEDERAL 001H,2013-03-01,20,114,21336,2175,3902,584003,48222
300153776300,30-015-37763,SERRANO 29 FEDERAL 001H,2013-04-01,21,127,23355,2039,4029,607358,50261
300153776300,30-015-37763,SERRANO 29 FEDERAL 001H,2013-05-01,22,78,18728,1220,4107,626086,51481
300153776300,30-015-37763,SERRANO 29 FEDERAL 001H,2013-06-01,23,88,23020,1779,4195,649106,53260
300153776300,30-015-37763,SERRANO 29 FEDERAL 001H,2013-07-01,24,203,19841,1597,4398,668947,54857
300153776300,30-015-37763,SERRANO 29 FEDERAL 001H,2013-08-01,25,115,18744,1322,4513,687691,56179
300153776300,30-015-37763,SERRANO 29 FEDERAL 001H,2013-09-01,26,103,20584,1827,4616,708275,58006
300153776300,30-015-37763,SERRANO 29 FEDERAL 001H,2013-10-01,27,141,15204,1069,4757,723479,59075
300153776300,30-015-37763,SERRANO 29 FEDERAL 001H,2013-11-01,28,106,17972,1590,4863,741451,60665
300153776300,30-015-37763,SERRANO 29 FEDERAL 001H,2013-12-01,29,125,15948,1343,4988,757399,62008
300153776300,30-015-37763,SERRANO 29 FEDERAL 001H,2014-01-01,30,152,17261,1485,5140,774660,63493
300153776300,30-015-37763,SERRANO 29 FEDERAL 001H,2014-02-01,31,95,13918,1391,5235,788578,64884
300153776300,30-015-37763,SERRANO 29 FEDERAL 001H,2014-03-01,32,124,18660,1440,5359,807238,66324
300153776300,30-015-37763,SERRANO 29 FEDERAL 001H,2014-04-01,33,79,15811,1280,5438,823049,67604
300153776300,30-015-37763,SERRANO 29 FEDERAL 001H,2014-05-01,34,98,17992,1604,5536,841041,69208
300153776300,30-015-37763,SERRANO 29 FEDERAL 001H,2014-06-01,35,101,15117,1458,5637,856158,70666
300153776300,30-015-37763,SERRANO 29 FEDERAL 001H,2014-07-01,36,104,15012,1282,5741,871170,71948
300153776300,30-015-37763,SERRANO 29 FEDERAL 001H,2014-08-01,37,36,16027,1528,5777,887197,73476
300153776300,30-015-37763,SERRANO 29 FEDERAL 001H,2014-09-01,38,86,14457,1169,5863,901654,74645
300153776300,30-015-37763,SERRANO 29 FEDERAL 001H,2014-10-01,39,77,12263,992,5940,913917,75637
300153776300,30-015-37763,SERRANO 29 FEDERAL 001H,2014-11-01,40,145,14789,1168,6085,928706,76805
300153776300,30-015-37763,SERRANO 29 FEDERAL 001H,2014-12-01,41,106,14581,1282,6191,943287,78087
300153776300,30-015-37763,SERRANO 29 FEDERAL 001H,2015-01-01,42,92,13686,1211,6283,956973,79298
300153776300,30-015-37763,SERRANO 29 FEDERAL 001H,2015-02-01,43,64,10874,740,6347,967847,80038
300153776300,30-015-37763,SERRANO 29 FEDERAL 001H,2015-03-01,44,61,12222,1077,6408,980069,81115
300153776300,30-015-37763,SERRANO 29 FEDERAL 001H,2015-04-01,45,85,11337,897,6493,991406,82012
300153776300,30-015-37763,SERRANO 29 FEDERAL 001H,2015-05-01,46,65,14941,1358,6558,1006347,83370
300153776300,30-015-37763,SERRANO 29 FEDERAL 001H,2015-06-01,47,61,13145,1065,6619,1019492,84435
300153776300,30-015-37763,SERRANO 29 FEDERAL 001H,2015-07-01,48,56,9353,806,6675,1028845,85241
300153776300,30-015-37763,SERRANO 29 FEDERAL 001H,2015-08-01,49,101,16143,1568,6776,1044988,86809
300153776300,30-015-37763,SERRANO 29 FEDERAL 001H,2015-09-01,50,81,16257,1442,6857,1061245,88251
300153776300,30-015-37763,SERRANO 29 FEDERAL 001H,2015-10-01,51,96,16555,1469,6953,1077800,89720
300153776300,30-015-37763,SERRANO 29 FEDERAL 001H,2015-11-01,52,84,14128,1332,7037,1091928,91052
300153776300,30-015-37763,SERRANO 29 FEDERAL 001H,2015-12-01,53,90,11936,973,7127,1103864,92025
300153776300,30-015-37763,SERRANO 29 FEDERAL 001H,2016-01-01,54,79,11766,1041,7206,1115630,93066
300153776300,30-015-37763,SERRANO 29 FEDERAL 001H,2016-02-01,55,47,6574,656,7253,1122204,93722
300153776300,30-015-37763,SERRANO 29 FEDERAL 001H,2016-03-01,56,80,11260,1272,7333,1133464,94994
300153776300,30-015-37763,SERRANO 29 FEDERAL 001H,2016-04-01,57,81,11581,1173,7414,1145045,96167
300153776300,30-015-37763,SERRANO 29 FEDERAL 001H,2016-05-01,58,60,12756,1541,7474,1157801,97708
300153776300,30-015-37763,SERRANO 29 FEDERAL 001H,2016-06-01,59,50,14119,1230,7524,1171920,98938
300153776300,30-015-37763,SERRANO 29 FEDERAL 001H,2016-07-01,60,64,13931,1122,7588,1185851,100060
300153776300,30-015-37763,SERRANO 29 FEDERAL 001H,2016-08-01,61,77,13533,1091,7665,1199384,101151
300153776300,30-015-37763,SERRANO 29 FEDERAL 001H,2016-09-01,62,63,13313,1080,7728,1212697,102231
300153776300,30-015-37763,SERRANO 29 FEDERAL 001H,2016-10-01,63,62,13834,1106,7790,1226531,103337
300153776300,30-015-37763,SERRANO 29 FEDERAL 001H,2016-11-01,64,84,10306,897,7874,1236837,104234
300153776300,30-015-37763,SERRANO 29 FEDERAL 001H,2016-12-01,65,78,12883,1186,7952,1249720,105420
300153776300,30-015-37763,SERRANO 29 FEDERAL 001H,2017-01-01,66,32,10566,861,7984,1260286,106281
300153776300,30-015-37763,SERRANO 29 FEDERAL 001H,2017-02-01,67,32,9921,809,8016,1270207,107090
300153776300,30-015-37763,SERRANO 29 FEDERAL 001H,2017-03-01,68,53,13225,1149,8069,1283432,108239
300153776300,30-015-37763,SERRANO 29 FEDERAL 001H,2017-04-01,69,65,11764,1011,8134,1295196,109250
300153776300,30-015-37763,SERRANO 29 FEDERAL 001H,2017-05-01,70,67,8798,708,8201,1303994,109958
300153776300,30-015-37763,SERRANO 29 FEDERAL 001H,2017-06-01,71,44,8689,720,8245,1312683,110678
300153776300,30-015-37763,SERRANO 29 FEDERAL 001H,2017-07-01,72,12,8231,306,8257,1320914,110984
300153776300,30-015-37763,SERRANO 29 FEDERAL 001H,2017-08-01,73,27,3612,181,8284,1324526,111165
300153776300,30-015-37763,SERRANO 29 FEDERAL 001H,2017-09-01,74,39,6277,548,8323,1330803,111713
300153776300,30-015-37763,SERRANO 29 FEDERAL 001H,2017-10-01,75,44,11722,1343,8367,1342525,113056
300153776300,30-015-37763,SERRANO 29 FEDERAL 001H,2017-11-01,76,0,13309,1219,8367,1355834,114275
300153776300,30-015-37763,SERRANO 29 FEDERAL 001H,2017-12-01,77,10,12708,915,8377,1368542,115190
300153776300,30-015-37763,SERRANO 29 FEDERAL 001H,2018-01-01,78,67,501,89,8444,1369043,115279
300153776300,30-015-37763,SERRANO 29 FEDERAL 001H,2018-02-01,79,0,0,0,8444,1369043,115279
300153776300,30-015-37763,SERRANO 29 FEDERAL 001H,2018-03-01,80,38,421,2,8482,1369464,115281
300153776300,30-015-37763,SERRANO 29 FEDERAL 001H,2018-04-01,81,15,12234,360,8497,1381698,115641
300153776300,30-015-37763,SERRANO 29 FEDERAL 001H,2018-05-01,82,58,8784,816,8555,1390482,116457
300153776300,30-015-37763,SERRANO 29 FEDERAL 001H,2018-06-01,83,0,2858,120,8555,1393340,116577
300153776300,30-015-37763,SERRANO 29 FEDERAL 001H,2018-07-01,84,2,527,0,8557,1393867,116577
300153776300,30-015-37763,SERRANO 29 FEDERAL 001H,2018-08-01,85,2,3050,240,8559,1396917,116817
300153776300,30-015-37763,SERRANO 29 FEDERAL 001H,2018-09-01,86,4,158,359,8563,1397075,117176
300153776300,30-015-37763,SERRANO 29 FEDERAL 001H,2018-10-01,87,1,255,0,8564,1397330,117176
300153776300,30-015-37763,SERRANO 29 FEDERAL 001H,2018-11-01,88,0,23,0,8564,1397353,117176
300153776300,30-015-37763,SERRANO 29 FEDERAL 001H,2018-12-01,89,0,3,0,8564,1397356,117176
300153776300,30-015-37763,SERRANO 29 FEDERAL 001H,2019-01-01,90,74,11911,742,8638,1409267,117918
300153776300,30-015-37763,SERRANO 29 FEDERAL 001H,2019-02-01,91,13,1714,160,8651,1410981,118078
300153776300,30-015-37763,SERRANO 29 FEDERAL 001H,2019-03-01,92,3,10611,1040,8654,1421592,119118
300153776300,30-015-37763,SERRANO 29 FEDERAL 001H,2019-04-01,93,75,10689,38,8729,1432281,119156
300153776300,30-015-37763,SERRANO 29 FEDERAL 001H,2019-05-01,94,220,9287,0,8949,1441568,119156
300153776300,30-015-37763,SERRANO 29 FEDERAL 001H,2019-06-01,95,178,112,473,9127,1441680,119629
300153776300,30-015-37763,SERRANO 29 FEDERAL 001H,2019-07-01,96,26,3442,13,9153,1445122,119642
300153776300,30-015-37763,SERRANO 29 FEDERAL 001H,2019-08-01,97,0,14,7,9153,1445136,119649
300153776300,30-015-37763,SERRANO 29 FEDERAL 001H,2019-09-01,98,0,170,20,9153,1445306,119669
300153776300,30-015-37763,SERRANO 29 FEDERAL 001H,2019-10-01,99,0,24,0,9153,1445330,119669
300153776300,30-015-37763,SERRANO 29 FEDERAL 001H,2019-11-01,100,11,12204,309,9164,1457534,119978
300153776300,30-015-37763,SERRANO 29 FEDERAL 001H,2019-12-01,101,79,12376,301,9243,1469910,120279
300153776300,30-015-37763,SERRANO 29 FEDERAL 001H,2020-01-01,102,94,12833,83,9337,1482743,120362
300153776300,30-015-37763,SERRANO 29 FEDERAL 001H,2020-02-01,103,72,11223,440,9409,1493966,120802
300153776300,30-015-37763,SERRANO 29 FEDERAL 001H,2020-03-01,104,18,6254,417,9427,1500220,121219
300153776300,30-015-37763,SERRANO 29 FEDERAL 001H,2020-04-01,105,4,11162,3,9431,1511382,121222
300153776300,30-015-37763,SERRANO 29 FEDERAL 001H,2020-05-01,106,41,5121,0,9472,1516503,121222
300153776300,30-015-37763,SERRANO 29 FEDERAL 001H,2020-06-01,107,0,10092,30,9472,1526595,121252
300153776300,30-015-37763,SERRANO 29 FEDERAL 001H,2020-07-01,108,0,12078,386,9472,1538673,121638
300153776300,30-015-37763,SERRANO 29 FEDERAL 001H,2020-08-01,109,0,8866,781,9472,1547539,122419
300153776300,30-015-37763,SERRANO 29 FEDERAL 001H,2020-09-01,110,2,11558,905,9474,1559097,123324
300153776300,30-015-37763,SERRANO 29 FEDERAL 001H,2020-10-01,111,5,7457,414,9479,1566554,123738
300153776300,30-015-37763,SERRANO 29 FEDERAL 001H,2020-11-01,112,2,8778,492,9481,1575332,124230
300153776300,30-015-37763,SERRANO 29 FEDERAL 001H,2020-12-01,113,3,9228,372,9484,1584560,124602
300153776300,30-015-37763,SERRANO 29 FEDERAL 001H,2021-01-01,114,25,9225,1042,9509,1593785,125644
300153776300,30-015-37763,SERRANO 29 FEDERAL 001H,2021-02-01,115,10,8620,579,9519,1602405,126223
300153776300,30-015-37763,SERRANO 29 FEDERAL 001H,2021-03-01,116,67,8837,801,9586,1611242,127024
300153776300,30-015-37763,SERRANO 29 FEDERAL 001H,2021-04-01,117,36,9440,918,9622,1620682,127942
300153776300,30-015-37763,SERRANO 29 FEDERAL 001H,2021-05-01,118,20,8963,782,9642,1629645,128724
300153776300,30-015-37763,SERRANO 29 FEDERAL 001H,2021-06-01,119,54,9363,805,9696,1639008,129529
300153776300,30-015-37763,SERRANO 29 FEDERAL 001H,2021-07-01,120,31,11731,1157,9727,1650739,130686
300153776300,30-015-37763,SERRANO 29 FEDERAL 001H,2021-08-01,121,22,6331,410,9749,1657070,131096
300153776300,30-015-37763,SERRANO 29 FEDERAL 001H,2021-09-01,122,58,10743,909,9807,1667813,132005
300153776300,30-015-37763,SERRANO 29 FEDERAL 001H,2021-10-01,123,0,3652,335,9807,1671465,132340
300153776300,30-015-37763,SERRANO 29 FEDERAL 001H,2021-11-01,124,46,13370,1215,9853,1684835,133555
300153776300,30-015-37763,SERRANO 29 FEDERAL 001H,2021-12-01,125,65,12739,1003,9918,1697574,134558
300153776300,30-015-37763,SERRANO 29 FEDERAL 001H,2022-01-01,126,31,11457,869,9949,1709031,135427
300153776300,30-015-37763,SERRANO 29 FEDERAL 001H,2022-02-01,127,54,7300,562,10003,1716331,135989
300153776300,30-015-37763,SERRANO 29 FEDERAL 001H,2022-03-01,128,9,11965,1069,10012,1728296,137058
300153776300,30-015-37763,SERRANO 29 FEDERAL 001H,2022-04-01,129,30,12465,971,10042,1740761,138029
300153776300,30-015-37763,SERRANO 29 FEDERAL 001H,2022-05-01,130,20,3421,167,10062,1744182,138196
300153776300,30-015-37763,SERRANO 29 FEDERAL 001H,2022-06-01,131,13,5496,435,10075,1749678,138631
300153776300,30-015-37763,SERRANO 29 FEDERAL 001H,2022-07-01,132,0,855,176,10075,1750533,138807
300153776300,30-015-37763,SERRANO 29 FEDERAL 001H,2022-08-01,133,0,42,0,10075,1750575,138807
300153776300,30-015-37763,SERRANO 29 FEDERAL 001H,2022-09-01,134,49,1196,140,10124,1751771,138947
300153776300,30-015-37763,SERRANO 29 FEDERAL 001H,2022-10-01,135,0,411,0,10124,1752182,138947
300153776300,30-015-37763,SERRANO 29 FEDERAL 001H,2022-11-01,136,43,5171,506,10167,1757353,139453
300153776300,30-015-37763,SERRANO 29 FEDERAL 001H,2022-12-01,137,16,2884,236,10183,1760237,139689
300153776300,30-015-37763,SERRANO 29 FEDERAL 001H,2023-01-01,138,16,273,26,10199,1760510,139715
300153776300,30-015-37763,SERRANO 29 FEDERAL 001H,2023-02-01,139,6,348,6,10205,1760858,139721
300153776300,30-015-37763,SERRANO 29 FEDERAL 001H,2023-03-01,140,30,4833,470,10235,1765691,140191
300153776300,30-015-37763,SERRANO 29 FEDERAL 001H,2023-04-01,141,0,2104,143,10235,1767795,140334
300153776300,30-015-37763,SERRANO 29 FEDERAL 001H,2023-05-01,142,0,2420,185,10235,1770215,140519
300153776300,30-015-37763,SERRANO 29 FEDERAL 001H,2023-06-01,143,53,3751,354,10288,1773966,140873
300153776300,30-015-37763,SERRANO 29 FEDERAL 001H,2023-07-01,144,0,804,73,10288,1774770,140946
300154918100,30-015-49181,PERDOMO 25 STATE COM 703H,2023-06-01,1,23490,49474,72025,23490,49474,72025
300154918100,30-015-49181,PERDOMO 25 STATE COM 703H,2023-07-01,2,40974,84852,131748,64464,134326,203773
300153534400,30-015-35344,LONG NOSE COM 001,2007-04-01,1,0,28816,0,0,28816,0
300153534400,30-015-35344,LONG NOSE COM 001,2007-05-01,2,0,112946,0,0,141762,0
300153534400,30-015-35344,LONG NOSE COM 001,2007-06-01,3,0,25281,0,0,167043,0
300153534400,30-015-35344,LONG NOSE COM 001,2007-07-01,4,0,15137,0,0,182180,0
300153534400,30-015-35344,LONG NOSE COM 001,2007-08-01,5,0,9930,0,0,192110,0
300153534400,30-015-35344,LONG NOSE COM 001,2007-09-01,6,0,679,0,0,192789,0
300153534400,30-015-35344,LONG NOSE COM 001,2007-10-01,7,0,0,0,0,192789,0
300153534400,30-015-35344,LONG NOSE COM 001,2007-11-01,1,0,24383,0,0,217172,0
300153534400,30-015-35344,LONG NOSE COM 001,2007-12-01,2,0,58425,0,0,275597,0
300153534400,30-015-35344,LONG NOSE COM 001,2008-01-01,3,0,51344,0,0,326941,0
300153534400,30-015-35344,LONG NOSE COM 001,2008-02-01,4,0,41540,0,0,368481,0
300153534400,30-015-35344,LONG NOSE COM 001,2008-03-01,5,0,36649,0,0,405130,0
300153534400,30-015-35344,LONG NOSE COM 001,2008-04-01,6,0,30694,0,0,435824,0
300153534400,30-015-35344,LONG NOSE COM 001,2008-05-01,7,0,27721,0,0,463545,0
300153534400,30-015-35344,LONG NOSE COM 001,2008-06-01,8,0,22116,0,0,485661,0
300153534400,30-015-35344,LONG NOSE COM 001,2008-07-01,9,0,18586,0,0,504247,0
300153534400,30-015-35344,LONG NOSE COM 001,2008-08-01,10,0,14716,0,0,518963,0
300153534400,30-015-35344,LONG NOSE COM 001,2008-09-01,11,0,13333,0,0,532296,0
300153534400,30-015-35344,LONG NOSE COM 001,2008-10-01,12,0,12959,0,0,545255,0
300153534400,30-015-35344,LONG NOSE COM 001,2008-11-01,13,0,22197,0,0,567452,0
300153534400,30-015-35344,LONG NOSE COM 001,2008-12-01,14,0,22197,0,0,589649,0
300153534400,30-015-35344,LONG NOSE COM 001,2009-01-01,15,0,17085,0,0,606734,0
300153534400,30-015-35344,LONG NOSE COM 001,2009-02-01,16,0,14895,0,0,621629,0
300153534400,30-015-35344,LONG NOSE COM 001,2009-03-01,17,0,10632,0,0,632261,0
300153534400,30-015-35344,LONG NOSE COM 001,2009-04-01,18,0,5233,0,0,637494,0
300153534400,30-015-35344,LONG NOSE COM 001,2009-05-01,19,0,4676,0,0,642170,0
300153534400,30-015-35344,LONG NOSE COM 001,2009-06-01,20,0,7925,0,0,650095,0
300153534400,30-015-35344,LONG NOSE COM 001,2009-07-01,21,0,15385,0,0,665480,0
300153534400,30-015-35344,LONG NOSE COM 001,2009-08-01,22,0,12008,0,0,677488,0
300153534400,30-015-35344,LONG NOSE COM 001,2009-09-01,23,0,9295,0,0,686783,0
300153534400,30-015-35344,LONG NOSE COM 001,2009-10-01,24,0,5449,0,0,692232,0
300153534400,30-015-35344,LONG NOSE COM 001,2009-11-01,25,0,6089,0,0,698321,0
300153534400,30-015-35344,LONG NOSE COM 001,2009-12-01,26,0,11134,0,0,709455,0
300153534400,30-015-35344,LONG NOSE COM 001,2010-01-01,27,0,9610,0,0,719065,0
300153534400,30-015-35344,LONG NOSE COM 001,2010-02-01,28,0,2789,0,0,721854,0
300153534400,30-015-35344,LONG NOSE COM 001,2010-03-01,29,0,27,0,0,721881,0
300153534400,30-015-35344,LONG NOSE COM 001,2010-04-01,30,0,282,0,0,722163,0
300153534400,30-015-35344,LONG NOSE COM 001,2010-05-01,31,0,1151,0,0,723314,0
300153534400,30-015-35344,LONG NOSE COM 001,2010-06-01,32,0,9261,0,0,732575,0
300153534400,30-015-35344,LONG NOSE COM 001,2010-07-01,33,0,7558,0,0,740133,0
300153534400,30-015-35344,LONG NOSE COM 001,2010-08-01,34,0,7988,0,0,748121,0
300153534400,30-015-35344,LONG NOSE COM 001,2010-09-01,35,0,6265,0,0,754386,0
300153534400,30-015-35344,LONG NOSE COM 001,2010-10-01,36,0,7173,0,0,761559,0
300153534400,30-015-35344,LONG NOSE COM 001,2010-11-01,37,0,5957,0,0,767516,0
300153534400,30-015-35344,LONG NOSE COM 001,2010-12-01,38,0,6319,0,0,773835,0
300153534400,30-015-35344,LONG NOSE COM 001,2011-01-01,39,0,6079,0,0,779914,0
300153534400,30-015-35344,LONG NOSE COM 001,2011-02-01,40,0,3837,0,0,783751,0
300153534400,30-015-35344,LONG NOSE COM 001,2011-03-01,41,0,5229,0,0,788980,0
300153534400,30-015-35344,LONG NOSE COM 001,2011-04-01,42,16,5253,0,16,794233,0
300153534400,30-015-35344,LONG NOSE COM 001,2011-05-01,43,16,4474,0,32,798707,0
300153534400,30-015-35344,LONG NOSE COM 001,2011-06-01,44,0,1768,0,32,800475,0
300153534400,30-015-35344,LONG NOSE COM 001,2011-07-01,45,0,857,0,32,801332,0
300153534400,30-015-35344,LONG NOSE COM 001,2011-08-01,46,0,1204,0,32,802536,0
300153534400,30-015-35344,LONG NOSE COM 001,2011-09-01,47,0,305,0,32,802841,0
300153534400,30-015-35344,LONG NOSE COM 001,2011-10-01,48,0,6538,0,32,809379,0
300153534400,30-015-35344,LONG NOSE COM 001,2011-11-01,49,2,5872,0,34,815251,0
300153534400,30-015-35344,LONG NOSE COM 001,2011-12-01,50,1,4847,0,35,820098,0
300153534400,30-015-35344,LONG NOSE COM 001,2012-01-01,51,0,4680,0,35,824778,0
300153534400,30-015-35344,LONG NOSE COM 001,2012-02-01,52,1,4454,0,36,829232,0
300153534400,30-015-35344,LONG NOSE COM 001,2012-03-01,53,0,3537,0,36,832769,0
300153534400,30-015-35344,LONG NOSE COM 001,2012-04-01,54,0,3149,0,36,835918,0
300153534400,30-015-35344,LONG NOSE COM 001,2012-05-01,55,0,3945,0,36,839863,0
300153534400,30-015-35344,LONG NOSE COM 001,2012-06-01,56,1,2864,0,37,842727,0
300153534400,30-015-35344,LONG NOSE COM 001,2012-07-01,57,0,2677,0,37,845404,0
300153534400,30-015-35344,LONG NOSE COM 001,2012-08-01,58,0,2301,0,37,847705,0
300153534400,30-015-35344,LONG NOSE COM 001,2012-09-01,59,0,2669,0,37,850374,0
300153534400,30-015-35344,LONG NOSE COM 001,2012-10-01,60,0,2752,0,37,853126,0
300153534400,30-015-35344,LONG NOSE COM 001,2012-11-01,61,0,1816,0,37,854942,0
300153534400,30-015-35344,LONG NOSE COM 001,2012-12-01,62,0,2977,0,37,857919,0
300153534400,30-015-35344,LONG NOSE COM 001,2013-01-01,63,0,3778,0,37,861697,0
300153534400,30-015-35344,LONG NOSE COM 001,2013-02-01,64,0,4437,0,37,866134,0
300153534400,30-015-35344,LONG NOSE COM 001,2013-03-01,65,0,2978,0,37,869112,0
300153534400,30-015-35344,LONG NOSE COM 001,2013-04-01,66,0,2792,0,37,871904,0
300153534400,30-015-35344,LONG NOSE COM 001,2013-05-01,67,0,1563,0,37,873467,0
300153534400,30-015-35344,LONG NOSE COM 001,2013-06-01,68,0,1929,0,37,875396,0
300153534400,30-015-35344,LONG NOSE COM 001,2013-07-01,69,0,1290,0,37,876686,0
300153534400,30-015-35344,LONG NOSE COM 001,2013-08-01,70,0,1352,0,37,878038,0
300153534400,30-015-35344,LONG NOSE COM 001,2013-09-01,71,0,1360,0,37,879398,0
300153534400,30-015-35344,LONG NOSE COM 001,2013-10-01,72,0,1465,0,37,880863,0
300153534400,30-015-35344,LONG NOSE COM 001,2013-11-01,73,0,676,0,37,881539,0
300153534400,30-015-35344,LONG NOSE COM 001,2013-12-01,74,0,1540,0,37,883079,0
300153534400,30-015-35344,LONG NOSE COM 001,2014-01-01,75,0,1214,0,37,884293,0
300153534400,30-015-35344,LONG NOSE COM 001,2014-02-01,76,0,1055,0,37,885348,0
300153534400,30-015-35344,LONG NOSE COM 001,2014-03-01,77,0,1723,0,37,887071,0
300153534400,30-015-35344,LONG NOSE COM 001,2014-04-01,78,0,1553,0,37,888624,0
300153534400,30-015-35344,LONG NOSE COM 001,2014-05-01,79,0,935,0,37,889559,0
300153534400,30-015-35344,LONG NOSE COM 001,2014-06-01,80,0,1019,0,37,890578,0
300153534400,30-015-35344,LONG NOSE COM 001,2014-07-01,81,0,983,0,37,891561,0
300153534400,30-015-35344,LONG NOSE COM 001,2014-08-01,82,0,967,0,37,892528,0
300153534400,30-015-35344,LONG NOSE COM 001,2014-09-01,83,0,954,0,37,893482,0
300153534400,30-015-35344,LONG NOSE COM 001,2014-10-01,84,0,852,0,37,894334,0
300153534400,30-015-35344,LONG NOSE COM 001,2014-11-01,85,0,276,0,37,894610,0
300153534400,30-015-35344,LONG NOSE COM 001,2014-12-01,86,0,2602,0,37,897212,0
300153534400,30-015-35344,LONG NOSE COM 001,2015-01-01,87,0,1834,0,37,899046,0
300153534400,30-015-35344,LONG NOSE COM 001,2015-02-01,88,0,2471,0,37,901517,0
300153534400,30-015-35344,LONG NOSE COM 001,2015-03-01,89,0,2913,0,37,904430,0
300153534400,30-015-35344,LONG NOSE COM 001,2015-04-01,90,0,3340,0,37,907770,0
300153534400,30-015-35344,LONG NOSE COM 001,2015-05-01,91,0,3018,0,37,910788,0
300153534400,30-015-35344,LONG NOSE COM 001,2015-06-01,92,7,3592,0,44,914380,0
300153534400,30-015-35344,LONG NOSE COM 001,2015-07-01,93,0,3427,0,44,917807,0
300153534400,30-015-35344,LONG NOSE COM 001,2015-08-01,94,0,2911,0,44,920718,0
300153534400,30-015-35344,LONG NOSE COM 001,2015-09-01,95,0,2617,9,44,923335,9
300153534400,30-015-35344,LONG NOSE COM 001,2015-10-01,96,0,2898,7,44,926233,16
300153534400,30-015-35344,LONG NOSE COM 001,2015-11-01,97,0,2811,13,44,929044,29
300153534400,30-015-35344,LONG NOSE COM 001,2015-12-01,98,0,2288,20,44,931332,49
300153534400,30-015-35344,LONG NOSE COM 001,2016-01-01,99,0,2889,12,44,934221,61
300153534400,30-015-35344,LONG NOSE COM 001,2016-02-01,100,0,2884,2,44,937105,63
300153534400,30-015-35344,LONG NOSE COM 001,2016-03-01,101,0,2868,0,44,939973,63
300153534400,30-015-35344,LONG NOSE COM 001,2016-04-01,102,0,2545,5,44,942518,68
300153534400,30-015-35344,LONG NOSE COM 001,2016-05-01,103,0,2941,14,44,945459,82
300153534400,30-015-35344,LONG NOSE COM 001,2016-06-01,104,0,2682,8,44,948141,90
300153534400,30-015-35344,LONG NOSE COM 001,2016-07-01,105,0,2756,12,44,950897,102
300153534400,30-015-35344,LONG NOSE COM 001,2016-08-01,106,0,2398,8,44,953295,110
300153534400,30-015-35344,LONG NOSE COM 001,2016-09-01,107,0,2081,10,44,955376,120
300153534400,30-015-35344,LONG NOSE COM 001,2016-10-01,108,0,1655,1,44,957031,121
300153534400,30-015-35344,LONG NOSE COM 001,2016-11-01,109,0,2075,5,44,959106,126
300153534400,30-015-35344,LONG NOSE COM 001,2016-12-01,110,0,1323,7,44,960429,133
300153534400,30-015-35344,LONG NOSE COM 001,2017-01-01,111,0,2172,5,44,962601,138
300153534400,30-015-35344,LONG NOSE COM 001,2017-02-01,112,0,2023,3,44,964624,141
300153534400,30-015-35344,LONG NOSE COM 001,2017-03-01,113,0,2897,10,44,967521,151
300153534400,30-015-35344,LONG NOSE COM 001,2017-04-01,114,0,1772,3,44,969293,154
300153534400,30-015-35344,LONG NOSE COM 001,2017-05-01,115,0,2574,0,44,971867,154
300153534400,30-015-35344,LONG NOSE COM 001,2017-06-01,116,0,1321,0,44,973188,154
300153534400,30-015-35344,LONG NOSE COM 001,2017-07-01,117,0,2115,0,44,975303,154
300153534400,30-015-35344,LONG NOSE COM 001,2017-08-01,118,0,1446,0,44,976749,154
300153534400,30-015-35344,LONG NOSE COM 001,2017-09-01,119,0,1590,0,44,978339,154
300153534400,30-015-35344,LONG NOSE COM 001,2017-10-01,120,0,1411,0,44,979750,154
300153534400,30-015-35344,LONG NOSE COM 001,2017-11-01,121,0,1199,0,44,980949,154
300153534400,30-015-35344,LONG NOSE COM 001,2017-12-01,122,0,993,0,44,981942,154
300153534400,30-015-35344,LONG NOSE COM 001,2018-01-01,123,0,1439,0,44,983381,154
300153534400,30-015-35344,LONG NOSE COM 001,2018-02-01,124,0,1330,0,44,984711,154
300153534400,30-015-35344,LONG NOSE COM 001,2018-03-01,125,0,1379,0,44,986090,154
300153534400,30-015-35344,LONG NOSE COM 001,2018-04-01,126,0,1421,0,44,987511,154
300153534400,30-015-35344,LONG NOSE COM 001,2018-05-01,127,0,1337,0,44,988848,154
300153534400,30-015-35344,LONG NOSE COM 001,2018-06-01,128,0,1605,0,44,990453,154
300153534400,30-015-35344,LONG NOSE COM 001,2018-07-01,129,0,1433,2,44,991886,156
300153534400,30-015-35344,LONG NOSE COM 001,2018-08-01,130,0,1016,0,44,992902,156
300153534400,30-015-35344,LONG NOSE COM 001,2018-09-01,131,1,1166,0,45,994068,156
300153534400,30-015-35344,LONG NOSE COM 001,2018-10-01,132,0,792,0,45,994860,156
300153534400,30-015-35344,LONG NOSE COM 001,2018-11-01,133,0,538,0,45,995398,156
300153534400,30-015-35344,LONG NOSE COM 001,2018-12-01,134,0,824,0,45,996222,156
300153534400,30-015-35344,LONG NOSE COM 001,2019-01-01,135,0,793,0,45,997015,156
300153534400,30-015-35344,LONG NOSE COM 001,2019-02-01,136,0,682,0,45,997697,156
300153534400,30-015-35344,LONG NOSE COM 001,2019-03-01,137,0,314,0,45,998011,156
300153534400,30-015-35344,LONG NOSE COM 001,2019-04-01,138,0,0,0,45,998011,156
300153534400,30-015-35344,LONG NOSE COM 001,2019-05-01,139,0,720,0,45,998731,156
300153534400,30-015-35344,LONG NOSE COM 001,2019-06-01,140,0,70,0,45,998801,156
300153534400,30-015-35344,LONG NOSE COM 001,2019-07-01,141,0,149,0,45,998950,156
300153534400,30-015-35344,LONG NOSE COM 001,2019-08-01,142,0,933,0,45,999883,156
300153534400,30-015-35344,LONG NOSE COM 001,2019-09-01,143,0,725,0,45,1000608,156
300153534400,30-015-35344,LONG NOSE COM 001,2019-10-01,144,0,509,0,45,1001117,156
300153534400,30-015-35344,LONG NOSE COM 001,2019-11-01,145,0,1174,0,45,1002291,156
300153534400,30-015-35344,LONG NOSE COM 001,2019-12-01,146,0,879,0,45,1003170,156
300153534400,30-015-35344,LONG NOSE COM 001,2020-01-01,147,0,797,0,45,1003967,156
300153534400,30-015-35344,LONG NOSE COM 001,2020-02-01,148,0,974,0,45,1004941,156
300153534400,30-015-35344,LONG NOSE COM 001,2020-03-01,149,0,955,0,45,1005896,156
300153534400,30-015-35344,LONG NOSE COM 001,2020-04-01,150,0,1535,0,45,1007431,156
300153534400,30-015-35344,LONG NOSE COM 001,2020-05-01,151,0,1402,0,45,1008833,156
300153534400,30-015-35344,LONG NOSE COM 001,2020-06-01,152,0,1150,0,45,1009983,156
300153534400,30-015-35344,LONG NOSE COM 001,2020-07-01,153,0,672,0,45,1010655,156
300153534400,30-015-35344,LONG NOSE COM 001,2020-08-01,154,0,1224,0,45,1011879,156
300153534400,30-015-35344,LONG NOSE COM 001,2020-09-01,155,0,1572,0,45,1013451,156
300153534400,30-015-35344,LONG NOSE COM 001,2020-10-01,156,0,976,0,45,1014427,156
300153534400,30-015-35344,LONG NOSE COM 001,2020-11-01,157,0,726,0,45,1015153,156
300153534400,30-015-35344,LONG NOSE COM 001,2020-12-01,158,0,946,0,45,1016099,156
300153534400,30-015-35344,LONG NOSE COM 001,2021-01-01,159,0,1627,0,45,1017726,156
300153534400,30-015-35344,LONG NOSE COM 001,2021-02-01,160,0,388,0,45,1018114,156
300153534400,30-015-35344,LONG NOSE COM 001,2021-03-01,161,0,418,0,45,1018532,156
300153534400,30-015-35344,LONG NOSE COM 001,2021-04-01,162,0,1016,0,45,1019548,156
300153534400,30-015-35344,LONG NOSE COM 001,2021-05-01,163,0,997,0,45,1020545,156
300153534400,30-015-35344,LONG NOSE COM 001,2021-06-01,164,0,481,0,45,1021026,156
300153534400,30-015-35344,LONG NOSE COM 001,2021-07-01,165,38,84,0,83,1021110,156
300153534400,30-015-35344,LONG NOSE COM 001,2021-08-01,166,0,240,0,83,1021350,156
300153534400,30-015-35344,LONG NOSE COM 001,2021-09-01,167,32,667,0,115,1022017,156
300153534400,30-015-35344,LONG NOSE COM 001,2021-10-01,168,0,501,0,115,1022518,156
300153534400,30-015-35344,LONG NOSE COM 001,2021-11-01,169,0,348,0,115,1022866,156
300153534400,30-015-35344,LONG NOSE COM 001,2021-12-01,170,0,267,0,115,1023133,156
300153534400,30-015-35344,LONG NOSE COM 001,2022-01-01,171,0,240,0,115,1023373,156
300153534400,30-015-35344,LONG NOSE COM 001,2022-02-01,172,2,273,0,117,1023646,156
300153534400,30-015-35344,LONG NOSE COM 001,2022-03-01,173,0,567,0,117,1024213,156
300153534400,30-015-35344,LONG NOSE COM 001,2022-04-01,174,0,583,0,117,1024796,156
300153534400,30-015-35344,LONG NOSE COM 001,2022-05-01,175,0,92,0,117,1024888,156
300153534400,30-015-35344,LONG NOSE COM 001,2022-06-01,176,0,9,0,117,1024897,156
300153534400,30-015-35344,LONG NOSE COM 001,2022-07-01,177,0,11,0,117,1024908,156
300153534400,30-015-35344,LONG NOSE COM 001,2022-08-01,178,0,15,0,117,1024923,156
300153534400,30-015-35344,LONG NOSE COM 001,2022-09-01,179,0,38,0,117,1024961,156
300153534400,30-015-35344,LONG NOSE COM 001,2022-10-01,180,0,52,0,117,1025013,156
300153534400,30-015-35344,LONG NOSE COM 001,2022-11-01,181,0,36,0,117,1025049,156
300153534400,30-015-35344,LONG NOSE COM 001,2022-12-01,182,0,21,0,117,1025070,156
300153534400,30-015-35344,LONG NOSE COM 001,2023-01-01,183,0,11,0,117,1025081,156
300153534400,30-015-35344,LONG NOSE COM 001,2023-02-01,184,0,18,0,117,1025099,156
300153534400,30-015-35344,LONG NOSE COM 001,2023-03-01,185,0,16,0,117,1025115,156
300153534400,30-015-35344,LONG NOSE COM 001,2023-04-01,186,0,27,0,117,1025142,156
300153534400,30-015-35344,LONG NOSE COM 001,2023-05-01,187,0,7,0,117,1025149,156
300153534400,30-015-35344,LONG NOSE COM 001,2023-06-01,188,0,23,0,117,1025172,156
300153534400,30-015-35344,LONG NOSE COM 001,2023-07-01,189,0,54,0,117,1025226,156
300154114500,30-015-41145,DOC HOLLIDAY 32 STATE COM 001,2014-04-01,1,7704,19704,38365,7704,19704,38365
300154114500,30-015-41145,DOC HOLLIDAY 32 STATE COM 001,2014-05-01,2,6922,34541,42917,14626,54245,81282
300154114500,30-015-41145,DOC HOLLIDAY 32 STATE COM 001,2014-06-01,3,4549,22539,25935,19175,76784,107217
300154114500,30-015-41145,DOC HOLLIDAY 32 STATE COM 001,2014-07-01,4,3357,12720,23229,22532,89504,130446
300154114500,30-015-41145,DOC HOLLIDAY 32 STATE COM 001,2014-08-01,5,3587,17815,25308,26119,107319,155754
300154114500,30-015-41145,DOC HOLLIDAY 32 STATE COM 001,2014-09-01,6,1351,5884,8818,27470,113203,164572
300154114500,30-015-41145,DOC HOLLIDAY 32 STATE COM 001,2014-10-01,7,2745,6698,9599,30215,119901,174171
300154114500,30-015-41145,DOC HOLLIDAY 32 STATE COM 001,2014-11-01,8,2399,7232,10181,32614,127133,184352
300154114500,30-015-41145,DOC HOLLIDAY 32 STATE COM 001,2014-12-01,9,2016,6197,11010,34630,133330,195362
300154114500,30-015-41145,DOC HOLLIDAY 32 STATE COM 001,2015-01-01,10,2118,6082,9549,36748,139412,204911
300154114500,30-015-41145,DOC HOLLIDAY 32 STATE COM 001,2015-02-01,11,1820,7973,7589,38568,147385,212500
300154114500,30-015-41145,DOC HOLLIDAY 32 STATE COM 001,2015-03-01,12,1583,5270,8506,40151,152655,221006
300154114500,30-015-41145,DOC HOLLIDAY 32 STATE COM 001,2015-04-01,13,1588,5324,6226,41739,157979,227232
300154114500,30-015-41145,DOC HOLLIDAY 32 STATE COM 001,2015-05-01,14,705,2512,2038,42444,160491,229270
300154114500,30-015-41145,DOC HOLLIDAY 32 STATE COM 001,2015-06-01,15,1169,3147,2124,43613,163638,231394
300154114500,30-015-41145,DOC HOLLIDAY 32 STATE COM 001,2015-07-01,16,892,3451,2466,44505,167089,233860
300154114500,30-015-41145,DOC HOLLIDAY 32 STATE COM 001,2015-08-01,17,1753,3600,3563,46258,170689,237423
300154114500,30-015-41145,DOC HOLLIDAY 32 STATE COM 001,2015-09-01,18,1151,2056,2701,47409,172745,240124
300154114500,30-015-41145,DOC HOLLIDAY 32 STATE COM 001,2015-10-01,19,1300,2782,3258,48709,175527,243382
300154114500,30-015-41145,DOC HOLLIDAY 32 STATE COM 001,2015-11-01,20,1087,2623,2600,49796,178150,245982
300154114500,30-015-41145,DOC HOLLIDAY 32 STATE COM 001,2015-12-01,21,987,2349,2451,50783,180499,248433
300154114500,30-015-41145,DOC HOLLIDAY 32 STATE COM 001,2016-01-01,22,1150,2294,2490,51933,182793,250923
300154114500,30-015-41145,DOC HOLLIDAY 32 STATE COM 001,2016-02-01,23,1100,3093,2551,53033,185886,253474
300154114500,30-015-41145,DOC HOLLIDAY 32 STATE COM 001,2016-03-01,24,914,2919,1673,53947,188805,255147
300154114500,30-015-41145,DOC HOLLIDAY 32 STATE COM 001,2016-04-01,25,1047,3290,2566,54994,192095,257713
300154114500,30-015-41145,DOC HOLLIDAY 32 STATE COM 001,2016-05-01,26,991,3161,2498,55985,195256,260211
300154114500,30-015-41145,DOC HOLLIDAY 32 STATE COM 001,2016-06-01,27,847,2573,2315,56832,197829,262526
300154114500,30-015-41145,DOC HOLLIDAY 32 STATE COM 001,2016-07-01,28,887,2978,2346,57719,200807,264872
300154114500,30-015-41145,DOC HOLLIDAY 32 STATE COM 001,2016-08-01,29,885,2288,1624,58604,203095,266496
300154114500,30-015-41145,DOC HOLLIDAY 32 STATE COM 001,2016-09-01,30,768,2642,1907,59372,205737,268403
300154114500,30-015-41145,DOC HOLLIDAY 32 STATE COM 001,2016-10-01,31,702,2398,1603,60074,208135,270006
300154114500,30-015-41145,DOC HOLLIDAY 32 STATE COM 001,2016-11-01,32,704,2545,1596,60778,210680,271602
300154114500,30-015-41145,DOC HOLLIDAY 32 STATE COM 001,2016-12-01,33,874,2702,2012,61652,213382,273614
300154114500,30-015-41145,DOC HOLLIDAY 32 STATE COM 001,2017-01-01,34,738,2493,1754,62390,215875,275368
300154114500,30-015-41145,DOC HOLLIDAY 32 STATE COM 001,2017-02-01,35,824,2738,1778,63214,218613,277146
300154114500,30-015-41145,DOC HOLLIDAY 32 STATE COM 001,2017-03-01,36,845,3100,2018,64059,221713,279164
300154114500,30-015-41145,DOC HOLLIDAY 32 STATE COM 001,2017-04-01,37,769,3109,1943,64828,224822,281107
300154114500,30-015-41145,DOC HOLLIDAY 32 STATE COM 001,2017-05-01,38,780,2951,2067,65608,227773,283174
300154114500,30-015-41145,DOC HOLLIDAY 32 STATE COM 001,2017-06-01,39,754,2922,1885,66362,230695,285059
300154114500,30-015-41145,DOC HOLLIDAY 32 STATE COM 001,2017-07-01,40,466,2321,1423,66828,233016,286482
300154114500,30-015-41145,DOC HOLLIDAY 32 STATE COM 001,2017-08-01,41,793,2731,2506,67621,235747,288988
300154114500,30-015-41145,DOC HOLLIDAY 32 STATE COM 001,2017-09-01,42,770,2284,3441,68391,238031,292429
300154114500,30-015-41145,DOC HOLLIDAY 32 STATE COM 001,2017-10-01,43,752,2323,2575,69143,240354,295004
300154114500,30-015-41145,DOC HOLLIDAY 32 STATE COM 001,2017-11-01,44,694,2915,2691,69837,243269,297695
300154114500,30-015-41145,DOC HOLLIDAY 32 STATE COM 001,2017-12-01,45,713,1608,2790,70550,244877,300485
300154114500,30-015-41145,DOC HOLLIDAY 32 STATE COM 001,2018-01-01,46,596,1118,2016,71146,245995,302501
300154114500,30-015-41145,DOC HOLLIDAY 32 STATE COM 001,2018-02-01,47,343,1643,1543,71489,247638,304044
300154114500,30-015-41145,DOC HOLLIDAY 32 STATE COM 001,2018-03-01,48,887,2774,3552,72376,250412,307596
300154114500,30-015-41145,DOC HOLLIDAY 32 STATE COM 001,2018-04-01,49,638,3003,2093,73014,253415,309689
300154114500,30-015-41145,DOC HOLLIDAY 32 STATE COM 001,2018-05-01,50,696,2492,2838,73710,255907,312527
300154114500,30-015-41145,DOC HOLLIDAY 32 STATE COM 001,2018-06-01,51,673,2635,1132,74383,258542,313659
300154114500,30-015-41145,DOC HOLLIDAY 32 STATE COM 001,2018-07-01,52,609,2877,1780,74992,261419,315439
300154114500,30-015-41145,DOC HOLLIDAY 32 STATE COM 001,2018-08-01,53,396,2948,997,75388,264367,316436
300154114500,30-015-41145,DOC HOLLIDAY 32 STATE COM 001,2018-09-01,54,700,1629,2036,76088,265996,318472
300154114500,30-015-41145,DOC HOLLIDAY 32 STATE COM 001,2018-10-01,55,598,1312,1800,76686,267308,320272
300154114500,30-015-41145,DOC HOLLIDAY 32 STATE COM 001,2018-11-01,56,552,363,839,77238,267671,321111
300154114500,30-015-41145,DOC HOLLIDAY 32 STATE COM 001,2018-12-01,57,372,1558,136,77610,269229,321247
300154114500,30-015-41145,DOC HOLLIDAY 32 STATE COM 001,2019-01-01,58,989,1130,7752,78599,270359,328999
300154114500,30-015-41145,DOC HOLLIDAY 32 STATE COM 001,2019-02-01,59,844,1725,6942,79443,272084,335941
300154114500,30-015-41145,DOC HOLLIDAY 32 STATE COM 001,2019-03-01,60,656,1862,5761,80099,273946,341702
300154114500,30-015-41145,DOC HOLLIDAY 32 STATE COM 001,2019-04-01,61,918,1870,8426,81017,275816,350128
300154114500,30-015-41145,DOC HOLLIDAY 32 STATE COM 001,2019-05-01,62,722,2064,6510,81739,277880,356638
300154114500,30-015-41145,DOC HOLLIDAY 32 STATE COM 001,2019-06-01,63,666,2295,2341,82405,280175,358979
300154114500,30-015-41145,DOC HOLLIDAY 32 STATE COM 001,2019-07-01,64,633,2062,4332,83038,282237,363311
300154114500,30-015-41145,DOC HOLLIDAY 32 STATE COM 001,2019-08-01,65,617,2635,4057,83655,284872,367368
300154114500,30-015-41145,DOC HOLLIDAY 32 STATE COM 001,2019-09-01,66,644,2107,1525,84299,286979,368893
300154114500,30-015-41145,DOC HOLLIDAY 32 STATE COM 001,2019-10-01,67,653,1983,3458,84952,288962,372351
300154114500,30-015-41145,DOC HOLLIDAY 32 STATE COM 001,2019-11-01,68,510,718,3902,85462,289680,376253
300154114500,30-015-41145,DOC HOLLIDAY 32 STATE COM 001,2019-12-01,69,598,1661,3197,86060,291341,379450
300154114500,30-015-41145,DOC HOLLIDAY 32 STATE COM 001,2020-01-01,70,665,1833,7818,86725,293174,387268
300154114500,30-015-41145,DOC HOLLIDAY 32 STATE COM 001,2020-02-01,71,616,2767,3461,87341,295941,390729
300154114500,30-015-41145,DOC HOLLIDAY 32 STATE COM 001,2020-03-01,72,376,2495,7164,87717,298436,397893
300154114500,30-015-41145,DOC HOLLIDAY 32 STATE COM 001,2020-04-01,73,594,2799,4580,88311,301235,402473
300154114500,30-015-41145,DOC HOLLIDAY 32 STATE COM 001,2020-05-01,74,549,3282,7781,88860,304517,410254
300154114500,30-015-41145,DOC HOLLIDAY 32 STATE COM 001,2020-06-01,75,605,3150,4267,89465,307667,414521
300154114500,30-015-41145,DOC HOLLIDAY 32 STATE COM 001,2020-07-01,76,518,3305,3269,89983,310972,417790
300154114500,30-015-41145,DOC HOLLIDAY 32 STATE COM 001,2020-08-01,77,379,3020,2612,90362,313992,420402
300154114500,30-015-41145,DOC HOLLIDAY 32 STATE COM 001,2020-09-01,78,735,3909,4904,91097,317901,425306
300154114500,30-015-41145,DOC HOLLIDAY 32 STATE COM 001,2020-10-01,79,489,3941,3376,91586,321842,428682
300154114500,30-015-41145,DOC HOLLIDAY 32 STATE COM 001,2020-11-01,80,781,5409,5783,92367,327251,434465
300154114500,30-015-41145,DOC HOLLIDAY 32 STATE COM 001,2020-12-01,81,611,5293,7677,92978,332544,442142
300154114500,30-015-41145,DOC HOLLIDAY 32 STATE COM 001,2021-01-01,82,604,6172,4617,93582,338716,446759
300154114500,30-015-41145,DOC HOLLIDAY 32 STATE COM 001,2021-02-01,83,464,5186,2510,94046,343902,449269
300154114500,30-015-41145,DOC HOLLIDAY 32 STATE COM 001,2021-03-01,84,670,6216,5267,94716,350118,454536
300154114500,30-015-41145,DOC HOLLIDAY 32 STATE COM 001,2021-04-01,85,541,6110,5217,95257,356228,459753
300154114500,30-015-41145,DOC HOLLIDAY 32 STATE COM 001,2021-05-01,86,483,6206,5097,95740,362434,464850
300154114500,30-015-41145,DOC HOLLIDAY 32 STATE COM 001,2021-06-01,87,396,5162,3567,96136,367596,468417
300154114500,30-015-41145,DOC HOLLIDAY 32 STATE COM 001,2021-07-01,88,485,5519,4571,96621,373115,472988
300154114500,30-015-41145,DOC HOLLIDAY 32 STATE COM 001,2021-08-01,89,521,6069,4656,97142,379184,477644
300154114500,30-015-41145,DOC HOLLIDAY 32 STATE COM 001,2021-09-01,90,457,7007,4704,97599,386191,482348
300154114500,30-015-41145,DOC HOLLIDAY 32 STATE COM 001,2021-10-01,91,166,2554,1797,97765,388745,484145
300154114500,30-015-41145,DOC HOLLIDAY 32 STATE COM 001,2021-11-01,92,493,6718,3644,98258,395463,487789
300154114500,30-015-41145,DOC HOLLIDAY 32 STATE COM 001,2021-12-01,93,562,5622,3981,98820,401085,491770
300154114500,30-015-41145,DOC HOLLIDAY 32 STATE COM 001,2022-01-01,94,552,6725,4068,99372,407810,495838
300154114500,30-015-41145,DOC HOLLIDAY 32 STATE COM 001,2022-02-01,95,277,3413,1779,99649,411223,497617
300154114500,30-015-41145,DOC HOLLIDAY 32 STATE COM 001,2022-03-01,96,544,5850,3696,100193,417073,501313
300154114500,30-015-41145,DOC HOLLIDAY 32 STATE COM 001,2022-04-01,97,450,4880,3549,100643,421953,504862
300154114500,30-015-41145,DOC HOLLIDAY 32 STATE COM 001,2022-05-01,98,22,1503,8,100665,423456,504870
300154114500,30-015-41145,DOC HOLLIDAY 32 STATE COM 001,2022-06-01,99,188,2854,988,100853,426310,505858
300154114500,30-015-41145,DOC HOLLIDAY 32 STATE COM 001,2022-07-01,100,0,1892,5,100853,428202,505863
300154114500,30-015-41145,DOC HOLLIDAY 32 STATE COM 001,2022-08-01,101,0,963,5,100853,429165,505868
300154114500,30-015-41145,DOC HOLLIDAY 32 STATE COM 001,2022-09-01,102,0,1976,34,100853,431141,505902
300154114500,30-015-41145,DOC HOLLIDAY 32 STATE COM 001,2022-10-01,103,0,459,16,100853,431600,505918
300154114500,30-015-41145,DOC HOLLIDAY 32 STATE COM 001,2022-11-01,104,0,239,0,100853,431839,505918
300154114500,30-015-41145,DOC HOLLIDAY 32 STATE COM 001,2022-12-01,105,0,0,0,100853,431839,505918
300154114500,30-015-41145,DOC HOLLIDAY 32 STATE COM 001,2023-01-01,106,0,1096,0,100853,432935,505918
300154114500,30-015-41145,DOC HOLLIDAY 32 STATE COM 001,2023-02-01,107,6,0,0,100859,432935,505918
300154114500,30-015-41145,DOC HOLLIDAY 32 STATE COM 001,2023-03-01,108,0,982,10,100859,433917,505928
300154114500,30-015-41145,DOC HOLLIDAY 32 STATE COM 001,2023-04-01,109,0,2036,0,100859,435953,505928
300154114500,30-015-41145,DOC HOLLIDAY 32 STATE COM 001,2023-05-01,110,0,0,0,100859,435953,505928
300154114500,30-015-41145,DOC HOLLIDAY 32 STATE COM 001,2023-06-01,111,230,2021,208,101089,437974,506136
300154114500,30-015-41145,DOC HOLLIDAY 32 STATE COM 001,2023-07-01,112,629,2338,868,101718,440312,507004
300152581200,30-015-25812,HARKEY 35 STATE 001,1989-01-01,1,293,7178,28,293,7178,28
300152581200,30-015-25812,HARKEY 35 STATE 001,1989-02-01,2,242,6024,7,535,13202,35
300152581200,30-015-25812,HARKEY 35 STATE 001,1989-03-01,3,241,6542,33,776,19744,68
300152581200,30-015-25812,HARKEY 35 STATE 001,1989-04-01,4,35,6214,27,811,25958,95
300152581200,30-015-25812,HARKEY 35 STATE 001,1989-05-01,5,18,6547,19,829,32505,114
300152581200,30-015-25812,HARKEY 35 STATE 001,1989-06-01,6,14,3212,14,843,35717,128
300152581200,30-015-25812,HARKEY 35 STATE 001,1989-07-01,7,94,3328,0,937,39045,128
300152581200,30-015-25812,HARKEY 35 STATE 001,1989-08-01,8,217,6646,44,1154,45691,172
300152581200,30-015-25812,HARKEY 35 STATE 001,1989-09-01,9,143,5460,28,1297,51151,200
300152581200,30-015-25812,HARKEY 35 STATE 001,1989-10-01,10,285,6131,37,1582,57282,237
300152581200,30-015-25812,HARKEY 35 STATE 001,1989-11-01,11,68,5751,31,1650,63033,268
300152581200,30-015-25812,HARKEY 35 STATE 001,1989-12-01,12,355,5852,35,2005,68885,303
300152581200,30-015-25812,HARKEY 35 STATE 001,1990-01-01,13,208,5565,28,2213,74450,331
300152581200,30-015-25812,HARKEY 35 STATE 001,1990-02-01,14,171,4712,26,2384,79162,357
300152581200,30-015-25812,HARKEY 35 STATE 001,1990-03-01,15,193,5489,37,2577,84651,394
300152581200,30-015-25812,HARKEY 35 STATE 001,1990-04-01,16,256,5001,28,2833,89652,422
300152581200,30-015-25812,HARKEY 35 STATE 001,1990-05-01,17,76,5397,27,2909,95049,449
300152581200,30-015-25812,HARKEY 35 STATE 001,1990-06-01,18,139,5041,26,3048,100090,475
300152581200,30-015-25812,HARKEY 35 STATE 001,1990-07-01,19,115,4864,28,3163,104954,503
300152581200,30-015-25812,HARKEY 35 STATE 001,1990-08-01,20,136,4726,56,3299,109680,559
300152581200,30-015-25812,HARKEY 35 STATE 001,1990-09-01,21,77,4344,33,3376,114024,592
300152581200,30-015-25812,HARKEY 35 STATE 001,1990-10-01,22,128,4617,38,3504,118641,630
300152581200,30-015-25812,HARKEY 35 STATE 001,1990-11-01,23,131,4455,26,3635,123096,656
300152581200,30-015-25812,HARKEY 35 STATE 001,1990-12-01,24,140,3568,47,3775,126664,703
300152581200,30-015-25812,HARKEY 35 STATE 001,1991-01-01,25,16,3261,15,3791,129925,718
300152581200,30-015-25812,HARKEY 35 STATE 001,1991-02-01,26,30,3927,36,3821,133852,754
300152581200,30-015-25812,HARKEY 35 STATE 001,1991-03-01,27,169,4272,0,3990,138124,754
300152581200,30-015-25812,HARKEY 35 STATE 001,1991-04-01,28,57,4097,22,4047,142221,776
300152581200,30-015-25812,HARKEY 35 STATE 001,1991-05-01,29,151,4184,43,4198,146405,819
300152581200,30-015-25812,HARKEY 35 STATE 001,1991-06-01,30,78,4000,45,4276,150405,864
300152581200,30-015-25812,HARKEY 35 STATE 001,1991-07-01,31,15,4364,76,4291,154769,940
300152581200,30-015-25812,HARKEY 35 STATE 001,1991-08-01,32,0,4266,28,4291,159035,968
300152581200,30-015-25812,HARKEY 35 STATE 001,1991-09-01,33,7,3933,23,4298,162968,991
300152581200,30-015-25812,HARKEY 35 STATE 001,1991-10-01,34,0,4144,0,4298,167112,991
300152581200,30-015-25812,HARKEY 35 STATE 001,1991-11-01,35,0,3645,28,4298,170757,1019
300152581200,30-015-25812,HARKEY 35 STATE 001,1991-12-01,36,20,3413,24,4318,174170,1043
300152581200,30-015-25812,HARKEY 35 STATE 001,1992-01-01,37,51,3964,32,4369,178134,1075
300152581200,30-015-25812,HARKEY 35 STATE 001,1992-02-01,38,105,3666,0,4474,181800,1075
300152581200,30-015-25812,HARKEY 35 STATE 001,1992-03-01,39,142,4268,64,4616,186068,1139
300152581200,30-015-25812,HARKEY 35 STATE 001,1992-04-01,40,108,4164,39,4724,190232,1178
300152581200,30-015-25812,HARKEY 35 STATE 001,1992-05-01,41,70,4227,25,4794,194459,1203
300152581200,30-015-25812,HARKEY 35 STATE 001,1992-06-01,42,119,4018,8,4913,198477,1211
300152581200,30-015-25812,HARKEY 35 STATE 001,1992-07-01,43,88,4127,14,5001,202604,1225
300152581200,30-015-25812,HARKEY 35 STATE 001,1992-08-01,44,108,4061,10,5109,206665,1235
300152581200,30-015-25812,HARKEY 35 STATE 001,1992-09-01,45,89,3913,25,5198,210578,1260
300152581200,30-015-25812,HARKEY 35 STATE 001,1992-10-01,46,65,3937,22,5263,214515,1282
300152581200,30-015-25812,HARKEY 35 STATE 001,1992-11-01,47,69,3296,21,5332,217811,1303
300152581200,30-015-25812,HARKEY 35 STATE 001,1992-12-01,48,54,3952,26,5386,221763,1329
300152581200,30-015-25812,HARKEY 35 STATE 001,1993-01-01,49,16,3757,30,5402,225520,1359
300152581200,30-015-25812,HARKEY 35 STATE 001,1993-02-01,50,91,3270,30,5493,228790,1389
300152581200,30-015-25812,HARKEY 35 STATE 001,1993-03-01,51,51,3656,27,5544,232446,1416
300152581200,30-015-25812,HARKEY 35 STATE 001,1993-04-01,52,48,3470,41,5592,235916,1457
300152581200,30-015-25812,HARKEY 35 STATE 001,1993-05-01,53,38,3548,0,5630,239464,1457
300152581200,30-015-25812,HARKEY 35 STATE 001,1993-06-01,54,14,3473,11,5644,242937,1468
300152581200,30-015-25812,HARKEY 35 STATE 001,1993-07-01,55,5,3303,0,5649,246240,1468
300152581200,30-015-25812,HARKEY 35 STATE 001,1993-08-01,56,0,3556,0,5649,249796,1468
300152581200,30-015-25812,HARKEY 35 STATE 001,1993-09-01,57,87,3653,0,5736,253449,1468
300152581200,30-015-25812,HARKEY 35 STATE 001,1993-10-01,58,0,3709,12,5736,257158,1480
300152581200,30-015-25812,HARKEY 35 STATE 001,1993-11-01,59,0,3359,12,5736,260517,1492
300152581200,30-015-25812,HARKEY 35 STATE 001,1993-12-01,60,0,2390,3,5736,262907,1495
300152581200,30-015-25812,HARKEY 35 STATE 001,1994-01-01,61,122,2649,1392,5858,265556,2887
300152581200,30-015-25812,HARKEY 35 STATE 001,1994-02-01,62,0,3123,34,5858,268679,2921
300152581200,30-015-25812,HARKEY 35 STATE 001,1994-03-01,63,0,3146,26,5858,271825,2947
300152581200,30-015-25812,HARKEY 35 STATE 001,1994-04-01,64,0,3353,20440,5858,275178,23387
300152581200,30-015-25812,HARKEY 35 STATE 001,1994-05-01,65,27,2868,10,5885,278046,23397
300152581200,30-015-25812,HARKEY 35 STATE 001,1994-06-01,66,0,3009,0,5885,281055,23397
300152581200,30-015-25812,HARKEY 35 STATE 001,1994-07-01,67,216,3853,22,6101,284908,23419
300152581200,30-015-25812,HARKEY 35 STATE 001,1994-08-01,68,166,6002,85,6267,290910,23504
300152581200,30-015-25812,HARKEY 35 STATE 001,1994-09-01,69,297,5796,164,6564,296706,23668
300152581200,30-015-25812,HARKEY 35 STATE 001,1994-10-01,70,234,5127,155,6798,301833,23823
300152581200,30-015-25812,HARKEY 35 STATE 001,1994-11-01,71,265,5486,84,7063,307319,23907
300152581200,30-015-25812,HARKEY 35 STATE 001,1994-12-01,72,347,5527,124,7410,312846,24031
300152581200,30-015-25812,HARKEY 35 STATE 001,1995-01-01,1,499,1372,88,7909,314218,24119
300152581200,30-015-25812,HARKEY 35 STATE 001,1995-02-01,2,758,2811,549,8667,317029,24668
300152581200,30-015-25812,HARKEY 35 STATE 001,1995-04-01,1,377,1743,83,9044,318772,24751
300152581200,30-015-25812,HARKEY 35 STATE 001,1995-05-01,2,369,1032,60,9413,319804,24811
300152581200,30-015-25812,HARKEY 35 STATE 001,1995-06-01,3,283,1507,60,9696,321311,24871
300152581200,30-015-25812,HARKEY 35 STATE 001,1995-07-01,4,0,0,0,9696,321311,24871
300152581200,30-015-25812,HARKEY 35 STATE 001,1995-08-01,5,178,829,41,9874,322140,24912
300152581200,30-015-25812,HARKEY 35 STATE 001,1995-09-01,6,290,0,60,10164,322140,24972
300152581200,30-015-25812,HARKEY 35 STATE 001,1995-10-01,7,238,0,62,10402,322140,25034
300152581200,30-015-25812,HARKEY 35 STATE 001,1995-11-01,8,265,0,57,10667,322140,25091
300152581200,30-015-25812,HARKEY 35 STATE 001,1995-12-01,9,234,0,61,10901,322140,25152
300152581200,30-015-25812,HARKEY 35 STATE 001,1996-01-01,10,233,0,90,11134,322140,25242
300152581200,30-015-25812,HARKEY 35 STATE 001,1996-02-01,11,195,0,87,11329,322140,25329
300152581200,30-015-25812,HARKEY 35 STATE 001,1996-03-01,12,188,0,93,11517,322140,25422
300152581200,30-015-25812,HARKEY 35 STATE 001,1996-04-01,13,173,0,87,11690,322140,25509
300152581200,30-015-25812,HARKEY 35 STATE 001,1996-05-01,14,171,0,29,11861,322140,25538
300152581200,30-015-25812,HARKEY 35 STATE 001,1996-06-01,15,61,227,0,11922,322367,25538
300152581200,30-015-25812,HARKEY 35 STATE 001,1996-07-01,16,0,7986,16,11922,330353,25554
300152581200,30-015-25812,HARKEY 35 STATE 001,1996-08-01,17,134,11692,151,12056,342045,25705
300152581200,30-015-25812,HARKEY 35 STATE 001,1996-09-01,18,459,9980,223,12515,352025,25928
300152581200,30-015-25812,HARKEY 35 STATE 001,1996-10-01,19,455,6589,158,12970,358614,26086
300152581200,30-015-25812,HARKEY 35 STATE 001,1996-11-01,20,333,6789,61,13303,365403,26147
300152581200,30-015-25812,HARKEY 35 STATE 001,1996-12-01,21,272,9284,175,13575,374687,26322
300152581200,30-015-25812,HARKEY 35 STATE 001,1997-01-01,22,487,7866,188,14062,382553,26510
300152581200,30-015-25812,HARKEY 35 STATE 001,1997-02-01,23,385,6249,114,14447,388802,26624
300152581200,30-015-25812,HARKEY 35 STATE 001,1997-03-01,24,452,7124,179,14899,395926,26803
300152581200,30-015-25812,HARKEY 35 STATE 001,1997-04-01,25,280,6814,137,15179,402740,26940
300152581200,30-015-25812,HARKEY 35 STATE 001,1997-05-01,26,382,7499,157,15561,410239,27097
300152581200,30-015-25812,HARKEY 35 STATE 001,1997-06-01,27,292,7643,147,15853,417882,27244
300152581200,30-015-25812,HARKEY 35 STATE 001,1997-07-01,28,356,6692,124,16209,424574,27368
300152581200,30-015-25812,HARKEY 35 STATE 001,1997-08-01,29,402,6754,146,16611,431328,27514
300152581200,30-015-25812,HARKEY 35 STATE 001,1997-09-01,30,373,6491,143,16984,437819,27657
300152581200,30-015-25812,HARKEY 35 STATE 001,1997-10-01,31,323,5712,109,17307,443531,27766
300152581200,30-015-25812,HARKEY 35 STATE 001,1997-11-01,32,373,5676,128,17680,449207,27894
300152581200,30-015-25812,HARKEY 35 STATE 001,1997-12-01,33,380,6065,152,18060,455272,28046
300152581200,30-015-25812,HARKEY 35 STATE 001,1998-01-01,34,346,6135,118,18406,461407,28164
300152581200,30-015-25812,HARKEY 35 STATE 001,1998-02-01,35,300,5424,114,18706,466831,28278
300152581200,30-015-25812,HARKEY 35 STATE 001,1998-03-01,36,301,5467,95,19007,472298,28373
300152581200,30-015-25812,HARKEY 35 STATE 001,1998-04-01,37,340,5455,138,19347,477753,28511
300152581200,30-015-25812,HARKEY 35 STATE 001,1998-05-01,38,294,5360,114,19641,483113,28625
300152581200,30-015-25812,HARKEY 35 STATE 001,1998-06-01,39,291,5095,108,19932,488208,28733
300152581200,30-015-25812,HARKEY 35 STATE 001,1998-07-01,40,284,5183,113,20216,493391,28846
300152581200,30-015-25812,HARKEY 35 STATE 001,1998-08-01,41,275,5023,99,20491,498414,28945
300152581200,30-015-25812,HARKEY 35 STATE 001,1998-09-01,42,256,4630,61,20747,503044,29006
300152581200,30-015-25812,HARKEY 35 STATE 001,1998-10-01,43,291,5239,117,21038,508283,29123
300152581200,30-015-25812,HARKEY 35 STATE 001,1998-11-01,44,298,4949,108,21336,513232,29231
300152581200,30-015-25812,HARKEY 35 STATE 001,1998-12-01,45,300,5045,118,21636,518277,29349
300152581200,30-015-25812,HARKEY 35 STATE 001,1999-01-01,46,271,5093,125,21907,523370,29474
300152581200,30-015-25812,HARKEY 35 STATE 001,1999-02-01,47,264,4655,121,22171,528025,29595
300152581200,30-015-25812,HARKEY 35 STATE 001,1999-03-01,48,232,5143,135,22403,533168,29730
300152581200,30-015-25812,HARKEY 35 STATE 001,1999-04-01,49,259,4915,136,22662,538083,29866
300152581200,30-015-25812,HARKEY 35 STATE 001,1999-05-01,50,277,4902,122,22939,542985,29988
300152581200,30-015-25812,HARKEY 35 STATE 001,1999-06-01,51,240,4642,104,23179,547627,30092
300152581200,30-015-25812,HARKEY 35 STATE 001,1999-07-01,52,203,4329,100,23382,551956,30192
300152581200,30-015-25812,HARKEY 35 STATE 001,1999-08-01,53,237,4675,100,23619,556631,30292
300152581200,30-015-25812,HARKEY 35 STATE 001,1999-09-01,54,113,3894,100,23732,560525,30392
300152581200,30-015-25812,HARKEY 35 STATE 001,1999-10-01,55,140,2779,111,23872,563304,30503
300152581200,30-015-25812,HARKEY 35 STATE 001,1999-11-01,56,302,4646,105,24174,567950,30608
300152581200,30-015-25812,HARKEY 35 STATE 001,1999-12-01,57,259,4232,109,24433,572182,30717
300152581200,30-015-25812,HARKEY 35 STATE 001,2000-01-01,58,232,4156,103,24665,576338,30820
300152581200,30-015-25812,HARKEY 35 STATE 001,2000-02-01,59,226,3921,92,24891,580259,30912
300152581200,30-015-25812,HARKEY 35 STATE 001,2000-03-01,60,208,6865,85,25099,587124,30997
300152581200,30-015-25812,HARKEY 35 STATE 001,2000-04-01,61,224,9750,94,25323,596874,31091
300152581200,30-015-25812,HARKEY 35 STATE 001,2000-05-01,62,183,10048,90,25506,606922,31181
300152581200,30-015-25812,HARKEY 35 STATE 001,2000-06-01,63,139,6276,99,25645,613198,31280
300152581200,30-015-25812,HARKEY 35 STATE 001,2000-07-01,64,140,2654,58,25785,615852,31338
300152581200,30-015-25812,HARKEY 35 STATE 001,2000-08-01,65,164,3123,73,25949,618975,31411
300152581200,30-015-25812,HARKEY 35 STATE 001,2000-09-01,66,132,2291,52,26081,621266,31463
300152581200,30-015-25812,HARKEY 35 STATE 001,2000-10-01,67,116,2763,62,26197,624029,31525
300152581200,30-015-25812,HARKEY 35 STATE 001,2000-11-01,68,128,3336,35,26325,627365,31560
300152581200,30-015-25812,HARKEY 35 STATE 001,2000-12-01,69,161,3719,45,26486,631084,31605
300152581200,30-015-25812,HARKEY 35 STATE 001,2001-01-01,70,234,3373,98,26720,634457,31703
300152581200,30-015-25812,HARKEY 35 STATE 001,2001-02-01,71,170,3136,61,26890,637593,31764
300152581200,30-015-25812,HARKEY 35 STATE 001,2001-03-01,72,172,3434,98,27062,641027,31862
300152581200,30-015-25812,HARKEY 35 STATE 001,2001-04-01,73,252,4263,158,27314,645290,32020
300152581200,30-015-25812,HARKEY 35 STATE 001,2001-05-01,74,246,4513,135,27560,649803,32155
300152581200,30-015-25812,HARKEY 35 STATE 001,2001-06-01,75,178,4351,110,27738,654154,32265
300152581200,30-015-25812,HARKEY 35 STATE 001,2001-07-01,76,162,4183,115,27900,658337,32380
300152581200,30-015-25812,HARKEY 35 STATE 001,2001-08-01,77,165,3948,94,28065,662285,32474
300152581200,30-015-25812,HARKEY 35 STATE 001,2001-09-01,78,164,3606,7,28229,665891,32481
300152581200,30-015-25812,HARKEY 35 STATE 001,2001-10-01,79,260,3886,130,28489,669777,32611
300152581200,30-015-25812,HARKEY 35 STATE 001,2001-11-01,80,276,4701,90,28765,674478,32701
300152581200,30-015-25812,HARKEY 35 STATE 001,2001-12-01,81,195,4714,156,28960,679192,32857
300152581200,30-015-25812,HARKEY 35 STATE 001,2002-01-01,82,225,5311,191,29185,684503,33048
300152581200,30-015-25812,HARKEY 35 STATE 001,2002-02-01,83,188,4506,132,29373,689009,33180
300152581200,30-015-25812,HARKEY 35 STATE 001,2002-03-01,84,158,4646,163,29531,693655,33343
300152581200,30-015-25812,HARKEY 35 STATE 001,2002-04-01,85,210,4383,105,29741,698038,33448
300152581200,30-015-25812,HARKEY 35 STATE 001,2002-05-01,86,244,4311,243,29985,702349,33691
300152581200,30-015-25812,HARKEY 35 STATE 001,2002-06-01,87,171,3555,71,30156,705904,33762
300152581200,30-015-25812,HARKEY 35 STATE 001,2002-07-01,88,216,4829,153,30372,710733,33915
300152581200,30-015-25812,HARKEY 35 STATE 001,2002-08-01,89,168,3442,108,30540,714175,34023
300152581200,30-015-25812,HARKEY 35 STATE 001,2002-09-01,90,40,4026,36,30580,718201,34059
300152581200,30-015-25812,HARKEY 35 STATE 001,2002-10-01,91,8,4710,21,30588,722911,34080
300152581200,30-015-25812,HARKEY 35 STATE 001,2002-11-01,92,231,3957,79,30819,726868,34159
300152581200,30-015-25812,HARKEY 35 STATE 001,2002-12-01,93,54,4269,63,30873,731137,34222
300152581200,30-015-25812,HARKEY 35 STATE 001,2003-01-01,94,158,3783,90,31031,734920,34312
300152581200,30-015-25812,HARKEY 35 STATE 001,2003-02-01,95,37,3657,77,31068,738577,34389
300152581200,30-015-25812,HARKEY 35 STATE 001,2003-03-01,96,181,4273,92,31249,742850,34481
300152581200,30-015-25812,HARKEY 35 STATE 001,2003-04-01,97,87,4236,72,31336,747086,34553
300152581200,30-015-25812,HARKEY 35 STATE 001,2003-05-01,98,15,4392,42,31351,751478,34595
300152581200,30-015-25812,HARKEY 35 STATE 001,2003-06-01,99,122,3400,54,31473,754878,34649
300152581200,30-015-25812,HARKEY 35 STATE 001,2003-07-01,100,87,3993,153,31560,758871,34802
300152581200,30-015-25812,HARKEY 35 STATE 001,2003-08-01,101,186,3986,113,31746,762857,34915
300152581200,30-015-25812,HARKEY 35 STATE 001,2003-09-01,102,188,3786,95,31934,766643,35010
300152581200,30-015-25812,HARKEY 35 STATE 001,2003-10-01,103,157,3439,104,32091,770082,35114
300152581200,30-015-25812,HARKEY 35 STATE 001,2003-11-01,104,142,3776,132,32233,773858,35246
300152581200,30-015-25812,HARKEY 35 STATE 001,2003-12-01,105,114,3764,111,32347,777622,35357
300152581200,30-015-25812,HARKEY 35 STATE 001,2004-01-01,106,103,3178,57,32450,780800,35414
300152581200,30-015-25812,HARKEY 35 STATE 001,2004-02-01,107,132,3577,71,32582,784377,35485
300152581200,30-015-25812,HARKEY 35 STATE 001,2004-03-01,108,69,3698,84,32651,788075,35569
300152581200,30-015-25812,HARKEY 35 STATE 001,2004-04-01,109,79,3479,51,32730,791554,35620
300152581200,30-015-25812,HARKEY 35 STATE 001,2004-05-01,110,310,3308,69,33040,794862,35689
300152581200,30-015-25812,HARKEY 35 STATE 001,2004-06-01,111,121,2237,69,33161,797099,35758
300152581200,30-015-25812,HARKEY 35 STATE 001,2004-07-01,112,217,2209,111,33378,799308,35869
300152581200,30-015-25812,HARKEY 35 STATE 001,2004-08-01,113,161,2022,49,33539,801330,35918
300152581200,30-015-25812,HARKEY 35 STATE 001,2004-09-01,114,42,1953,56,33581,803283,35974
300152581200,30-015-25812,HARKEY 35 STATE 001,2004-10-01,115,138,2119,16,33719,805402,35990
300152581200,30-015-25812,HARKEY 35 STATE 001,2004-11-01,116,103,2042,83,33822,807444,36073
300152581200,30-015-25812,HARKEY 35 STATE 001,2004-12-01,117,229,7982,65,34051,815426,36138
300152581200,30-015-25812,HARKEY 35 STATE 001,2005-01-01,118,196,6683,39,34247,822109,36177
300152581200,30-015-25812,HARKEY 35 STATE 001,2005-02-01,119,113,3188,95,34360,825297,36272
300152581200,30-015-25812,HARKEY 35 STATE 001,2005-03-01,120,83,3641,87,34443,828938,36359
300152581200,30-015-25812,HARKEY 35 STATE 001,2005-04-01,121,90,3458,81,34533,832396,36440
300152581200,30-015-25812,HARKEY 35 STATE 001,2005-05-01,122,144,3174,98,34677,835570,36538
300152581200,30-015-25812,HARKEY 35 STATE 001,2005-06-01,123,170,2721,64,34847,838291,36602
300152581200,30-015-25812,HARKEY 35 STATE 001,2005-07-01,124,193,2848,63,35040,841139,36665
300152581200,30-015-25812,HARKEY 35 STATE 001,2005-08-01,125,214,3359,75,35254,844498,36740
300152581200,30-015-25812,HARKEY 35 STATE 001,2005-09-01,126,215,3158,50,35469,847656,36790
300152581200,30-015-25812,HARKEY 35 STATE 001,2005-10-01,127,112,3451,82,35581,851107,36872
300152581200,30-015-25812,HARKEY 35 STATE 001,2005-11-01,128,110,2886,56,35691,853993,36928
300152581200,30-015-25812,HARKEY 35 STATE 001,2005-12-01,129,104,7354,72,35795,861347,37000
300152581200,30-015-25812,HARKEY 35 STATE 001,2006-01-01,130,112,3432,31,35907,864779,37031
300152581200,30-015-25812,HARKEY 35 STATE 001,2006-02-01,131,163,3405,37,36070,868184,37068
300152581200,30-015-25812,HARKEY 35 STATE 001,2006-03-01,132,147,2439,9,36217,870623,37077
300152581200,30-015-25812,HARKEY 35 STATE 001,2006-04-01,133,107,2331,58,36324,872954,37135
300152581200,30-015-25812,HARKEY 35 STATE 001,2006-05-01,134,59,2605,69,36383,875559,37204
300152581200,30-015-25812,HARKEY 35 STATE 001,2006-06-01,135,185,2451,70,36568,878010,37274
300152581200,30-015-25812,HARKEY 35 STATE 001,2006-07-01,136,40,2643,60,36608,880653,37334
300152581200,30-015-25812,HARKEY 35 STATE 001,2006-08-01,137,150,3040,62,36758,883693,37396
300152581200,30-015-25812,HARKEY 35 STATE 001,2006-09-01,138,137,3741,60,36895,887434,37456
300152581200,30-015-25812,HARKEY 35 STATE 001,2006-10-01,139,32,3912,62,36927,891346,37518
300152581200,30-015-25812,HARKEY 35 STATE 001,2006-11-01,140,200,3561,60,37127,894907,37578
300152581200,30-015-25812,HARKEY 35 STATE 001,2006-12-01,141,57,3367,62,37184,898274,37640
300152581200,30-015-25812,HARKEY 35 STATE 001,2007-01-01,142,193,3239,62,37377,901513,37702
300152581200,30-015-25812,HARKEY 35 STATE 001,2007-02-01,143,202,3994,56,37579,905507,37758
300152581200,30-015-25812,HARKEY 35 STATE 001,2007-03-01,144,107,6159,62,37686,911666,37820
300152581200,30-015-25812,HARKEY 35 STATE 001,2007-04-01,145,0,2032,54,37686,913698,37874
300152581200,30-015-25812,HARKEY 35 STATE 001,2007-05-01,146,0,17,2,37686,913715,37876
300152581200,30-015-25812,HARKEY 35 STATE 001,2007-06-01,147,0,894,56,37686,914609,37932
300152581200,30-015-25812,HARKEY 35 STATE 001,2007-07-01,148,73,1433,28,37759,916042,37960
300152581200,30-015-25812,HARKEY 35 STATE 001,2007-08-01,149,8,87,61,37767,916129,38021
300152581200,30-015-25812,HARKEY 35 STATE 001,2007-09-01,150,0,32,0,37767,916161,38021
300152581200,30-015-25812,HARKEY 35 STATE 001,2007-10-01,151,0,0,0,37767,916161,38021
300152581200,30-015-25812,HARKEY 35 STATE 001,2007-11-01,152,42,2651,60,37809,918812,38081
300152581200,30-015-25812,HARKEY 35 STATE 001,2007-12-01,153,87,2051,57,37896,920863,38138
300152581200,30-015-25812,HARKEY 35 STATE 001,2008-01-01,154,8,1911,95,37904,922774,38233
300152581200,30-015-25812,HARKEY 35 STATE 001,2008-02-01,155,10,1755,60,37914,924529,38293
300152581200,30-015-25812,HARKEY 35 STATE 001,2008-03-01,156,44,1401,42,37958,925930,38335
300152581200,30-015-25812,HARKEY 35 STATE 001,2008-04-01,157,16,1756,73,37974,927686,38408
300152581200,30-015-25812,HARKEY 35 STATE 001,2008-05-01,158,0,2151,57,37974,929837,38465
300152581200,30-015-25812,HARKEY 35 STATE 001,2008-06-01,159,0,2064,81,37974,931901,38546
300152581200,30-015-25812,HARKEY 35 STATE 001,2008-07-01,160,49,2310,150,38023,934211,38696
300152581200,30-015-25812,HARKEY 35 STATE 001,2008-08-01,161,34,2363,25,38057,936574,38721
300152581200,30-015-25812,HARKEY 35 STATE 001,2008-09-01,162,14,2049,0,38071,938623,38721
300152581200,30-015-25812,HARKEY 35 STATE 001,2008-10-01,163,0,1802,0,38071,940425,38721
300152581200,30-015-25812,HARKEY 35 STATE 001,2008-11-01,164,24,1876,0,38095,942301,38721
300152581200,30-015-25812,HARKEY 35 STATE 001,2008-12-01,165,4,1756,0,38099,944057,38721
300152581200,30-015-25812,HARKEY 35 STATE 001,2009-01-01,166,14,2044,108,38113,946101,38829
300152581200,30-015-25812,HARKEY 35 STATE 001,2009-02-01,167,21,1596,54,38134,947697,38883
300152581200,30-015-25812,HARKEY 35 STATE 001,2009-03-01,168,0,2096,57,38134,949793,38940
300152581200,30-015-25812,HARKEY 35 STATE 001,2009-04-01,169,7,1741,0,38141,951534,38940
300152581200,30-015-25812,HARKEY 35 STATE 001,2009-05-01,170,14,1545,0,38155,953079,38940
300152581200,30-015-25812,HARKEY 35 STATE 001,2009-06-01,171,31,1602,61,38186,954681,39001
300152581200,30-015-25812,HARKEY 35 STATE 001,2009-07-01,172,12,1987,49,38198,956668,39050
300152581200,30-015-25812,HARKEY 35 STATE 001,2009-08-01,173,83,1829,30,38281,958497,39080
300152581200,30-015-25812,HARKEY 35 STATE 001,2009-09-01,174,85,1429,84,38366,959926,39164
300152581200,30-015-25812,HARKEY 35 STATE 001,2009-10-01,175,57,1473,45,38423,961399,39209
300152581200,30-015-25812,HARKEY 35 STATE 001,2009-11-01,176,18,1027,39,38441,962426,39248
300152581200,30-015-25812,HARKEY 35 STATE 001,2009-12-01,177,42,876,66,38483,963302,39314
300152581200,30-015-25812,HARKEY 35 STATE 001,2010-01-01,178,89,783,64,38572,964085,39378
300152581200,30-015-25812,HARKEY 35 STATE 001,2010-02-01,179,63,733,75,38635,964818,39453
300152581200,30-015-25812,HARKEY 35 STATE 001,2010-03-01,180,42,194,3,38677,965012,39456
300152581200,30-015-25812,HARKEY 35 STATE 001,2010-04-01,181,0,461,5,38677,965473,39461
300152581200,30-015-25812,HARKEY 35 STATE 001,2010-05-01,182,15,497,56,38692,965970,39517
300152581200,30-015-25812,HARKEY 35 STATE 001,2010-06-01,183,14,96,0,38706,966066,39517
300152581200,30-015-25812,HARKEY 35 STATE 001,2010-07-01,184,2,25,0,38708,966091,39517
300152581200,30-015-25812,HARKEY 35 STATE 001,2010-08-01,185,0,17,0,38708,966108,39517
300152581200,30-015-25812,HARKEY 35 STATE 001,2010-09-01,186,30,129,69,38738,966237,39586
300152581200,30-015-25812,HARKEY 35 STATE 001,2010-10-01,187,6,1270,100,38744,967507,39686
300152581200,30-015-25812,HARKEY 35 STATE 001,2010-11-01,188,0,618,64,38744,968125,39750
300152581200,30-015-25812,HARKEY 35 STATE 001,2010-12-01,189,0,13,0,38744,968138,39750
300152581200,30-015-25812,HARKEY 35 STATE 001,2011-01-01,190,3,77,6,38747,968215,39756
300152581200,30-015-25812,HARKEY 35 STATE 001,2011-02-01,191,2,1027,21,38749,969242,39777
300152581200,30-015-25812,HARKEY 35 STATE 001,2011-03-01,192,0,49,0,38749,969291,39777
300152581200,30-015-25812,HARKEY 35 STATE 001,2011-04-01,193,0,16,0,38749,969307,39777
300152581200,30-015-25812,HARKEY 35 STATE 001,2011-05-01,194,181,913,145,38930,970220,39922
300152581200,30-015-25812,HARKEY 35 STATE 001,2011-06-01,195,85,308,70,39015,970528,39992
300152581200,30-015-25812,HARKEY 35 STATE 001,2011-07-01,196,156,411,0,39171,970939,39992
300152581200,30-015-25812,HARKEY 35 STATE 001,2011-08-01,197,0,407,0,39171,971346,39992
300152581200,30-015-25812,HARKEY 35 STATE 001,2011-09-01,198,42,372,121,39213,971718,40113
300152581200,30-015-25812,HARKEY 35 STATE 001,2011-10-01,199,84,411,132,39297,972129,40245
300152581200,30-015-25812,HARKEY 35 STATE 001,2011-11-01,200,49,566,0,39346,972695,40245
300152581200,30-015-25812,HARKEY 35 STATE 001,2011-12-01,201,31,56,0,39377,972751,40245
300152581200,30-015-25812,HARKEY 35 STATE 001,2012-01-01,202,58,667,33,39435,973418,40278
300152581200,30-015-25812,HARKEY 35 STATE 001,2012-02-01,203,70,275,0,39505,973693,40278
300152581200,30-015-25812,HARKEY 35 STATE 001,2012-03-01,204,13,320,0,39518,974013,40278
300152581200,30-015-25812,HARKEY 35 STATE 001,2012-04-01,205,10,321,66,39528,974334,40344
300152581200,30-015-25812,HARKEY 35 STATE 001,2012-05-01,206,41,427,6,39569,974761,40350
300152581200,30-015-25812,HARKEY 35 STATE 001,2012-06-01,207,35,345,10,39604,975106,40360
300152581200,30-015-25812,HARKEY 35 STATE 001,2012-07-01,208,40,342,24,39644,975448,40384
300152581200,30-015-25812,HARKEY 35 STATE 001,2012-08-01,209,42,38,25,39686,975486,40409
300152581200,30-015-25812,HARKEY 35 STATE 001,2012-09-01,210,24,503,132,39710,975989,40541
300152581200,30-015-25812,HARKEY 35 STATE 001,2012-10-01,211,9,38,0,39719,976027,40541
300152581200,30-015-25812,HARKEY 35 STATE 001,2012-11-01,212,0,4,10,39719,976031,40551
300152581200,30-015-25812,HARKEY 35 STATE 001,2012-12-01,213,17,1658,45,39736,977689,40596
300152581200,30-015-25812,HARKEY 35 STATE 001,2013-01-01,214,2,246,33,39738,977935,40629
300152581200,30-015-25812,HARKEY 35 STATE 001,2013-02-01,215,0,207,0,39738,978142,40629
300152581200,30-015-25812,HARKEY 35 STATE 001,2013-03-01,216,27,755,3,39765,978897,40632
300152581200,30-015-25812,HARKEY 35 STATE 001,2013-04-01,217,133,104,487,39898,979001,41119
300152581200,30-015-25812,HARKEY 35 STATE 001,2013-05-01,218,48,790,132,39946,979791,41251
300152581200,30-015-25812,HARKEY 35 STATE 001,2013-06-01,219,6,30,0,39952,979821,41251
300152581200,30-015-25812,HARKEY 35 STATE 001,2013-07-01,220,27,294,278,39979,980115,41529
300152581200,30-015-25812,HARKEY 35 STATE 001,2013-08-01,221,37,1410,87,40016,981525,41616
300152581200,30-015-25812,HARKEY 35 STATE 001,2013-09-01,222,204,3004,830,40220,984529,42446
300152581200,30-015-25812,HARKEY 35 STATE 001,2013-10-01,223,232,2842,775,40452,987371,43221
300152581200,30-015-25812,HARKEY 35 STATE 001,2013-11-01,224,116,2340,422,40568,989711,43643
300152581200,30-015-25812,HARKEY 35 STATE 001,2013-12-01,225,82,1656,244,40650,991367,43887
300152581200,30-015-25812,HARKEY 35 STATE 001,2014-01-01,226,225,2202,878,40875,993569,44765
300152581200,30-015-25812,HARKEY 35 STATE 001,2014-02-01,227,143,1581,697,41018,995150,45462
300152581200,30-015-25812,HARKEY 35 STATE 001,2014-03-01,228,90,2050,346,41108,997200,45808
300152581200,30-015-25812,HARKEY 35 STATE 001,2014-04-01,229,64,2261,114,41172,999461,45922
300152581200,30-015-25812,HARKEY 35 STATE 001,2014-05-01,230,159,2095,127,41331,1001556,46049
300152581200,30-015-25812,HARKEY 35 STATE 001,2014-06-01,231,46,1083,129,41377,1002639,46178
300152581200,30-015-25812,HARKEY 35 STATE 001,2014-07-01,232,139,2248,151,41516,1004887,46329
300152581200,30-015-25812,HARKEY 35 STATE 001,2014-08-01,233,90,2178,103,41606,1007065,46432
300152581200,30-015-25812,HARKEY 35 STATE 001,2014-09-01,234,79,2033,87,41685,1009098,46519
300152581200,30-015-25812,HARKEY 35 STATE 001,2014-10-01,235,134,1749,117,41819,1010847,46636
300152581200,30-015-25812,HARKEY 35 STATE 001,2014-11-01,236,120,2050,183,41939,1012897,46819
300152581200,30-015-25812,HARKEY 35 STATE 001,2014-12-01,237,96,1501,421,42035,1014398,47240
300152581200,30-015-25812,HARKEY 35 STATE 001,2015-01-01,238,7,1452,28,42042,1015850,47268
300152581200,30-015-25812,HARKEY 35 STATE 001,2015-02-01,239,0,508,0,42042,1016358,47268
300152581200,30-015-25812,HARKEY 35 STATE 001,2015-03-01,240,12,410,15,42054,1016768,47283
300152581200,30-015-25812,HARKEY 35 STATE 001,2015-04-01,241,104,320,124,42158,1017088,47407
300152581200,30-015-25812,HARKEY 35 STATE 001,2015-05-01,242,0,949,39,42158,1018037,47446
300152581200,30-015-25812,HARKEY 35 STATE 001,2015-06-01,243,16,20,20,42174,1018057,47466
300152581200,30-015-25812,HARKEY 35 STATE 001,2015-07-01,244,16,20,25,42190,1018077,47491
300152581200,30-015-25812,HARKEY 35 STATE 001,2015-08-01,245,0,161,30,42190,1018238,47521
300152581200,30-015-25812,HARKEY 35 STATE 001,2015-09-01,246,74,12,24,42264,1018250,47545
300152581200,30-015-25812,HARKEY 35 STATE 001,2015-10-01,247,12,20,35,42276,1018270,47580
300152581200,30-015-25812,HARKEY 35 STATE 001,2015-11-01,248,25,26,174,42301,1018296,47754
300152581200,30-015-25812,HARKEY 35 STATE 001,2015-12-01,249,0,57,4,42301,1018353,47758
300152581200,30-015-25812,HARKEY 35 STATE 001,2016-01-01,250,0,28,0,42301,1018381,47758
300152581200,30-015-25812,HARKEY 35 STATE 001,2016-02-01,251,28,14,52,42329,1018395,47810
300152581200,30-015-25812,HARKEY 35 STATE 001,2016-03-01,252,513,920,424,42842,1019315,48234
300152581200,30-015-25812,HARKEY 35 STATE 001,2016-04-01,253,259,1803,15,43101,1021118,48249
300152581200,30-015-25812,HARKEY 35 STATE 001,2016-05-01,254,167,1024,97,43268,1022142,48346
300152581200,30-015-25812,HARKEY 35 STATE 001,2016-06-01,255,107,510,32,43375,1022652,48378
300152581200,30-015-25812,HARKEY 35 STATE 001,2016-07-01,256,119,473,34,43494,1023125,48412
300152581200,30-015-25812,HARKEY 35 STATE 001,2016-08-01,257,57,825,19,43551,1023950,48431
300152581200,30-015-25812,HARKEY 35 STATE 001,2016-09-01,258,98,1683,42,43649,1025633,48473
300152581200,30-015-25812,HARKEY 35 STATE 001,2016-10-01,259,31,1685,2,43680,1027318,48475
300152581200,30-015-25812,HARKEY 35 STATE 001,2016-11-01,260,0,1557,0,43680,1028875,48475
300152581200,30-015-25812,HARKEY 35 STATE 001,2016-12-01,261,0,1400,0,43680,1030275,48475
300152581200,30-015-25812,HARKEY 35 STATE 001,2017-01-01,262,0,1082,0,43680,1031357,48475
300152581200,30-015-25812,HARKEY 35 STATE 001,2017-02-01,263,0,1006,0,43680,1032363,48475
300152581200,30-015-25812,HARKEY 35 STATE 001,2017-03-01,264,0,1008,0,43680,1033371,48475
300152581200,30-015-25812,HARKEY 35 STATE 001,2017-04-01,265,0,808,0,43680,1034179,48475
300152581200,30-015-25812,HARKEY 35 STATE 001,2017-05-01,266,0,653,0,43680,1034832,48475
300152581200,30-015-25812,HARKEY 35 STATE 001,2017-06-01,267,0,296,0,43680,1035128,48475
300152581200,30-015-25812,HARKEY 35 STATE 001,2017-07-01,268,0,558,0,43680,1035686,48475
300152581200,30-015-25812,HARKEY 35 STATE 001,2017-08-01,269,0,607,0,43680,1036293,48475
300152581200,30-015-25812,HARKEY 35 STATE 001,2017-09-01,270,0,563,0,43680,1036856,48475
300152581200,30-015-25812,HARKEY 35 STATE 001,2017-10-01,271,0,571,0,43680,1037427,48475
300152581200,30-015-25812,HARKEY 35 STATE 001,2017-11-01,272,0,709,0,43680,1038136,48475
300152581200,30-015-25812,HARKEY 35 STATE 001,2017-12-01,273,0,738,0,43680,1038874,48475
300152581200,30-015-25812,HARKEY 35 STATE 001,2018-01-01,274,0,699,0,43680,1039573,48475
300152581200,30-015-25812,HARKEY 35 STATE 001,2018-02-01,275,0,612,0,43680,1040185,48475
300152581200,30-015-25812,HARKEY 35 STATE 001,2018-03-01,276,0,661,0,43680,1040846,48475
300152581200,30-015-25812,HARKEY 35 STATE 001,2018-04-01,277,0,559,0,43680,1041405,48475
300152581200,30-015-25812,HARKEY 35 STATE 001,2018-05-01,278,0,351,0,43680,1041756,48475
300152581200,30-015-25812,HARKEY 35 STATE 001,2018-06-01,279,72,294,122,43752,1042050,48597
300152581200,30-015-25812,HARKEY 35 STATE 001,2018-07-01,280,127,99,60,43879,1042149,48657
300152581200,30-015-25812,HARKEY 35 STATE 001,2018-08-01,281,0,775,15,43879,1042924,48672
300152581200,30-015-25812,HARKEY 35 STATE 001,2018-09-01,282,0,145,0,43879,1043069,48672
300152581200,30-015-25812,HARKEY 35 STATE 001,2018-10-01,283,0,249,0,43879,1043318,48672
300152581200,30-015-25812,HARKEY 35 STATE 001,2018-11-01,284,0,435,0,43879,1043753,48672
300152581200,30-015-25812,HARKEY 35 STATE 001,2018-12-01,285,0,423,0,43879,1044176,48672
300152581200,30-015-25812,HARKEY 35 STATE 001,2019-01-01,286,0,411,0,43879,1044587,48672
300152581200,30-015-25812,HARKEY 35 STATE 001,2019-02-01,287,0,380,0,43879,1044967,48672
300152581200,30-015-25812,HARKEY 35 STATE 001,2019-03-01,288,0,445,0,43879,1045412,48672
300152581200,30-015-25812,HARKEY 35 STATE 001,2019-04-01,289,0,437,0,43879,1045849,48672
300152581200,30-015-25812,HARKEY 35 STATE 001,2019-05-01,290,0,272,0,43879,1046121,48672
300152581200,30-015-25812,HARKEY 35 STATE 001,2019-06-01,291,0,407,0,43879,1046528,48672
300152581200,30-015-25812,HARKEY 35 STATE 001,2019-07-01,292,0,283,0,43879,1046811,48672
300152581200,30-015-25812,HARKEY 35 STATE 001,2019-08-01,293,0,271,0,43879,1047082,48672
300152581200,30-015-25812,HARKEY 35 STATE 001,2019-09-01,294,0,302,0,43879,1047384,48672
300152581200,30-015-25812,HARKEY 35 STATE 001,2019-10-01,295,0,331,0,43879,1047715,48672
300152581200,30-015-25812,HARKEY 35 STATE 001,2019-11-01,296,0,343,0,43879,1048058,48672
300152581200,30-015-25812,HARKEY 35 STATE 001,2019-12-01,297,0,435,15,43879,1048493,48687
300152581200,30-015-25812,HARKEY 35 STATE 001,2020-01-01,298,0,604,66,43879,1049097,48753
300152581200,30-015-25812,HARKEY 35 STATE 001,2020-02-01,299,0,687,90,43879,1049784,48843
300152581200,30-015-25812,HARKEY 35 STATE 001,2020-03-01,300,0,512,114,43879,1050296,48957
300152581200,30-015-25812,HARKEY 35 STATE 001,2020-04-01,301,0,167,15,43879,1050463,48972
300152581200,30-015-25812,HARKEY 35 STATE 001,2020-05-01,302,0,0,0,43879,1050463,48972
300152581200,30-015-25812,HARKEY 35 STATE 001,2020-06-01,303,0,0,0,43879,1050463,48972
300152581200,30-015-25812,HARKEY 35 STATE 001,2020-07-01,304,0,0,0,43879,1050463,48972
300152581200,30-015-25812,HARKEY 35 STATE 001,2020-08-01,305,0,0,0,43879,1050463,48972
300152581200,30-015-25812,HARKEY 35 STATE 001,2020-09-01,306,0,0,0,43879,1050463,48972
300152581200,30-015-25812,HARKEY 35 STATE 001,2020-10-01,307,0,0,0,43879,1050463,48972
300152581200,30-015-25812,HARKEY 35 STATE 001,2020-11-01,308,0,0,0,43879,1050463,48972
300152581200,30-015-25812,HARKEY 35 STATE 001,2020-12-01,309,0,0,0,43879,1050463,48972
300152581200,30-015-25812,HARKEY 35 STATE 001,2021-01-01,310,0,0,0,43879,1050463,48972
300152581200,30-015-25812,HARKEY 35 STATE 001,2021-02-01,311,2,0,30,43881,1050463,49002
300152581200,30-015-25812,HARKEY 35 STATE 001,2021-03-01,312,104,1162,7,43985,1051625,49009
300152581200,30-015-25812,HARKEY 35 STATE 001,2021-04-01,313,0,928,0,43985,1052553,49009
300152581200,30-015-25812,HARKEY 35 STATE 001,2021-05-01,314,0,731,0,43985,1053284,49009
300152581200,30-015-25812,HARKEY 35 STATE 001,2021-06-01,315,0,379,0,43985,1053663,49009
300152581200,30-015-25812,HARKEY 35 STATE 001,2021-07-01,316,0,352,0,43985,1054015,49009
300152581200,30-015-25812,HARKEY 35 STATE 001,2021-08-01,317,0,333,0,43985,1054348,49009
300152581200,30-015-25812,HARKEY 35 STATE 001,2021-09-01,318,0,450,0,43985,1054798,49009
300152581200,30-015-25812,HARKEY 35 STATE 001,2021-10-01,319,0,449,0,43985,1055247,49009
300152581200,30-015-25812,HARKEY 35 STATE 001,2021-11-01,320,0,780,0,43985,1056027,49009
300152581200,30-015-25812,HARKEY 35 STATE 001,2021-12-01,321,0,709,0,43985,1056736,49009
300152581200,30-015-25812,HARKEY 35 STATE 001,2022-01-01,322,0,502,0,43985,1057238,49009
300152581200,30-015-25812,HARKEY 35 STATE 001,2022-02-01,323,0,601,0,43985,1057839,49009
300152581200,30-015-25812,HARKEY 35 STATE 001,2022-03-01,324,0,655,0,43985,1058494,49009
300152581200,30-015-25812,HARKEY 35 STATE 001,2022-04-01,325,16,466,0,44001,1058960,49009
300152581200,30-015-25812,HARKEY 35 STATE 001,2022-05-01,326,0,368,0,44001,1059328,49009
300152581200,30-015-25812,HARKEY 35 STATE 001,2022-06-01,327,0,11,0,44001,1059339,49009
300152581200,30-015-25812,HARKEY 35 STATE 001,2022-07-01,328,0,9,0,44001,1059348,49009
300152581200,30-015-25812,HARKEY 35 STATE 001,2022-08-01,329,0,11,0,44001,1059359,49009
300152581200,30-015-25812,HARKEY 35 STATE 001,2022-09-01,330,0,19,0,44001,1059378,49009
300152581200,30-015-25812,HARKEY 35 STATE 001,2022-10-01,331,0,5,0,44001,1059383,49009
300152581200,30-015-25812,HARKEY 35 STATE 001,2022-11-01,332,0,2,0,44001,1059385,49009
300152581200,30-015-25812,HARKEY 35 STATE 001,2022-12-01,333,0,2,0,44001,1059387,49009
300152581200,30-015-25812,HARKEY 35 STATE 001,2023-01-01,334,0,6,0,44001,1059393,49009
300152581200,30-015-25812,HARKEY 35 STATE 001,2023-02-01,335,0,9,0,44001,1059402,49009
300152581200,30-015-25812,HARKEY 35 STATE 001,2023-03-01,336,0,6,0,44001,1059408,49009
300152581200,30-015-25812,HARKEY 35 STATE 001,2023-04-01,337,0,8,0,44001,1059416,49009
300152581200,30-015-25812,HARKEY 35 STATE 001,2023-05-01,338,0,5,0,44001,1059421,49009
300152581200,30-015-25812,HARKEY 35 STATE 001,2023-06-01,339,0,13,0,44001,1059434,49009
300152581200,30-015-25812,HARKEY 35 STATE 001,2023-07-01,340,0,5,0,44001,1059439,49009
300154612800,30-015-46128,QUIEN SABE FEDERAL COM 603H,2020-02-01,1,20713,41352,90988,20713,41352,90988
300154612800,30-015-46128,QUIEN SABE FEDERAL COM 603H,2020-03-01,2,44800,95078,145133,65513,136430,236121
300154612800,30-015-46128,QUIEN SABE FEDERAL COM 603H,2020-04-01,3,37316,79898,124928,102829,216328,361049
300154612800,30-015-46128,QUIEN SABE FEDERAL COM 603H,2020-05-01,4,30299,66996,108150,133128,283324,469199
300154612800,30-015-46128,QUIEN SABE FEDERAL COM 603H,2020-06-01,5,21779,48516,78137,154907,331840,547336
300154612800,30-015-46128,QUIEN SABE FEDERAL COM 603H,2020-07-01,6,21216,54949,81448,176123,386789,628784
300154612800,30-015-46128,QUIEN SABE FEDERAL COM 603H,2020-08-01,7,17279,47623,71033,193402,434412,699817
300154612800,30-015-46128,QUIEN SABE FEDERAL COM 603H,2020-09-01,8,13992,42028,58953,207394,476440,758770
300154612800,30-015-46128,QUIEN SABE FEDERAL COM 603H,2020-10-01,9,11694,39048,56775,219088,515488,815545
300154612800,30-015-46128,QUIEN SABE FEDERAL COM 603H,2020-11-01,10,12222,39089,54660,231310,554577,870205
300154612800,30-015-46128,QUIEN SABE FEDERAL COM 603H,2020-12-01,11,9107,28928,44827,240417,583505,915032
300154612800,30-015-46128,QUIEN SABE FEDERAL COM 603H,2021-01-01,12,11142,34454,51263,251559,617959,966295
300154612800,30-015-46128,QUIEN SABE FEDERAL COM 603H,2021-02-01,13,7172,24341,40750,258731,642300,1007045
300154612800,30-015-46128,QUIEN SABE FEDERAL COM 603H,2021-03-01,14,10051,36344,50502,268782,678644,1057547
300154612800,30-015-46128,QUIEN SABE FEDERAL COM 603H,2021-04-01,15,9422,33605,43350,278204,712249,1100897
300154612800,30-015-46128,QUIEN SABE FEDERAL COM 603H,2021-05-01,16,9472,31726,45708,287676,743975,1146605
300154612800,30-015-46128,QUIEN SABE FEDERAL COM 603H,2021-06-01,17,6993,31034,37077,294669,775009,1183682
300154612800,30-015-46128,QUIEN SABE FEDERAL COM 603H,2021-07-01,18,8214,29989,41610,302883,804998,1225292
300154612800,30-015-46128,QUIEN SABE FEDERAL COM 603H,2021-08-01,19,8969,30502,40526,311852,835500,1265818
300154612800,30-015-46128,QUIEN SABE FEDERAL COM 603H,2021-09-01,20,8408,29605,37994,320260,865105,1303812
300154612800,30-015-46128,QUIEN SABE FEDERAL COM 603H,2021-10-01,21,7204,20758,28870,327464,885863,1332682
300154612800,30-015-46128,QUIEN SABE FEDERAL COM 603H,2021-11-01,22,7299,22682,32057,334763,908545,1364739
300154612800,30-015-46128,QUIEN SABE FEDERAL COM 603H,2021-12-01,23,7525,25412,33359,342288,933957,1398098
300154612800,30-015-46128,QUIEN SABE FEDERAL COM 603H,2022-01-01,24,6514,22399,27720,348802,956356,1425818
300154612800,30-015-46128,QUIEN SABE FEDERAL COM 603H,2022-02-01,25,5991,15933,21542,354793,972289,1447360
300154612800,30-015-46128,QUIEN SABE FEDERAL COM 603H,2022-03-01,26,3143,11192,9295,357936,983481,1456655
300154612800,30-015-46128,QUIEN SABE FEDERAL COM 603H,2022-04-01,27,5997,12431,19103,363933,995912,1475758
300154612800,30-015-46128,QUIEN SABE FEDERAL COM 603H,2022-05-01,28,6548,17944,24933,370481,1013856,1500691
300154612800,30-015-46128,QUIEN SABE FEDERAL COM 603H,2022-06-01,29,4113,9794,13156,374594,1023650,1513847
300154612800,30-015-46128,QUIEN SABE FEDERAL COM 603H,2022-07-01,30,9039,13938,20289,383633,1037588,1534136
300154612800,30-015-46128,QUIEN SABE FEDERAL COM 603H,2022-08-01,31,10078,21964,31724,393711,1059552,1565860
300154612800,30-015-46128,QUIEN SABE FEDERAL COM 603H,2022-09-01,32,8582,23628,31628,402293,1083180,1597488
300154612800,30-015-46128,QUIEN SABE FEDERAL COM 603H,2022-10-01,33,7454,24339,29930,409747,1107519,1627418
300154612800,30-015-46128,QUIEN SABE FEDERAL COM 603H,2022-11-01,34,4638,15717,20187,414385,1123236,1647605
300154612800,30-015-46128,QUIEN SABE FEDERAL COM 603H,2022-12-01,35,4842,14242,15304,419227,1137478,1662909
300154612800,30-015-46128,QUIEN SABE FEDERAL COM 603H,2023-01-01,36,5708,18059,20518,424935,1155537,1683427
300154612800,30-015-46128,QUIEN SABE FEDERAL COM 603H,2023-02-01,37,5057,19856,21672,429992,1175393,1705099
300154612800,30-015-46128,QUIEN SABE FEDERAL COM 603H,2023-03-01,38,5156,23127,27031,435148,1198520,1732130
300154612800,30-015-46128,QUIEN SABE FEDERAL COM 603H,2023-04-01,39,1489,2793,7016,436637,1201313,1739146
300154612800,30-015-46128,QUIEN SABE FEDERAL COM 603H,2023-05-01,40,4074,12906,34404,440711,1214219,1773550
300154612800,30-015-46128,QUIEN SABE FEDERAL COM 603H,2023-06-01,41,8588,17605,43998,449299,1231824,1817548
300154612800,30-015-46128,QUIEN SABE FEDERAL COM 603H,2023-07-01,42,1175,7372,30488,450474,1239196,1848036
300152710000,30-015-27100,BR 15 STATE 001,1995-01-01,1,255,0,0,255,0,0
300152710000,30-015-27100,BR 15 STATE 001,1995-02-01,2,0,0,0,255,0,0
300152710000,30-015-27100,BR 15 STATE 001,1995-03-01,3,635,0,0,890,0,0
300152710000,30-015-27100,BR 15 STATE 001,1995-04-01,4,371,0,0,1261,0,0
300152710000,30-015-27100,BR 15 STATE 001,1995-05-01,5,173,0,0,1434,0,0
300152710000,30-015-27100,BR 15 STATE 001,1995-06-01,6,0,0,0,1434,0,0
300152710000,30-015-27100,BR 15 STATE 001,1995-07-01,7,0,0,0,1434,0,0
300152710000,30-015-27100,BR 15 STATE 001,1995-08-01,8,0,0,0,1434,0,0
300152710000,30-015-27100,BR 15 STATE 001,1995-09-01,9,0,0,0,1434,0,0
300152710000,30-015-27100,BR 15 STATE 001,1995-10-01,10,0,0,0,1434,0,0
300152710000,30-015-27100,BR 15 STATE 001,1995-11-01,11,0,0,0,1434,0,0
300152710000,30-015-27100,BR 15 STATE 001,1995-12-01,12,0,0,0,1434,0,0
300152710000,30-015-27100,BR 15 STATE 001,1996-01-01,13,0,0,0,1434,0,0
300152710000,30-015-27100,BR 15 STATE 001,1996-02-01,14,0,0,0,1434,0,0
300152710000,30-015-27100,BR 15 STATE 001,1996-03-01,15,0,0,0,1434,0,0
300152710000,30-015-27100,BR 15 STATE 001,1996-04-01,16,0,0,0,1434,0,0
300152710000,30-015-27100,BR 15 STATE 001,1996-05-01,17,0,0,0,1434,0,0
300152710000,30-015-27100,BR 15 STATE 001,1996-06-01,18,0,0,0,1434,0,0
300152235200,30-015-22352,RED BLUFF STATE 001,1992-06-01,1,343,0,0,343,0,0
300152235200,30-015-22352,RED BLUFF STATE 001,1992-07-01,2,42,0,26,385,0,26
300152235200,30-015-22352,RED BLUFF STATE 001,1992-08-01,3,175,0,774,560,0,800
300152235200,30-015-22352,RED BLUFF STATE 001,1992-09-01,4,84,0,768,644,0,1568
300152235200,30-015-22352,RED BLUFF STATE 001,1992-10-01,5,86,0,693,730,0,2261
300152235200,30-015-22352,RED BLUFF STATE 001,1992-11-01,6,76,0,649,806,0,2910
300152235200,30-015-22352,RED BLUFF STATE 001,1992-12-01,7,77,0,672,883,0,3582
300152235200,30-015-22352,RED BLUFF STATE 001,1993-01-01,8,67,0,583,950,0,4165
300152235200,30-015-22352,RED BLUFF STATE 001,1993-02-01,9,67,0,609,1017,0,4774
300152235200,30-015-22352,RED BLUFF STATE 001,1993-03-01,10,64,0,542,1081,0,5316
300152235200,30-015-22352,RED BLUFF STATE 001,1993-04-01,11,65,0,509,1146,0,5825
300152235200,30-015-22352,RED BLUFF STATE 001,1993-05-01,12,66,0,511,1212,0,6336
300152235200,30-015-22352,RED BLUFF STATE 001,1993-06-01,13,54,0,438,1266,0,6774
300152235200,30-015-22352,RED BLUFF STATE 001,1993-07-01,14,60,0,515,1326,0,7289
300152235200,30-015-22352,RED BLUFF STATE 001,1993-08-01,15,59,0,426,1385,0,7715
300152235200,30-015-22352,RED BLUFF STATE 001,1993-09-01,16,48,0,501,1433,0,8216
300152235200,30-015-22352,RED BLUFF STATE 001,1993-10-01,17,59,0,622,1492,0,8838
300152235200,30-015-22352,RED BLUFF STATE 001,1993-11-01,18,57,0,434,1549,0,9272
300152235200,30-015-22352,RED BLUFF STATE 001,1993-12-01,19,15,0,95,1564,0,9367
300152235200,30-015-22352,RED BLUFF STATE 001,1994-01-01,20,0,0,0,1564,0,9367
300152235200,30-015-22352,RED BLUFF STATE 001,1994-02-01,21,0,0,0,1564,0,9367
300152235200,30-015-22352,RED BLUFF STATE 001,1994-03-01,22,0,0,0,1564,0,9367
300152235200,30-015-22352,RED BLUFF STATE 001,1994-04-01,23,0,0,0,1564,0,9367
300152235200,30-015-22352,RED BLUFF STATE 001,1994-05-01,24,0,0,0,1564,0,9367
300152235200,30-015-22352,RED BLUFF STATE 001,1994-06-01,25,0,0,0,1564,0,9367
300152235200,30-015-22352,RED BLUFF STATE 001,1994-07-01,26,77,0,537,1641,0,9904
300152235200,30-015-22352,RED BLUFF STATE 001,1994-08-01,27,0,0,0,1641,0,9904
300152235200,30-015-22352,RED BLUFF STATE 001,1994-09-01,28,68,0,651,1709,0,10555
300152235200,30-015-22352,RED BLUFF STATE 001,1994-10-01,29,52,0,461,1761,0,11016
300152235200,30-015-22352,RED BLUFF STATE 001,1994-11-01,30,14,0,0,1775,0,11016
300152235200,30-015-22352,RED BLUFF STATE 001,1994-12-01,31,15,0,367,1790,0,11383
300152235200,30-015-22352,RED BLUFF STATE 001,1995-01-01,32,44,0,344,1834,0,11727
300152710001,30-015-27100,BR 15 STATE 001,1996-10-01,1,150,0,0,1584,0,0
300152710001,30-015-27100,BR 15 STATE 001,1996-11-01,2,45,0,0,1629,0,0
300152710001,30-015-27100,BR 15 STATE 001,1996-12-01,3,35,0,0,1664,0,0
300152710001,30-015-27100,BR 15 STATE 001,1997-01-01,4,20,0,2496,1684,0,2496
300152710001,30-015-27100,BR 15 STATE 001,1997-02-01,5,0,0,0,1684,0,2496
300152710001,30-015-27100,BR 15 STATE 001,1997-03-01,6,53,0,5739,1737,0,8235
300152710001,30-015-27100,BR 15 STATE 001,1997-04-01,7,93,0,4017,1830,0,12252
300152710001,30-015-27100,BR 15 STATE 001,1997-05-01,8,30,0,6472,1860,0,18724
300152710001,30-015-27100,BR 15 STATE 001,1997-06-01,9,108,0,3353,1968,0,22077
300152710001,30-015-27100,BR 15 STATE 001,1997-07-01,10,29,0,2829,1997,0,24906
300152710001,30-015-27100,BR 15 STATE 001,1997-08-01,11,38,0,1217,2035,0,26123
300152710001,30-015-27100,BR 15 STATE 001,1997-09-01,12,0,0,0,2035,0,26123
300152710001,30-015-27100,BR 15 STATE 001,1997-10-01,13,21,0,3189,2056,0,29312
300152710001,30-015-27100,BR 15 STATE 001,1997-11-01,14,17,0,1386,2073,0,30698
300152710001,30-015-27100,BR 15 STATE 001,1997-12-01,15,7,0,581,2080,0,31279
300152710001,30-015-27100,BR 15 STATE 001,1998-01-01,16,51,0,1418,2131,0,32697
300152710001,30-015-27100,BR 15 STATE 001,1998-02-01,17,82,0,2556,2213,0,35253
300152710001,30-015-27100,BR 15 STATE 001,1998-03-01,18,0,0,801,2213,0,36054
300152710001,30-015-27100,BR 15 STATE 001,1998-04-01,19,21,0,1591,2234,0,37645
300152710001,30-015-27100,BR 15 STATE 001,1998-05-01,20,182,0,0,2416,0,37645
300152710001,30-015-27100,BR 15 STATE 001,1998-06-01,21,0,0,0,2416,0,37645
300152710001,30-015-27100,BR 15 STATE 001,1998-07-01,22,56,0,7940,2472,0,45585
300152710001,30-015-27100,BR 15 STATE 001,1998-08-01,23,0,0,0,2472,0,45585
300152710001,30-015-27100,BR 15 STATE 001,1998-09-01,24,15,0,0,2487,0,45585
300152710001,30-015-27100,BR 15 STATE 001,1998-10-01,25,101,0,2994,2588,0,48579
300152710001,30-015-27100,BR 15 STATE 001,1998-11-01,26,134,0,2129,2722,0,50708
300152710001,30-015-27100,BR 15 STATE 001,1998-12-01,27,31,0,1069,2753,0,51777
300152710001,30-015-27100,BR 15 STATE 001,1999-01-01,28,35,0,1516,2788,0,53293
300152710001,30-015-27100,BR 15 STATE 001,1999-02-01,29,42,0,2005,2830,0,55298
300152710001,30-015-27100,BR 15 STATE 001,1999-03-01,30,18,0,1569,2848,0,56867
300152710001,30-015-27100,BR 15 STATE 001,1999-04-01,31,0,0,0,2848,0,56867
300152710001,30-015-27100,BR 15 STATE 001,1999-05-01,32,17,0,1519,2865,0,58386
300152710001,30-015-27100,BR 15 STATE 001,1999-06-01,33,105,0,3693,2970,0,62079
300152710001,30-015-27100,BR 15 STATE 001,1999-07-01,34,15,0,1430,2985,0,63509
300152710001,30-015-27100,BR 15 STATE 001,1999-08-01,35,10,0,385,2995,0,63894
300152710001,30-015-27100,BR 15 STATE 001,1999-09-01,36,20,0,644,3015,0,64538
300152710001,30-015-27100,BR 15 STATE 001,1999-10-01,37,8,0,1807,3023,0,66345
300152710001,30-015-27100,BR 15 STATE 001,1999-11-01,38,20,0,1702,3043,0,68047
300152710001,30-015-27100,BR 15 STATE 001,1999-12-01,39,301,0,4786,3344,0,72833
300152710001,30-015-27100,BR 15 STATE 001,2000-01-01,40,0,0,0,3344,0,72833
300152710001,30-015-27100,BR 15 STATE 001,2000-02-01,41,145,0,5062,3489,0,77895
300152710001,30-015-27100,BR 15 STATE 001,2000-03-01,42,35,0,562,3524,0,78457
300152710001,30-015-27100,BR 15 STATE 001,2000-04-01,43,86,0,3664,3610,0,82121
300152710001,30-015-27100,BR 15 STATE 001,2000-05-01,44,340,0,5391,3950,0,87512
300152710001,30-015-27100,BR 15 STATE 001,2000-06-01,45,0,0,0,3950,0,87512
300152710001,30-015-27100,BR 15 STATE 001,2000-07-01,46,37,0,1946,3987,0,89458
300152710001,30-015-27100,BR 15 STATE 001,2000-08-01,47,70,0,2592,4057,0,92050
300152710001,30-015-27100,BR 15 STATE 001,2000-09-01,48,11,0,626,4068,0,92676
300152710001,30-015-27100,BR 15 STATE 001,2000-10-01,49,229,0,6490,4297,0,99166
300152710001,30-015-27100,BR 15 STATE 001,2000-11-01,50,83,0,753,4380,0,99919
300152710001,30-015-27100,BR 15 STATE 001,2000-12-01,51,0,0,0,4380,0,99919
300152710001,30-015-27100,BR 15 STATE 001,2001-01-01,52,63,0,3111,4443,0,103030
300152710001,30-015-27100,BR 15 STATE 001,2001-02-01,53,20,0,2196,4463,0,105226
300152710001,30-015-27100,BR 15 STATE 001,2001-03-01,54,28,0,1124,4491,0,106350
300152710001,30-015-27100,BR 15 STATE 001,2001-04-01,55,0,0,2224,4491,0,108574
300152710001,30-015-27100,BR 15 STATE 001,2001-05-01,56,310,0,6278,4801,0,114852
300152710001,30-015-27100,BR 15 STATE 001,2001-06-01,57,6,0,0,4807,0,114852
300152710001,30-015-27100,BR 15 STATE 001,2001-07-01,58,17,0,895,4824,0,115747
300152710001,30-015-27100,BR 15 STATE 001,2001-08-01,59,12,0,1296,4836,0,117043
300152710001,30-015-27100,BR 15 STATE 001,2001-09-01,60,14,0,1277,4850,0,118320
300152710001,30-015-27100,BR 15 STATE 001,2001-10-01,61,0,0,0,4850,0,118320
300152710001,30-015-27100,BR 15 STATE 001,2001-11-01,62,10,0,1299,4860,0,119619
300152710001,30-015-27100,BR 15 STATE 001,2001-12-01,63,0,0,0,4860,0,119619
300152710001,30-015-27100,BR 15 STATE 001,2002-01-01,64,15,0,2301,4875,0,121920
300152710001,30-015-27100,BR 15 STATE 001,2002-02-01,65,51,0,2225,4926,0,124145
300152710001,30-015-27100,BR 15 STATE 001,2002-03-01,66,20,0,904,4946,0,125049
300152710001,30-015-27100,BR 15 STATE 001,2002-04-01,67,31,0,1137,4977,0,126186
300152710001,30-015-27100,BR 15 STATE 001,2002-05-01,68,6,0,962,4983,0,127148
300152710001,30-015-27100,BR 15 STATE 001,2002-06-01,69,66,0,2648,5049,0,129796
300152710001,30-015-27100,BR 15 STATE 001,2002-07-01,70,41,0,1569,5090,0,131365
300152710001,30-015-27100,BR 15 STATE 001,2002-08-01,71,7,0,222,5097,0,131587
300152710001,30-015-27100,BR 15 STATE 001,2002-09-01,72,0,0,0,5097,0,131587
300152710001,30-015-27100,BR 15 STATE 001,2002-10-01,73,108,0,1544,5205,0,133131
300152710001,30-015-27100,BR 15 STATE 001,2002-11-01,74,0,0,1368,5205,0,134499
300152710001,30-015-27100,BR 15 STATE 001,2002-12-01,75,86,0,1540,5291,0,136039
300152710001,30-015-27100,BR 15 STATE 001,2003-01-01,76,29,0,1490,5320,0,137529
300152710001,30-015-27100,BR 15 STATE 001,2003-02-01,77,32,0,1290,5352,0,138819
300152710001,30-015-27100,BR 15 STATE 001,2003-03-01,78,45,0,1431,5397,0,140250
300152710001,30-015-27100,BR 15 STATE 001,2003-04-01,79,82,0,1482,5479,0,141732
300152710001,30-015-27100,BR 15 STATE 001,2003-05-01,80,50,0,1767,5529,0,143499
300152710001,30-015-27100,BR 15 STATE 001,2003-06-01,81,91,0,1268,5620,0,144767
300152710001,30-015-27100,BR 15 STATE 001,2003-07-01,82,46,0,1495,5666,0,146262
300152710001,30-015-27100,BR 15 STATE 001,2003-08-01,83,9,0,1336,5675,0,147598
300152710001,30-015-27100,BR 15 STATE 001,2003-09-01,84,29,0,635,5704,0,148233
300152710001,30-015-27100,BR 15 STATE 001,2003-10-01,85,65,0,2642,5769,0,150875
300152710001,30-015-27100,BR 15 STATE 001,2003-11-01,86,18,0,841,5787,0,151716
300152710001,30-015-27100,BR 15 STATE 001,2003-12-01,87,2,0,1137,5789,0,152853
300152710001,30-015-27100,BR 15 STATE 001,2004-01-01,88,22,0,1299,5811,0,154152
300152710001,30-015-27100,BR 15 STATE 001,2004-02-01,89,0,0,0,5811,0,154152
300152710001,30-015-27100,BR 15 STATE 001,2004-03-01,90,33,0,1868,5844,0,156020
300152710001,30-015-27100,BR 15 STATE 001,2004-04-01,91,0,0,0,5844,0,156020
300152710001,30-015-27100,BR 15 STATE 001,2004-05-01,92,70,0,2863,5914,0,158883
300152710001,30-015-27100,BR 15 STATE 001,2004-06-01,93,3,0,909,5917,0,159792
300152710001,30-015-27100,BR 15 STATE 001,2004-07-01,94,129,0,1940,6046,0,161732
300152710001,30-015-27100,BR 15 STATE 001,2004-08-01,95,0,0,0,6046,0,161732
300152710001,30-015-27100,BR 15 STATE 001,2004-09-01,96,143,0,0,6189,0,161732
300152710001,30-015-27100,BR 15 STATE 001,2004-10-01,97,86,0,3301,6275,0,165033
300152710001,30-015-27100,BR 15 STATE 001,2004-11-01,98,99,0,1269,6374,0,166302
300152710001,30-015-27100,BR 15 STATE 001,2004-12-01,99,10,0,830,6384,0,167132
300152710001,30-015-27100,BR 15 STATE 001,2005-01-01,100,23,0,1283,6407,0,168415
300152710001,30-015-27100,BR 15 STATE 001,2005-02-01,101,43,0,806,6450,0,169221
300152710001,30-015-27100,BR 15 STATE 001,2005-03-01,102,32,0,1299,6482,0,170520
300152710001,30-015-27100,BR 15 STATE 001,2005-04-01,103,46,0,1390,6528,0,171910
300152710001,30-015-27100,BR 15 STATE 001,2005-05-01,104,31,0,1525,6559,0,173435
300152710001,30-015-27100,BR 15 STATE 001,2005-06-01,105,117,0,2362,6676,0,175797
300152710001,30-015-27100,BR 15 STATE 001,2005-07-01,106,34,0,1688,6710,0,177485
300152710001,30-015-27100,BR 15 STATE 001,2005-08-01,107,19,0,1218,6729,0,178703
300152710001,30-015-27100,BR 15 STATE 001,2005-09-01,108,27,0,1926,6756,0,180629
300152710001,30-015-27100,BR 15 STATE 001,2005-10-01,109,6,0,2347,6762,0,182976
300152710001,30-015-27100,BR 15 STATE 001,2005-11-01,110,81,0,1396,6843,0,184372
300152710001,30-015-27100,BR 15 STATE 001,2005-12-01,111,40,0,1014,6883,0,185386
300152710001,30-015-27100,BR 15 STATE 001,2006-01-01,112,37,0,2037,6920,0,187423
300152710001,30-015-27100,BR 15 STATE 001,2006-02-01,113,23,0,969,6943,0,188392
300152710001,30-015-27100,BR 15 STATE 001,2006-03-01,114,94,0,2201,7037,0,190593
300152710001,30-015-27100,BR 15 STATE 001,2006-04-01,115,89,0,2515,7126,0,193108
300152710001,30-015-27100,BR 15 STATE 001,2006-05-01,116,8,0,1236,7134,0,194344
300152710001,30-015-27100,BR 15 STATE 001,2006-06-01,117,21,0,918,7155,0,195262
300152710001,30-015-27100,BR 15 STATE 001,2006-07-01,118,15,0,485,7170,0,195747
300152710001,30-015-27100,BR 15 STATE 001,2006-08-01,119,28,0,1236,7198,0,196983
300152710001,30-015-27100,BR 15 STATE 001,2006-09-01,120,8,0,586,7206,0,197569
300152710001,30-015-27100,BR 15 STATE 001,2006-10-01,121,18,0,1443,7224,0,199012
300152710001,30-015-27100,BR 15 STATE 001,2006-11-01,122,38,0,923,7262,0,199935
300152710001,30-015-27100,BR 15 STATE 001,2006-12-01,123,2,0,618,7264,0,200553
300152710001,30-015-27100,BR 15 STATE 001,2007-01-01,124,29,0,1045,7293,0,201598
300152710001,30-015-27100,BR 15 STATE 001,2007-02-01,125,57,0,631,7350,0,202229
300152710001,30-015-27100,BR 15 STATE 001,2007-03-01,126,11,0,0,7361,0,202229
300152710001,30-015-27100,BR 15 STATE 001,2007-04-01,127,75,0,2640,7436,0,204869
300152710001,30-015-27100,BR 15 STATE 001,2007-05-01,128,135,0,2511,7571,0,207380
300152710001,30-015-27100,BR 15 STATE 001,2007-06-01,129,1,0,931,7572,0,208311
300152710001,30-015-27100,BR 15 STATE 001,2007-07-01,130,139,0,3226,7711,0,211537
300152710001,30-015-27100,BR 15 STATE 001,2007-08-01,131,46,0,953,7757,0,212490
300152710001,30-015-27100,BR 15 STATE 001,2007-09-01,132,89,0,2855,7846,0,215345
300152710001,30-015-27100,BR 15 STATE 001,2007-10-01,133,96,0,2451,7942,0,217796
300152710001,30-015-27100,BR 15 STATE 001,2007-11-01,134,33,0,1061,7975,0,218857
300152710001,30-015-27100,BR 15 STATE 001,2007-12-01,135,109,0,1993,8084,0,220850
300152710001,30-015-27100,BR 15 STATE 001,2008-01-01,136,91,0,2877,8175,0,223727
300152710001,30-015-27100,BR 15 STATE 001,2008-02-01,137,178,0,3634,8353,0,227361
300152710001,30-015-27100,BR 15 STATE 001,2008-03-01,138,119,0,0,8472,0,227361
300152710001,30-015-27100,BR 15 STATE 001,2008-04-01,139,45,0,594,8517,0,227955
300152710001,30-015-27100,BR 15 STATE 001,2008-05-01,140,134,0,5040,8651,0,232995
300152710001,30-015-27100,BR 15 STATE 001,2008-06-01,141,252,0,4121,8903,0,237116
300152710001,30-015-27100,BR 15 STATE 001,2008-07-01,142,301,0,6125,9204,0,243241
300152710001,30-015-27100,BR 15 STATE 001,2008-08-01,143,262,0,4785,9466,0,248026
300152710001,30-015-27100,BR 15 STATE 001,2008-09-01,144,309,0,5655,9775,0,253681
300152710001,30-015-27100,BR 15 STATE 001,2008-10-01,145,63,0,2103,9838,0,255784
300152710001,30-015-27100,BR 15 STATE 001,2008-11-01,146,133,0,2661,9971,0,258445
300152710001,30-015-27100,BR 15 STATE 001,2008-12-01,147,36,0,78,10007,0,258523
300152710001,30-015-27100,BR 15 STATE 001,2009-01-01,148,128,0,0,10135,0,258523
300152710001,30-015-27100,BR 15 STATE 001,2009-02-01,149,187,0,1920,10322,0,260443
300152710001,30-015-27100,BR 15 STATE 001,2009-03-01,150,241,0,7440,10563,0,267883
300152710001,30-015-27100,BR 15 STATE 001,2009-04-01,151,223,0,3430,10786,0,271313
300152710001,30-015-27100,BR 15 STATE 001,2009-05-01,152,307,0,4495,11093,0,275808
300152710001,30-015-27100,BR 15 STATE 001,2009-06-01,153,240,0,4095,11333,0,279903
300152710001,30-015-27100,BR 15 STATE 001,2009-07-01,154,241,0,2515,11574,0,282418
300152710001,30-015-27100,BR 15 STATE 001,2009-08-01,155,230,0,2315,11804,0,284733
300152710001,30-015-27100,BR 15 STATE 001,2009-09-01,156,217,0,2886,12021,0,287619
300152710001,30-015-27100,BR 15 STATE 001,2009-10-01,157,192,0,3768,12213,0,291387
300152710001,30-015-27100,BR 15 STATE 001,2009-11-01,158,205,0,3726,12418,0,295113
300152710001,30-015-27100,BR 15 STATE 001,2009-12-01,159,150,0,3320,12568,0,298433
300152710001,30-015-27100,BR 15 STATE 001,2010-01-01,160,302,0,3410,12870,0,301843
300152710001,30-015-27100,BR 15 STATE 001,2010-02-01,161,260,0,2930,13130,0,304773
300152710001,30-015-27100,BR 15 STATE 001,2010-03-01,162,252,0,2945,13382,0,307718
300152710001,30-015-27100,BR 15 STATE 001,2010-04-01,163,237,0,2850,13619,0,310568
300152710001,30-015-27100,BR 15 STATE 001,2010-05-01,164,197,0,2850,13816,0,313418
300152710001,30-015-27100,BR 15 STATE 001,2010-06-01,165,114,0,2359,13930,0,315777
300152710001,30-015-27100,BR 15 STATE 001,2010-07-01,166,143,0,2184,14073,0,317961
300152710001,30-015-27100,BR 15 STATE 001,2010-08-01,167,282,0,2346,14355,0,320307
300152710001,30-015-27100,BR 15 STATE 001,2010-09-01,168,231,0,2114,14586,0,322421
300152710001,30-015-27100,BR 15 STATE 001,2010-10-01,169,226,0,2387,14812,0,324808
300152710001,30-015-27100,BR 15 STATE 001,2010-11-01,170,147,0,2310,14959,0,327118
300152710001,30-015-27100,BR 15 STATE 001,2010-12-01,171,261,0,2387,15220,0,329505
300152710001,30-015-27100,BR 15 STATE 001,2011-01-01,172,194,0,2237,15414,0,331742
300152710001,30-015-27100,BR 15 STATE 001,2011-02-01,173,134,0,1193,15548,0,332935
300152710001,30-015-27100,BR 15 STATE 001,2011-03-01,174,226,0,1671,15774,0,334606
300152710001,30-015-27100,BR 15 STATE 001,2011-04-01,175,225,0,2015,15999,0,336621
300152710001,30-015-27100,BR 15 STATE 001,2011-05-01,176,202,0,2384,16201,0,339005
300152710001,30-015-27100,BR 15 STATE 001,2011-06-01,177,156,0,2320,16357,0,341325
300152710001,30-015-27100,BR 15 STATE 001,2011-07-01,178,130,0,2340,16487,0,343665
300152710001,30-015-27100,BR 15 STATE 001,2011-08-01,179,122,0,2418,16609,0,346083
300152710001,30-015-27100,BR 15 STATE 001,2011-09-01,180,100,0,2340,16709,0,348423
300152710001,30-015-27100,BR 15 STATE 001,2011-10-01,181,32,0,3538,16741,0,351961
300152710001,30-015-27100,BR 15 STATE 001,2011-11-01,182,177,0,3484,16918,0,355445
300152710001,30-015-27100,BR 15 STATE 001,2011-12-01,183,148,0,3568,17066,0,359013
300152710001,30-015-27100,BR 15 STATE 001,2012-01-01,184,40,0,2012,17106,0,361025
300152710001,30-015-27100,BR 15 STATE 001,2012-02-01,185,350,0,3048,17456,0,364073
300152710001,30-015-27100,BR 15 STATE 001,2012-03-01,186,280,0,4116,17736,0,368189
300152710001,30-015-27100,BR 15 STATE 001,2012-04-01,187,202,0,4393,17938,0,372582
300152710001,30-015-27100,BR 15 STATE 001,2012-05-01,188,105,0,3268,18043,0,375850
300152710001,30-015-27100,BR 15 STATE 001,2012-06-01,189,28,0,909,18071,0,376759
300152710001,30-015-27100,BR 15 STATE 001,2012-07-01,190,71,0,1839,18142,0,378598
300152710001,30-015-27100,BR 15 STATE 001,2012-08-01,191,70,0,2580,18212,0,381178
300152710001,30-015-27100,BR 15 STATE 001,2012-09-01,192,171,0,3408,18383,0,384586
300152710001,30-015-27100,BR 15 STATE 001,2012-10-01,193,154,0,3618,18537,0,388204
300152710001,30-015-27100,BR 15 STATE 001,2012-11-01,194,254,0,3904,18791,0,392108
300152710001,30-015-27100,BR 15 STATE 001,2012-12-01,195,156,0,4087,18947,0,396195
300152710001,30-015-27100,BR 15 STATE 001,2013-01-01,196,165,0,3935,19112,0,400130
300152710001,30-015-27100,BR 15 STATE 001,2013-02-01,197,156,0,3500,19268,0,403630
300152710001,30-015-27100,BR 15 STATE 001,2013-03-01,198,79,0,3875,19347,0,407505
300152710001,30-015-27100,BR 15 STATE 001,2013-04-01,199,199,0,3750,19546,0,411255
300152710001,30-015-27100,BR 15 STATE 001,2013-05-01,200,112,0,3930,19658,0,415185
300152710001,30-015-27100,BR 15 STATE 001,2013-06-01,201,71,0,3900,19729,0,419085
300152710001,30-015-27100,BR 15 STATE 001,2013-07-01,202,121,0,130,19850,0,419215
300152710001,30-015-27100,BR 15 STATE 001,2013-08-01,203,140,0,2451,19990,0,421666
300152710001,30-015-27100,BR 15 STATE 001,2013-09-01,204,160,0,3870,20150,0,425536
300152710001,30-015-27100,BR 15 STATE 001,2013-10-01,205,123,0,3999,20273,0,429535
300152710001,30-015-27100,BR 15 STATE 001,2013-11-01,206,11,0,1802,20284,0,431337
300152710001,30-015-27100,BR 15 STATE 001,2013-12-01,207,0,0,385,20284,0,431722
300152710001,30-015-27100,BR 15 STATE 001,2014-01-01,208,0,0,0,20284,0,431722
300152710001,30-015-27100,BR 15 STATE 001,2014-02-01,209,0,0,0,20284,0,431722
300152710001,30-015-27100,BR 15 STATE 001,2014-03-01,210,0,0,380,20284,0,432102
300152710001,30-015-27100,BR 15 STATE 001,2014-04-01,211,31,0,810,20315,0,432912
300152710001,30-015-27100,BR 15 STATE 001,2014-05-01,212,247,0,3930,20562,0,436842
300152710001,30-015-27100,BR 15 STATE 001,2014-06-01,213,143,0,3900,20705,0,440742
300152710001,30-015-27100,BR 15 STATE 001,2014-07-01,214,0,0,2210,20705,0,442952
300152710001,30-015-27100,BR 15 STATE 001,2014-08-01,215,181,0,592,20886,0,443544
300152710001,30-015-27100,BR 15 STATE 001,2014-09-01,216,69,0,3182,20955,0,446726
300152710001,30-015-27100,BR 15 STATE 001,2014-10-01,217,25,0,888,20980,0,447614
300152710001,30-015-27100,BR 15 STATE 001,2014-11-01,218,114,0,2340,21094,0,449954
300152710001,30-015-27100,BR 15 STATE 001,2014-12-01,219,246,0,3770,21340,0,453724
300152710001,30-015-27100,BR 15 STATE 001,2015-01-01,220,9,0,1040,21349,0,454764
300152710001,30-015-27100,BR 15 STATE 001,2015-02-01,221,0,0,2340,21349,0,457104
300152710001,30-015-27100,BR 15 STATE 001,2015-03-01,222,68,0,3870,21417,0,460974
300152710001,30-015-27100,BR 15 STATE 001,2015-04-01,223,14,0,1380,21431,0,462354
300152710001,30-015-27100,BR 15 STATE 001,2015-05-01,224,33,0,1521,21464,0,463875
300152710001,30-015-27100,BR 15 STATE 001,2015-06-01,225,0,0,286,21464,0,464161
300152710001,30-015-27100,BR 15 STATE 001,2015-07-01,226,10,0,1155,21474,0,465316
300152710001,30-015-27100,BR 15 STATE 001,2015-08-01,227,1,0,700,21475,0,466016
300152710001,30-015-27100,BR 15 STATE 001,2015-09-01,228,1,0,309,21476,0,466325
300152710001,30-015-27100,BR 15 STATE 001,2015-10-01,229,0,0,149,21476,0,466474
300152710001,30-015-27100,BR 15 STATE 001,2015-11-01,230,0,0,0,21476,0,466474
300152710001,30-015-27100,BR 15 STATE 001,2015-12-01,231,0,0,0,21476,0,466474
300152710001,30-015-27100,BR 15 STATE 001,2016-01-01,232,0,0,0,21476,0,466474
300152710001,30-015-27100,BR 15 STATE 001,2016-02-01,233,0,0,0,21476,0,466474
300152710001,30-015-27100,BR 15 STATE 001,2016-03-01,234,1,0,125,21477,0,466599
300152710001,30-015-27100,BR 15 STATE 001,2016-04-01,235,3,0,569,21480,0,467168
300152710001,30-015-27100,BR 15 STATE 001,2016-05-01,236,2,0,188,21482,0,467356
300152710001,30-015-27100,BR 15 STATE 001,2016-06-01,237,63,0,3530,21545,0,470886
300152710001,30-015-27100,BR 15 STATE 001,2016-07-01,238,108,0,4312,21653,0,475198
300152710001,30-015-27100,BR 15 STATE 001,2016-08-01,239,319,0,4308,21972,0,479506
300152710001,30-015-27100,BR 15 STATE 001,2016-09-01,240,293,0,3875,22265,0,483381
300152710001,30-015-27100,BR 15 STATE 001,2016-10-01,241,294,0,3476,22559,0,486857
300152710001,30-015-27100,BR 15 STATE 001,2016-11-01,242,222,0,3540,22781,0,490397
300152710001,30-015-27100,BR 15 STATE 001,2016-12-01,243,214,0,2638,22995,0,493035
300152710001,30-015-27100,BR 15 STATE 001,2017-01-01,244,183,0,2394,23178,0,495429
300152710001,30-015-27100,BR 15 STATE 001,2017-02-01,245,146,0,2743,23324,0,498172
300152710001,30-015-27100,BR 15 STATE 001,2017-03-01,246,178,0,3741,23502,0,501913
300152710001,30-015-27100,BR 15 STATE 001,2017-04-01,247,152,0,3436,23654,0,505349
300152710001,30-015-27100,BR 15 STATE 001,2017-05-01,248,152,0,3436,23806,0,508785
300152710001,30-015-27100,BR 15 STATE 001,2017-06-01,249,153,0,3334,23959,0,512119
300152710001,30-015-27100,BR 15 STATE 001,2017-07-01,250,71,0,2500,24030,0,514619
300152710001,30-015-27100,BR 15 STATE 001,2017-08-01,251,26,0,1411,24056,0,516030
300154514300,30-015-45143,DAVID EDELSTEIN STATE COM 223H,2019-03-01,1,18911,295804,78314,18911,295804,78314
300154514300,30-015-45143,DAVID EDELSTEIN STATE COM 223H,2019-04-01,2,14564,265971,52966,33475,561775,131280
300154514300,30-015-45143,DAVID EDELSTEIN STATE COM 223H,2019-05-01,3,11706,218211,48444,45181,779986,179724
300154514300,30-015-45143,DAVID EDELSTEIN STATE COM 223H,2019-06-01,4,12295,259073,61082,57476,1039059,240806
300154514300,30-015-45143,DAVID EDELSTEIN STATE COM 223H,2019-07-01,5,12247,316587,70135,69723,1355646,310941
300154514300,30-015-45143,DAVID EDELSTEIN STATE COM 223H,2019-08-01,6,10441,258871,58048,80164,1614517,368989
300154514300,30-015-45143,DAVID EDELSTEIN STATE COM 223H,2019-09-01,7,6482,144759,28101,86646,1759276,397090
300154514300,30-015-45143,DAVID EDELSTEIN STATE COM 223H,2019-10-01,8,5215,112101,25318,91861,1871377,422408
300154514300,30-015-45143,DAVID EDELSTEIN STATE COM 223H,2019-11-01,9,4867,106831,25544,96728,1978208,447952
300154514300,30-015-45143,DAVID EDELSTEIN STATE COM 223H,2019-12-01,10,5246,161128,38954,101974,2139336,486906
300154514300,30-015-45143,DAVID EDELSTEIN STATE COM 223H,2020-01-01,11,5759,207147,46104,107733,2346483,533010
300154514300,30-015-45143,DAVID EDELSTEIN STATE COM 223H,2020-02-01,12,4545,122198,22004,112278,2468681,555014
300154514300,30-015-45143,DAVID EDELSTEIN STATE COM 223H,2020-03-01,13,4587,131098,27309,116865,2599779,582323
300154514300,30-015-45143,DAVID EDELSTEIN STATE COM 223H,2020-04-01,14,3798,107586,21568,120663,2707365,603891
300154514300,30-015-45143,DAVID EDELSTEIN STATE COM 223H,2020-05-01,15,3712,106356,21284,124375,2813721,625175
300154514300,30-015-45143,DAVID EDELSTEIN STATE COM 223H,2020-06-01,16,3483,96693,18688,127858,2910414,643863
300154514300,30-015-45143,DAVID EDELSTEIN STATE COM 223H,2020-07-01,17,3409,96229,20398,131267,3006643,664261
300154514300,30-015-45143,DAVID EDELSTEIN STATE COM 223H,2020-08-01,18,3308,93441,20523,134575,3100084,684784
300154514300,30-015-45143,DAVID EDELSTEIN STATE COM 223H,2020-09-01,19,3162,93472,19515,137737,3193556,704299
300154514300,30-015-45143,DAVID EDELSTEIN STATE COM 223H,2020-10-01,20,2380,65124,10520,140117,3258680,714819
300154514300,30-015-45143,DAVID EDELSTEIN STATE COM 223H,2020-11-01,21,2669,62189,11242,142786,3320869,726061
300154514300,30-015-45143,DAVID EDELSTEIN STATE COM 223H,2020-12-01,22,2467,62882,12518,145253,3383751,738579
300154514300,30-015-45143,DAVID EDELSTEIN STATE COM 223H,2021-01-01,23,2487,59182,11659,147740,3442933,750238
300154514300,30-015-45143,DAVID EDELSTEIN STATE COM 223H,2021-02-01,24,2512,64175,13202,150252,3507108,763440
300154514300,30-015-45143,DAVID EDELSTEIN STATE COM 223H,2021-03-01,25,3124,84052,16091,153376,3591160,779531
300154514300,30-015-45143,DAVID EDELSTEIN STATE COM 223H,2021-04-01,26,3008,77972,13837,156384,3669132,793368
300154514300,30-015-45143,DAVID EDELSTEIN STATE COM 223H,2021-05-01,27,3211,77948,13340,159595,3747080,806708
300154514300,30-015-45143,DAVID EDELSTEIN STATE COM 223H,2021-06-01,28,2980,74704,14146,162575,3821784,820854
300154514300,30-015-45143,DAVID EDELSTEIN STATE COM 223H,2021-07-01,29,2901,71187,13545,165476,3892971,834399
300154514300,30-015-45143,DAVID EDELSTEIN STATE COM 223H,2021-08-01,30,2648,69288,12225,168124,3962259,846624
300154514300,30-015-45143,DAVID EDELSTEIN STATE COM 223H,2021-09-01,31,2386,70349,13534,170510,4032608,860158
300154514300,30-015-45143,DAVID EDELSTEIN STATE COM 223H,2021-10-01,32,2256,68790,12183,172766,4101398,872341
300154514300,30-015-45143,DAVID EDELSTEIN STATE COM 223H,2021-11-01,33,2101,66861,12303,174867,4168259,884644
300154514300,30-015-45143,DAVID EDELSTEIN STATE COM 223H,2021-12-01,34,2246,69677,12148,177113,4237936,896792
300154514300,30-015-45143,DAVID EDELSTEIN STATE COM 223H,2022-01-01,35,2029,59838,11078,179142,4297774,907870
300154514300,30-015-45143,DAVID EDELSTEIN STATE COM 223H,2022-02-01,36,1912,58519,10626,181054,4356293,918496
300154514300,30-015-45143,DAVID EDELSTEIN STATE COM 223H,2022-03-01,37,2210,63815,11859,183264,4420108,930355
300154514300,30-015-45143,DAVID EDELSTEIN STATE COM 223H,2022-04-01,38,2297,58529,11309,185561,4478637,941664
300154514300,30-015-45143,DAVID EDELSTEIN STATE COM 223H,2022-05-01,39,2306,59525,11047,187867,4538162,952711
300154514300,30-015-45143,DAVID EDELSTEIN STATE COM 223H,2022-06-01,40,2174,55717,10759,190041,4593879,963470
300154514300,30-015-45143,DAVID EDELSTEIN STATE COM 223H,2022-07-01,41,2173,54467,10009,192214,4648346,973479
300154514300,30-015-45143,DAVID EDELSTEIN STATE COM 223H,2022-08-01,42,2227,57138,10754,194441,4705484,984233
300154514300,30-015-45143,DAVID EDELSTEIN STATE COM 223H,2022-09-01,43,2052,52236,9981,196493,4757720,994214
300154514300,30-015-45143,DAVID EDELSTEIN STATE COM 223H,2022-10-01,44,2059,51933,8730,198552,4809653,1002944
300154514300,30-015-45143,DAVID EDELSTEIN STATE COM 223H,2022-11-01,45,2119,52025,8976,200671,4861678,1011920
300154514300,30-015-45143,DAVID EDELSTEIN STATE COM 223H,2022-12-01,46,2058,54125,8682,202729,4915803,1020602
300154514300,30-015-45143,DAVID EDELSTEIN STATE COM 223H,2023-01-01,47,1888,47811,7821,204617,4963614,1028423
300154514300,30-015-45143,DAVID EDELSTEIN STATE COM 223H,2023-02-01,48,302,8268,598,204919,4971882,1029021
300154514300,30-015-45143,DAVID EDELSTEIN STATE COM 223H,2023-03-01,49,1508,43452,5293,206427,5015334,1034314
300154514300,30-015-45143,DAVID EDELSTEIN STATE COM 223H,2023-04-01,50,1771,46956,8415,208198,5062290,1042729
300154514300,30-015-45143,DAVID EDELSTEIN STATE COM 223H,2023-05-01,51,1634,42290,6086,209832,5104580,1048815
300154514300,30-015-45143,DAVID EDELSTEIN STATE COM 223H,2023-06-01,52,236,8333,29,210068,5112913,1048844
300154146900,30-015-41469,BUZZ 21 STATE 701H,2017-03-01,1,8922,19842,103554,8922,19842,103554
300154146900,30-015-41469,BUZZ 21 STATE 701H,2017-04-01,2,31481,64853,139818,40403,84695,243372
300154146900,30-015-41469,BUZZ 21 STATE 701H,2017-05-01,3,15472,32482,60706,55875,117177,304078
300154146900,30-015-41469,BUZZ 21 STATE 701H,2017-06-01,4,12465,30886,50134,68340,148063,354212
300154146900,30-015-41469,BUZZ 21 STATE 701H,2017-07-01,5,10614,31145,46066,78954,179208,400278
300154146900,30-015-41469,BUZZ 21 STATE 701H,2017-08-01,6,9441,33228,45872,88395,212436,446150
300154146900,30-015-41469,BUZZ 21 STATE 701H,2017-09-01,7,7640,25943,36236,96035,238379,482386
300154146900,30-015-41469,BUZZ 21 STATE 701H,2017-10-01,8,6899,26709,34918,102934,265088,517304
300154146900,30-015-41469,BUZZ 21 STATE 701H,2017-11-01,9,5846,18344,27011,108780,283432,544315
300154146900,30-015-41469,BUZZ 21 STATE 701H,2017-12-01,10,6122,19834,29716,114902,303266,574031
300154146900,30-015-41469,BUZZ 21 STATE 701H,2018-01-01,11,5634,20697,29188,120536,323963,603219
300154146900,30-015-41469,BUZZ 21 STATE 701H,2018-02-01,12,4691,17304,24621,125227,341267,627840
300154146900,30-015-41469,BUZZ 21 STATE 701H,2018-03-01,13,4798,17405,24966,130025,358672,652806
300154146900,30-015-41469,BUZZ 21 STATE 701H,2018-04-01,14,4485,16402,23853,134510,375074,676659
300154146900,30-015-41469,BUZZ 21 STATE 701H,2018-05-01,15,4325,17728,25822,138835,392802,702481
300154146900,30-015-41469,BUZZ 21 STATE 701H,2018-06-01,16,3387,12770,20499,142222,405572,722980
300154146900,30-015-41469,BUZZ 21 STATE 701H,2018-07-01,17,603,1357,10277,142825,406929,733257
300154146900,30-015-41469,BUZZ 21 STATE 701H,2018-08-01,18,3705,8692,27101,146530,415621,760358
300154146900,30-015-41469,BUZZ 21 STATE 701H,2018-09-01,19,3527,9674,27144,150057,425295,787502
300154146900,30-015-41469,BUZZ 21 STATE 701H,2018-10-01,20,3783,11321,25246,153840,436616,812748
300154146900,30-015-41469,BUZZ 21 STATE 701H,2018-11-01,21,3576,12452,22972,157416,449068,835720
300154146900,30-015-41469,BUZZ 21 STATE 701H,2018-12-01,22,3486,12389,21087,160902,461457,856807
300154146900,30-015-41469,BUZZ 21 STATE 701H,2019-01-01,23,3412,14412,22219,164314,475869,879026
300154146900,30-015-41469,BUZZ 21 STATE 701H,2019-02-01,24,2990,13886,18499,167304,489755,897525
300154146900,30-015-41469,BUZZ 21 STATE 701H,2019-03-01,25,3093,15076,19206,170397,504831,916731
300154146900,30-015-41469,BUZZ 21 STATE 701H,2019-04-01,26,2938,14433,18064,173335,519264,934795
300154146900,30-015-41469,BUZZ 21 STATE 701H,2019-05-01,27,2965,13744,17242,176300,533008,952037
300154146900,30-015-41469,BUZZ 21 STATE 701H,2019-06-01,28,2874,13644,17273,179174,546652,969310
300154146900,30-015-41469,BUZZ 21 STATE 701H,2019-07-01,29,2778,12553,16705,181952,559205,986015
300154146900,30-015-41469,BUZZ 21 STATE 701H,2019-08-01,30,2743,12235,16519,184695,571440,1002534
300154146900,30-015-41469,BUZZ 21 STATE 701H,2019-09-01,31,2570,11488,15061,187265,582928,1017595
300154146900,30-015-41469,BUZZ 21 STATE 701H,2019-10-01,32,2449,11769,15762,189714,594697,1033357
300154146900,30-015-41469,BUZZ 21 STATE 701H,2019-11-01,33,2468,11369,14721,192182,606066,1048078
300154146900,30-015-41469,BUZZ 21 STATE 701H,2019-12-01,34,2448,10876,13721,194630,616942,1061799
300154146900,30-015-41469,BUZZ 21 STATE 701H,2020-01-01,35,2254,10181,13367,196884,627123,1075166
300154146900,30-015-41469,BUZZ 21 STATE 701H,2020-02-01,36,2339,9779,12792,199223,636902,1087958
300154146900,30-015-41469,BUZZ 21 STATE 701H,2020-03-01,37,2349,9952,13497,201572,646854,1101455
300154146900,30-015-41469,BUZZ 21 STATE 701H,2020-04-01,38,1949,8662,11541,203521,655516,1112996
300154146900,30-015-41469,BUZZ 21 STATE 701H,2020-05-01,39,884,1511,2887,204405,657027,1115883
300154146900,30-015-41469,BUZZ 21 STATE 701H,2020-06-01,40,2417,7431,13896,206822,664458,1129779
300154146900,30-015-41469,BUZZ 21 STATE 701H,2020-07-01,41,2281,7934,14096,209103,672392,1143875
300154146900,30-015-41469,BUZZ 21 STATE 701H,2020-08-01,42,2165,9075,12820,211268,681467,1156695
300154146900,30-015-41469,BUZZ 21 STATE 701H,2020-09-01,43,1903,8267,11107,213171,689734,1167802
300154146900,30-015-41469,BUZZ 21 STATE 701H,2020-10-01,44,2055,8554,11191,215226,698288,1178993
300154146900,30-015-41469,BUZZ 21 STATE 701H,2020-11-01,45,1957,8150,10951,217183,706438,1189944
300154146900,30-015-41469,BUZZ 21 STATE 701H,2020-12-01,46,2011,8190,10983,219194,714628,1200927
300154146900,30-015-41469,BUZZ 21 STATE 701H,2021-01-01,47,1980,8659,11513,221174,723287,1212440
300154146900,30-015-41469,BUZZ 21 STATE 701H,2021-02-01,48,1512,7298,8845,222686,730585,1221285
300154146900,30-015-41469,BUZZ 21 STATE 701H,2021-03-01,49,1970,9083,11577,224656,739668,1232862
300154146900,30-015-41469,BUZZ 21 STATE 701H,2021-04-01,50,1790,8676,10658,226446,748344,1243520
300154146900,30-015-41469,BUZZ 21 STATE 701H,2021-05-01,51,1700,8318,10240,228146,756662,1253760
300154146900,30-015-41469,BUZZ 21 STATE 701H,2021-06-01,52,1582,6845,9483,229728,763507,1263243
300154146900,30-015-41469,BUZZ 21 STATE 701H,2021-07-01,53,1636,7755,10406,231364,771262,1273649
300154146900,30-015-41469,BUZZ 21 STATE 701H,2021-08-01,54,1733,7880,7268,233097,779142,1280917
300154146900,30-015-41469,BUZZ 21 STATE 701H,2021-09-01,55,1657,8041,7494,234754,787183,1288411
300154146900,30-015-41469,BUZZ 21 STATE 701H,2021-10-01,56,1711,8124,8687,236465,795307,1297098
300154146900,30-015-41469,BUZZ 21 STATE 701H,2021-11-01,57,1588,7847,9516,238053,803154,1306614
300154146900,30-015-41469,BUZZ 21 STATE 701H,2021-12-01,58,1618,8485,9990,239671,811639,1316604
300154146900,30-015-41469,BUZZ 21 STATE 701H,2022-01-01,59,1640,8231,9910,241311,819870,1326514
300154146900,30-015-41469,BUZZ 21 STATE 701H,2022-02-01,60,1401,6805,8584,242712,826675,1335098
300154146900,30-015-41469,BUZZ 21 STATE 701H,2022-03-01,61,1592,8243,10044,244304,834918,1345142
300154146900,30-015-41469,BUZZ 21 STATE 701H,2022-04-01,62,1469,7539,9365,245773,842457,1354507
300154146900,30-015-41469,BUZZ 21 STATE 701H,2022-05-01,63,1467,7533,9568,247240,849990,1364075
300154146900,30-015-41469,BUZZ 21 STATE 701H,2022-06-01,64,1358,6865,8645,248598,856855,1372720
300154146900,30-015-41469,BUZZ 21 STATE 701H,2022-07-01,65,1369,7104,8113,249967,863959,1380833
300154146900,30-015-41469,BUZZ 21 STATE 701H,2022-08-01,66,1386,7124,8653,251353,871083,1389486
300154146900,30-015-41469,BUZZ 21 STATE 701H,2022-09-01,67,1358,6947,8777,252711,878030,1398263
300154146900,30-015-41469,BUZZ 21 STATE 701H,2022-10-01,68,1490,7285,9143,254201,885315,1407406
300154146900,30-015-41469,BUZZ 21 STATE 701H,2022-11-01,69,1260,5929,7471,255461,891244,1414877
300154146900,30-015-41469,BUZZ 21 STATE 701H,2022-12-01,70,983,5210,5686,256444,896454,1420563
300154146900,30-015-41469,BUZZ 21 STATE 701H,2023-01-01,71,1443,4987,8150,257887,901441,1428713
300154146900,30-015-41469,BUZZ 21 STATE 701H,2023-02-01,72,1187,4081,6048,259074,905522,1434761
300154146900,30-015-41469,BUZZ 21 STATE 701H,2023-03-01,73,1117,4601,5242,260191,910123,1440003
300154146900,30-015-41469,BUZZ 21 STATE 701H,2023-04-01,74,1081,3158,5092,261272,913281,1445095
300154146900,30-015-41469,BUZZ 21 STATE 701H,2023-05-01,75,1324,5135,5961,262596,918416,1451056
300154146900,30-015-41469,BUZZ 21 STATE 701H,2023-06-01,76,805,2256,3574,263401,920672,1454630
300154146900,30-015-41469,BUZZ 21 STATE 701H,2023-07-01,77,1210,5232,3616,264611,925904,1458246
300154396700,30-015-43967,SWITCHBACK STATE 021H,2017-03-01,1,273,988,16984,273,988,16984
300154396700,30-015-43967,SWITCHBACK STATE 021H,2017-04-01,2,22659,43516,89429,22932,44504,106413
300154396700,30-015-43967,SWITCHBACK STATE 021H,2017-05-01,3,22344,47964,77811,45276,92468,184224
300154396700,30-015-43967,SWITCHBACK STATE 021H,2017-06-01,4,16477,35714,46520,61753,128182,230744
300154396700,30-015-43967,SWITCHBACK STATE 021H,2017-07-01,5,14240,35716,43496,75993,163898,274240
300154396700,30-015-43967,SWITCHBACK STATE 021H,2017-08-01,6,11207,34431,38440,87200,198329,312680
300154396700,30-015-43967,SWITCHBACK STATE 021H,2017-09-01,7,8863,29682,30707,96063,228011,343387
300154396700,30-015-43967,SWITCHBACK STATE 021H,2017-10-01,8,8587,26543,27943,104650,254554,371330
300154396700,30-015-43967,SWITCHBACK STATE 021H,2017-11-01,9,7347,25556,26956,111997,280110,398286
300154396700,30-015-43967,SWITCHBACK STATE 021H,2017-12-01,10,6717,20807,22116,118714,300917,420402
300154396700,30-015-43967,SWITCHBACK STATE 021H,2018-01-01,11,2860,9173,9448,121574,310090,429850
300154396700,30-015-43967,SWITCHBACK STATE 021H,2018-02-01,12,5609,14819,17695,127183,324909,447545
300154396700,30-015-43967,SWITCHBACK STATE 021H,2018-03-01,13,6720,22732,24727,133903,347641,472272
300154396700,30-015-43967,SWITCHBACK STATE 021H,2018-04-01,14,5426,21674,20329,139329,369315,492601
300154396700,30-015-43967,SWITCHBACK STATE 021H,2018-05-01,15,4106,16987,15182,143435,386302,507783
300154396700,30-015-43967,SWITCHBACK STATE 021H,2018-06-01,16,3093,9961,10502,146528,396263,518285
300154396700,30-015-43967,SWITCHBACK STATE 021H,2018-07-01,17,4871,19957,19633,151399,416220,537918
300154396700,30-015-43967,SWITCHBACK STATE 021H,2018-08-01,18,4197,22777,17296,155596,438997,555214
300154396700,30-015-43967,SWITCHBACK STATE 021H,2018-09-01,19,3593,20780,16536,159189,459777,571750
300154396700,30-015-43967,SWITCHBACK STATE 021H,2018-10-01,20,3370,15517,15270,162559,475294,587020
300154396700,30-015-43967,SWITCHBACK STATE 021H,2018-11-01,21,3405,15274,14439,165964,490568,601459
300154396700,30-015-43967,SWITCHBACK STATE 021H,2018-12-01,22,3371,15148,14120,169335,505716,615579
300154396700,30-015-43967,SWITCHBACK STATE 021H,2019-01-01,23,3021,12790,12870,172356,518506,628449
300154396700,30-015-43967,SWITCHBACK STATE 021H,2019-02-01,24,2678,10693,11563,175034,529199,640012
300154396700,30-015-43967,SWITCHBACK STATE 021H,2019-03-01,25,2841,11563,11057,177875,540762,651069
300154396700,30-015-43967,SWITCHBACK STATE 021H,2019-04-01,26,2690,11027,11062,180565,551789,662131
300154396700,30-015-43967,SWITCHBACK STATE 021H,2019-05-01,27,2554,10822,10862,183119,562611,672993
300154396700,30-015-43967,SWITCHBACK STATE 021H,2019-06-01,28,2521,10574,10241,185640,573185,683234
300154396700,30-015-43967,SWITCHBACK STATE 021H,2019-07-01,29,2543,10826,10286,188183,584011,693520
300154396700,30-015-43967,SWITCHBACK STATE 021H,2019-08-01,30,2442,11044,10724,190625,595055,704244
300154396700,30-015-43967,SWITCHBACK STATE 021H,2019-09-01,31,2295,10170,9690,192920,605225,713934
300154396700,30-015-43967,SWITCHBACK STATE 021H,2019-10-01,32,2248,10088,9670,195168,615313,723604
300154396700,30-015-43967,SWITCHBACK STATE 021H,2019-11-01,33,2253,9760,9219,197421,625073,732823
300154396700,30-015-43967,SWITCHBACK STATE 021H,2019-12-01,34,2310,10896,9978,199731,635969,742801
300154396700,30-015-43967,SWITCHBACK STATE 021H,2020-01-01,35,2216,10289,9993,201947,646258,752794
300154396700,30-015-43967,SWITCHBACK STATE 021H,2020-02-01,36,1993,9295,8921,203940,655553,761715
300154396700,30-015-43967,SWITCHBACK STATE 021H,2020-03-01,37,2129,10317,8654,206069,665870,770369
300154396700,30-015-43967,SWITCHBACK STATE 021H,2020-04-01,38,2024,9890,7204,208093,675760,777573
300154396700,30-015-43967,SWITCHBACK STATE 021H,2020-05-01,39,1982,9974,8952,210075,685734,786525
300154396700,30-015-43967,SWITCHBACK STATE 021H,2020-06-01,40,1724,8751,7622,211799,694485,794147
300154396700,30-015-43967,SWITCHBACK STATE 021H,2020-07-01,41,1755,8756,7769,213554,703241,801916
300154396700,30-015-43967,SWITCHBACK STATE 021H,2020-08-01,42,1728,8297,6867,215282,711538,808783
300154396700,30-015-43967,SWITCHBACK STATE 021H,2020-09-01,43,1737,8248,7735,217019,719786,816518
300154396700,30-015-43967,SWITCHBACK STATE 021H,2020-10-01,44,1759,8479,7624,218778,728265,824142
300154396700,30-015-43967,SWITCHBACK STATE 021H,2020-11-01,45,1789,8218,7164,220567,736483,831306
300154396700,30-015-43967,SWITCHBACK STATE 021H,2020-12-01,46,1604,7122,7109,222171,743605,838415
300154396700,30-015-43967,SWITCHBACK STATE 021H,2021-01-01,47,1649,7311,6328,223820,750916,844743
300154396700,30-015-43967,SWITCHBACK STATE 021H,2021-02-01,48,1404,6384,5585,225224,757300,850328
300154396700,30-015-43967,SWITCHBACK STATE 021H,2021-03-01,49,1422,6461,6199,226646,763761,856527
300154396700,30-015-43967,SWITCHBACK STATE 021H,2021-04-01,50,1676,7360,6794,228322,771121,863321
300154396700,30-015-43967,SWITCHBACK STATE 021H,2021-05-01,51,1601,7228,6519,229923,778349,869840
300154396700,30-015-43967,SWITCHBACK STATE 021H,2021-06-01,52,796,3685,3410,230719,782034,873250
300154396700,30-015-43967,SWITCHBACK STATE 021H,2021-07-01,53,779,4387,3159,231498,786421,876409
300154396700,30-015-43967,SWITCHBACK STATE 021H,2021-08-01,54,1720,6615,7414,233218,793036,883823
300154396700,30-015-43967,SWITCHBACK STATE 021H,2021-09-01,55,1605,6128,6977,234823,799164,890800
300154396700,30-015-43967,SWITCHBACK STATE 021H,2021-10-01,56,1617,6517,7188,236440,805681,897988
300154396700,30-015-43967,SWITCHBACK STATE 021H,2021-11-01,57,1543,6265,6939,237983,811946,904927
300154396700,30-015-43967,SWITCHBACK STATE 021H,2021-12-01,58,1555,6608,6686,239538,818554,911613
300154396700,30-015-43967,SWITCHBACK STATE 021H,2022-01-01,59,1485,6549,6605,241023,825103,918218
300154396700,30-015-43967,SWITCHBACK STATE 021H,2022-02-01,60,1346,5945,5994,242369,831048,924212
300154396700,30-015-43967,SWITCHBACK STATE 021H,2022-03-01,61,50,296,198,242419,831344,924410
300154396700,30-015-43967,SWITCHBACK STATE 021H,2022-04-01,62,1593,6728,6477,244012,838072,930887
300154396700,30-015-43967,SWITCHBACK STATE 021H,2022-05-01,63,1556,6345,6984,245568,844417,937871
300154396700,30-015-43967,SWITCHBACK STATE 021H,2022-06-01,64,1023,4508,4511,246591,848925,942382
300154396700,30-015-43967,SWITCHBACK STATE 021H,2022-07-01,65,970,4483,4395,247561,853408,946777
300154396700,30-015-43967,SWITCHBACK STATE 021H,2022-08-01,66,1524,6465,6366,249085,859873,953143
300154396700,30-015-43967,SWITCHBACK STATE 021H,2022-09-01,67,1141,5875,7529,250226,865748,960672
300154396700,30-015-43967,SWITCHBACK STATE 021H,2022-10-01,68,969,3404,4963,251195,869152,965635
300154396700,30-015-43967,SWITCHBACK STATE 021H,2022-11-01,69,0,0,0,251195,869152,965635
300154396700,30-015-43967,SWITCHBACK STATE 021H,2022-12-01,70,86,379,592,251281,869531,966227
300154396700,30-015-43967,SWITCHBACK STATE 021H,2023-01-01,71,1405,6093,6373,252686,875624,972600
300154396700,30-015-43967,SWITCHBACK STATE 021H,2023-02-01,72,1376,4799,5626,254062,880423,978226
300154396700,30-015-43967,SWITCHBACK STATE 021H,2023-03-01,73,1458,4920,5403,255520,885343,983629
300154396700,30-015-43967,SWITCHBACK STATE 021H,2023-04-01,74,1944,5343,6088,257464,890686,989717
300154396700,30-015-43967,SWITCHBACK STATE 021H,2023-05-01,75,1404,6246,7357,258868,896932,997074
300154396700,30-015-43967,SWITCHBACK STATE 021H,2023-06-01,76,691,3064,3850,259559,899996,1000924
300154396700,30-015-43967,SWITCHBACK STATE 021H,2023-07-01,77,1328,6156,6666,260887,906152,1007590
300154596400,30-015-45964,TONY LA RUSSA STATE COM 201H,2019-08-01,1,32,116,20238,32,116,20238
300154596400,30-015-45964,TONY LA RUSSA STATE COM 201H,2019-09-01,2,19413,39353,114432,19445,39469,134670
300154596400,30-015-45964,TONY LA RUSSA STATE COM 201H,2019-10-01,3,13553,27396,63951,32998,66865,198621
300154596400,30-015-45964,TONY LA RUSSA STATE COM 201H,2019-11-01,4,10893,24128,58466,43891,90993,257087
300154596400,30-015-45964,TONY LA RUSSA STATE COM 201H,2019-12-01,5,7885,20614,47973,51776,111607,305060
300154596400,30-015-45964,TONY LA RUSSA STATE COM 201H,2020-01-01,6,6588,19925,41428,58364,131532,346488
300154596400,30-015-45964,TONY LA RUSSA STATE COM 201H,2020-02-01,7,5219,16713,33022,63583,148245,379510
300154596400,30-015-45964,TONY LA RUSSA STATE COM 201H,2020-03-01,8,4592,15599,31103,68175,163844,410613
300154596400,30-015-45964,TONY LA RUSSA STATE COM 201H,2020-04-01,9,3684,11215,23560,71859,175059,434173
300154596400,30-015-45964,TONY LA RUSSA STATE COM 201H,2020-05-01,10,3738,13145,27008,75597,188204,461181
300154596400,30-015-45964,TONY LA RUSSA STATE COM 201H,2020-06-01,11,3497,12491,25193,79094,200695,486374
300154596400,30-015-45964,TONY LA RUSSA STATE COM 201H,2020-07-01,12,3097,12502,25115,82191,213197,511489
300154596400,30-015-45964,TONY LA RUSSA STATE COM 201H,2020-08-01,13,2895,11943,23452,85086,225140,534941
300154596400,30-015-45964,TONY LA RUSSA STATE COM 201H,2020-09-01,14,2698,11191,22832,87784,236331,557773
300154596400,30-015-45964,TONY LA RUSSA STATE COM 201H,2020-10-01,15,2481,10888,22548,90265,247219,580321
300154596400,30-015-45964,TONY LA RUSSA STATE COM 201H,2020-11-01,16,2354,10094,18778,92619,257313,599099
300154596400,30-015-45964,TONY LA RUSSA STATE COM 201H,2020-12-01,17,2130,8487,12784,94749,265800,611883
300154596400,30-015-45964,TONY LA RUSSA STATE COM 201H,2021-01-01,18,2759,10642,20810,97508,276442,632693
300154596400,30-015-45964,TONY LA RUSSA STATE COM 201H,2021-02-01,19,1882,9121,15560,99390,285563,648253
300154596400,30-015-45964,TONY LA RUSSA STATE COM 201H,2021-03-01,20,2584,12602,20374,101974,298165,668627
300154596400,30-015-45964,TONY LA RUSSA STATE COM 201H,2021-04-01,21,2130,12515,20356,104104,310680,688983
300154596400,30-015-45964,TONY LA RUSSA STATE COM 201H,2021-05-01,22,2211,11229,18359,106315,321909,707342
300154596400,30-015-45964,TONY LA RUSSA STATE COM 201H,2021-06-01,23,1934,11057,17628,108249,332966,724970
300154596400,30-015-45964,TONY LA RUSSA STATE COM 201H,2021-07-01,24,1950,10325,15499,110199,343291,740469
300154596400,30-015-45964,TONY LA RUSSA STATE COM 201H,2021-08-01,25,1897,10727,15663,112096,354018,756132
300154596400,30-015-45964,TONY LA RUSSA STATE COM 201H,2021-09-01,26,1665,9800,14644,113761,363818,770776
300154596400,30-015-45964,TONY LA RUSSA STATE COM 201H,2021-10-01,27,1746,10694,15657,115507,374512,786433
300154596400,30-015-45964,TONY LA RUSSA STATE COM 201H,2021-11-01,28,1614,9065,13894,117121,383577,800327
300154596400,30-015-45964,TONY LA RUSSA STATE COM 201H,2021-12-01,29,1625,8976,14165,118746,392553,814492
300154596400,30-015-45964,TONY LA RUSSA STATE COM 201H,2022-01-01,30,1398,7364,11973,120144,399917,826465
300154596400,30-015-45964,TONY LA RUSSA STATE COM 201H,2022-02-01,31,1362,6978,11489,121506,406895,837954
300154596400,30-015-45964,TONY LA RUSSA STATE COM 201H,2022-03-01,32,1242,6486,10375,122748,413381,848329
300154596400,30-015-45964,TONY LA RUSSA STATE COM 201H,2022-04-01,33,1403,6586,11168,124151,419967,859497
300154596400,30-015-45964,TONY LA RUSSA STATE COM 201H,2022-05-01,34,1472,8026,12310,125623,427993,871807
300154596400,30-015-45964,TONY LA RUSSA STATE COM 201H,2022-06-01,35,931,5967,8924,126554,433960,880731
300154596400,30-015-45964,TONY LA RUSSA STATE COM 201H,2022-07-01,36,350,590,11642,126904,434550,892373
300154596400,30-015-45964,TONY LA RUSSA STATE COM 201H,2022-08-01,37,988,2032,17790,127892,436582,910163
300154596400,30-015-45964,TONY LA RUSSA STATE COM 201H,2022-09-01,38,999,5754,16661,128891,442336,926824
300154596400,30-015-45964,TONY LA RUSSA STATE COM 201H,2022-10-01,39,911,1204,13103,129802,443540,939927
300154596400,30-015-45964,TONY LA RUSSA STATE COM 201H,2022-11-01,40,353,917,7028,130155,444457,946955
300154596400,30-015-45964,TONY LA RUSSA STATE COM 201H,2022-12-01,41,1625,3867,14037,131780,448324,960992
300154596400,30-015-45964,TONY LA RUSSA STATE COM 201H,2023-01-01,42,1838,4529,10914,133618,452853,971906
300154596400,30-015-45964,TONY LA RUSSA STATE COM 201H,2023-02-01,43,1907,6097,15707,135525,458950,987613
300154596400,30-015-45964,TONY LA RUSSA STATE COM 201H,2023-03-01,44,1592,5032,13670,137117,463982,1001283
300154596400,30-015-45964,TONY LA RUSSA STATE COM 201H,2023-04-01,45,1421,3835,11924,138538,467817,1013207
300154596400,30-015-45964,TONY LA RUSSA STATE COM 201H,2023-05-01,46,1242,3517,10790,139780,471334,1023997
300154596400,30-015-45964,TONY LA RUSSA STATE COM 201H,2023-06-01,47,1403,3525,10235,141183,474859,1034232
300152409700,30-015-24097,SMITH 10 COM 001,1982-05-01,1,0,21092,76,0,21092,76
300152409700,30-015-24097,SMITH 10 COM 001,1982-06-01,2,0,32400,89,0,53492,165
300152409700,30-015-24097,SMITH 10 COM 001,1982-07-01,3,0,24943,116,0,78435,281
300152409700,30-015-24097,SMITH 10 COM 001,1982-08-01,4,0,23076,65,0,101511,346
300152409700,30-015-24097,SMITH 10 COM 001,1982-09-01,5,0,19848,69,0,121359,415
300152409700,30-015-24097,SMITH 10 COM 001,1982-10-01,6,0,23235,66,0,144594,481
300152409700,30-015-24097,SMITH 10 COM 001,1982-11-01,7,0,22916,48,0,167510,529
300152409700,30-015-24097,SMITH 10 COM 001,1982-12-01,8,0,11516,24,0,179026,553
300152409700,30-015-24097,SMITH 10 COM 001,1983-01-01,9,0,20307,64,0,199333,617
300152409700,30-015-24097,SMITH 10 COM 001,1983-02-01,10,0,12196,46,0,211529,663
300152409700,30-015-24097,SMITH 10 COM 001,1983-03-01,11,0,18004,61,0,229533,724
300152409700,30-015-24097,SMITH 10 COM 001,1983-04-01,12,0,12950,57,0,242483,781
300152409700,30-015-24097,SMITH 10 COM 001,1983-05-01,13,0,2148,1,0,244631,782
300152409700,30-015-24097,SMITH 10 COM 001,1983-06-01,14,0,1767,0,0,246398,782
300152409700,30-015-24097,SMITH 10 COM 001,1983-07-01,15,0,2133,0,0,248531,782
300152409700,30-015-24097,SMITH 10 COM 001,1983-08-01,16,0,1731,6,0,250262,788
300152409700,30-015-24097,SMITH 10 COM 001,1983-09-01,17,0,1279,6,0,251541,794
300152409700,30-015-24097,SMITH 10 COM 001,1983-10-01,18,0,5616,19,0,257157,813
300152409700,30-015-24097,SMITH 10 COM 001,1983-11-01,19,0,1272,0,0,258429,813
300152409700,30-015-24097,SMITH 10 COM 001,1983-12-01,20,0,2420,19,0,260849,832
300152409700,30-015-24097,SMITH 10 COM 001,1984-01-01,21,0,6539,38,0,267388,870
300152409700,30-015-24097,SMITH 10 COM 001,1984-02-01,22,0,0,0,0,267388,870
300152409700,30-015-24097,SMITH 10 COM 001,1984-03-01,23,0,0,0,0,267388,870
300152409700,30-015-24097,SMITH 10 COM 001,1984-04-01,24,0,30841,73,0,298229,943
300152409700,30-015-24097,SMITH 10 COM 001,1984-05-01,25,0,28711,102,0,326940,1045
300152409700,30-015-24097,SMITH 10 COM 001,1984-06-01,26,0,4934,17,0,331874,1062
300152409700,30-015-24097,SMITH 10 COM 001,1984-07-01,27,0,17505,54,0,349379,1116
300152409700,30-015-24097,SMITH 10 COM 001,1984-08-01,28,0,8333,52,0,357712,1168
300152409700,30-015-24097,SMITH 10 COM 001,1984-09-01,29,0,20789,84,0,378501,1252
300152409700,30-015-24097,SMITH 10 COM 001,1984-10-01,30,0,17841,70,0,396342,1322
300152409700,30-015-24097,SMITH 10 COM 001,1984-11-01,31,0,15967,79,0,412309,1401
300152409700,30-015-24097,SMITH 10 COM 001,1984-12-01,32,0,14130,56,0,426439,1457
300152409700,30-015-24097,SMITH 10 COM 001,1985-01-01,33,0,12940,51,0,439379,1508
300152409700,30-015-24097,SMITH 10 COM 001,1985-02-01,34,0,9458,36,0,448837,1544
300152409700,30-015-24097,SMITH 10 COM 001,1985-03-01,35,0,5898,0,0,454735,1544
300152409700,30-015-24097,SMITH 10 COM 001,1985-04-01,36,0,13700,41,0,468435,1585
300152409700,30-015-24097,SMITH 10 COM 001,1985-05-01,37,0,14247,65,0,482682,1650
300152409700,30-015-24097,SMITH 10 COM 001,1985-06-01,38,0,11897,27,0,494579,1677
300152409700,30-015-24097,SMITH 10 COM 001,1985-07-01,39,0,11387,5,0,505966,1682
300152409700,30-015-24097,SMITH 10 COM 001,1985-08-01,40,0,12189,37,0,518155,1719
300152409700,30-015-24097,SMITH 10 COM 001,1985-09-01,41,0,12998,55,0,531153,1774
300152409700,30-015-24097,SMITH 10 COM 001,1985-10-01,42,0,1170,3,0,532323,1777
300152409700,30-015-24097,SMITH 10 COM 001,1985-11-01,43,0,943,0,0,533266,1777
300152409700,30-015-24097,SMITH 10 COM 001,1985-12-01,44,0,11659,34,0,544925,1811
300152409700,30-015-24097,SMITH 10 COM 001,1986-01-01,45,0,14165,46,0,559090,1857
300152409700,30-015-24097,SMITH 10 COM 001,1986-02-01,46,0,11357,36,0,570447,1893
300152409700,30-015-24097,SMITH 10 COM 001,1986-03-01,47,0,2205,0,0,572652,1893
300152409700,30-015-24097,SMITH 10 COM 001,1986-04-01,48,0,10910,35,0,583562,1928
300152409700,30-015-24097,SMITH 10 COM 001,1986-05-01,49,0,15830,76,0,599392,2004
300152409700,30-015-24097,SMITH 10 COM 001,1986-06-01,50,0,13357,58,0,612749,2062
300152409700,30-015-24097,SMITH 10 COM 001,1986-07-01,51,0,7608,14,0,620357,2076
300152409700,30-015-24097,SMITH 10 COM 001,1986-08-01,52,0,7810,15,0,628167,2091
300152409700,30-015-24097,SMITH 10 COM 001,1986-09-01,53,0,9103,43,0,637270,2134
300152409700,30-015-24097,SMITH 10 COM 001,1986-10-01,54,0,9252,37,0,646522,2171
300152409700,30-015-24097,SMITH 10 COM 001,1986-11-01,55,0,8292,30,0,654814,2201
300152409700,30-015-24097,SMITH 10 COM 001,1986-12-01,56,0,8347,27,0,663161,2228
300152409700,30-015-24097,SMITH 10 COM 001,1987-01-01,57,0,8081,31,0,671242,2259
300152409700,30-015-24097,SMITH 10 COM 001,1987-02-01,58,0,6572,16,0,677814,2275
300152409700,30-015-24097,SMITH 10 COM 001,1987-03-01,59,0,6900,14,0,684714,2289
300152409700,30-015-24097,SMITH 10 COM 001,1987-04-01,60,0,0,0,0,684714,2289
300152409700,30-015-24097,SMITH 10 COM 001,1987-05-01,61,0,0,0,0,684714,2289
300152409700,30-015-24097,SMITH 10 COM 001,1987-06-01,62,0,0,0,0,684714,2289
300152409700,30-015-24097,SMITH 10 COM 001,1987-07-01,63,0,468,0,0,685182,2289
300152409700,30-015-24097,SMITH 10 COM 001,1987-08-01,64,0,19391,74,0,704573,2363
300152409700,30-015-24097,SMITH 10 COM 001,1987-09-01,65,0,3323,1,0,707896,2364
300152409700,30-015-24097,SMITH 10 COM 001,1987-10-01,66,0,0,0,0,707896,2364
300152409700,30-015-24097,SMITH 10 COM 001,1987-11-01,67,0,0,0,0,707896,2364
300152409700,30-015-24097,SMITH 10 COM 001,1987-12-01,68,0,0,0,0,707896,2364
300152409700,30-015-24097,SMITH 10 COM 001,1988-01-01,69,0,0,0,0,707896,2364
300152409700,30-015-24097,SMITH 10 COM 001,1988-02-01,70,0,0,0,0,707896,2364
300152409700,30-015-24097,SMITH 10 COM 001,1988-03-01,71,0,0,0,0,707896,2364
300152409700,30-015-24097,SMITH 10 COM 001,1988-04-01,72,0,0,0,0,707896,2364
300152409700,30-015-24097,SMITH 10 COM 001,1988-05-01,73,0,0,0,0,707896,2364
300152409700,30-015-24097,SMITH 10 COM 001,1988-06-01,74,0,0,0,0,707896,2364
300152409700,30-015-24097,SMITH 10 COM 001,1988-07-01,75,0,0,0,0,707896,2364
300152409700,30-015-24097,SMITH 10 COM 001,1988-08-01,76,0,0,0,0,707896,2364
300152409700,30-015-24097,SMITH 10 COM 001,1988-09-01,77,0,0,0,0,707896,2364
300152409700,30-015-24097,SMITH 10 COM 001,1988-10-01,78,0,0,0,0,707896,2364
300152409700,30-015-24097,SMITH 10 COM 001,1988-11-01,79,0,0,0,0,707896,2364
300152409700,30-015-24097,SMITH 10 COM 001,1988-12-01,80,0,0,0,0,707896,2364
300152409700,30-015-24097,SMITH 10 COM 001,1989-01-01,81,0,0,0,0,707896,2364
300152409700,30-015-24097,SMITH 10 COM 001,1989-02-01,82,0,0,0,0,707896,2364
300152409700,30-015-24097,SMITH 10 COM 001,1989-03-01,83,0,0,0,0,707896,2364
300152409700,30-015-24097,SMITH 10 COM 001,1989-04-01,84,0,20777,114,0,728673,2478
300152409700,30-015-24097,SMITH 10 COM 001,1989-05-01,85,0,8837,28,0,737510,2506
300152409700,30-015-24097,SMITH 10 COM 001,1989-06-01,86,0,5226,4,0,742736,2510
300152409700,30-015-24097,SMITH 10 COM 001,1989-07-01,87,0,5218,6,0,747954,2516
300152409700,30-015-24097,SMITH 10 COM 001,1989-08-01,88,0,4216,0,0,752170,2516
300152409700,30-015-24097,SMITH 10 COM 001,1989-09-01,89,0,3912,0,0,756082,2516
300152409700,30-015-24097,SMITH 10 COM 001,1989-10-01,90,0,4353,3,0,760435,2519
300152409700,30-015-24097,SMITH 10 COM 001,1989-11-01,91,0,3884,15,0,764319,2534
300152409700,30-015-24097,SMITH 10 COM 001,1989-12-01,92,0,2888,9,0,767207,2543
300152409700,30-015-24097,SMITH 10 COM 001,1990-01-01,93,0,3466,6,0,770673,2549
300152409700,30-015-24097,SMITH 10 COM 001,1990-02-01,94,0,2557,3,0,773230,2552
300152409700,30-015-24097,SMITH 10 COM 001,1990-03-01,95,0,3240,0,0,776470,2552
300152409700,30-015-24097,SMITH 10 COM 001,1990-04-01,96,0,5439,31,0,781909,2583
300152409700,30-015-24097,SMITH 10 COM 001,1990-05-01,97,0,2774,0,0,784683,2583
300152409700,30-015-24097,SMITH 10 COM 001,1990-06-01,98,0,4087,0,0,788770,2583
300152409700,30-015-24097,SMITH 10 COM 001,1990-07-01,99,0,2817,0,0,791587,2583
300152409700,30-015-24097,SMITH 10 COM 001,1990-08-01,100,0,1312,0,0,792899,2583
300152409700,30-015-24097,SMITH 10 COM 001,1990-09-01,101,0,5148,0,0,798047,2583
300152409700,30-015-24097,SMITH 10 COM 001,1990-10-01,102,0,5400,0,0,803447,2583
300152409700,30-015-24097,SMITH 10 COM 001,1990-11-01,103,0,0,0,0,803447,2583
300152409700,30-015-24097,SMITH 10 COM 001,1990-12-01,104,0,4318,0,0,807765,2583
300152409700,30-015-24097,SMITH 10 COM 001,1991-01-01,105,0,2834,0,0,810599,2583
300152409700,30-015-24097,SMITH 10 COM 001,1991-02-01,106,0,2970,0,0,813569,2583
300152409700,30-015-24097,SMITH 10 COM 001,1991-03-01,107,0,3532,6,0,817101,2589
300152409700,30-015-24097,SMITH 10 COM 001,1991-04-01,108,0,3040,0,0,820141,2589
300152409700,30-015-24097,SMITH 10 COM 001,1991-05-01,109,0,2582,0,0,822723,2589
300152409700,30-015-24097,SMITH 10 COM 001,1991-06-01,110,0,2665,0,0,825388,2589
300152409700,30-015-24097,SMITH 10 COM 001,1991-07-01,111,0,3113,0,0,828501,2589
300152409700,30-015-24097,SMITH 10 COM 001,1991-08-01,112,0,2667,0,0,831168,2589
300152409700,30-015-24097,SMITH 10 COM 001,1991-09-01,113,0,3298,0,0,834466,2589
300152409700,30-015-24097,SMITH 10 COM 001,1991-10-01,114,0,3011,0,0,837477,2589
300152409700,30-015-24097,SMITH 10 COM 001,1991-11-01,115,0,2208,0,0,839685,2589
300152409700,30-015-24097,SMITH 10 COM 001,1991-12-01,116,0,1818,0,0,841503,2589
300152409700,30-015-24097,SMITH 10 COM 001,1992-01-01,117,0,2080,0,0,843583,2589
300152409700,30-015-24097,SMITH 10 COM 001,1992-02-01,118,0,2287,0,0,845870,2589
300152409700,30-015-24097,SMITH 10 COM 001,1992-03-01,119,0,2243,0,0,848113,2589
300152409700,30-015-24097,SMITH 10 COM 001,1992-04-01,120,0,2989,0,0,851102,2589
300152409700,30-015-24097,SMITH 10 COM 001,1992-05-01,121,0,3231,0,0,854333,2589
300152409700,30-015-24097,SMITH 10 COM 001,1992-06-01,122,0,1948,0,0,856281,2589
300152409700,30-015-24097,SMITH 10 COM 001,1992-07-01,123,0,3186,0,0,859467,2589
300152409700,30-015-24097,SMITH 10 COM 001,1992-08-01,124,0,2798,0,0,862265,2589
300152409700,30-015-24097,SMITH 10 COM 001,1992-09-01,125,0,2686,0,0,864951,2589
300152409700,30-015-24097,SMITH 10 COM 001,1992-10-01,126,0,2581,0,0,867532,2589
300152409700,30-015-24097,SMITH 10 COM 001,1992-11-01,127,0,2299,0,0,869831,2589
300152409700,30-015-24097,SMITH 10 COM 001,1992-12-01,128,0,2786,0,0,872617,2589
300152409700,30-015-24097,SMITH 10 COM 001,1993-01-01,129,0,2402,0,0,875019,2589
300152409700,30-015-24097,SMITH 10 COM 001,1993-02-01,130,0,2328,0,0,877347,2589
300152409700,30-015-24097,SMITH 10 COM 001,1993-03-01,131,0,2868,0,0,880215,2589
300152409700,30-015-24097,SMITH 10 COM 001,1993-04-01,132,0,2478,0,0,882693,2589
300152409700,30-015-24097,SMITH 10 COM 001,1993-05-01,133,0,2318,0,0,885011,2589
300152409700,30-015-24097,SMITH 10 COM 001,1993-06-01,134,0,2359,0,0,887370,2589
300152409700,30-015-24097,SMITH 10 COM 001,1993-07-01,135,0,2791,0,0,890161,2589
300152409700,30-015-24097,SMITH 10 COM 001,1993-08-01,136,0,2591,0,0,892752,2589
300152409700,30-015-24097,SMITH 10 COM 001,1993-09-01,137,0,1903,0,0,894655,2589
300152409700,30-015-24097,SMITH 10 COM 001,1993-10-01,138,0,2382,0,0,897037,2589
300152409700,30-015-24097,SMITH 10 COM 001,1993-11-01,139,0,2159,0,0,899196,2589
300152409700,30-015-24097,SMITH 10 COM 001,1993-12-01,140,0,2159,0,0,901355,2589
300152409700,30-015-24097,SMITH 10 COM 001,1994-01-01,141,0,2270,0,0,903625,2589
300152409700,30-015-24097,SMITH 10 COM 001,1994-02-01,142,0,2617,44,0,906242,2633
300152409700,30-015-24097,SMITH 10 COM 001,1994-03-01,143,0,3437,56,0,909679,2689
300152409700,30-015-24097,SMITH 10 COM 001,1994-04-01,144,0,1700,26,0,911379,2715
300152409700,30-015-24097,SMITH 10 COM 001,1994-05-01,145,0,3951,45,0,915330,2760
300152409700,30-015-24097,SMITH 10 COM 001,1994-06-01,146,0,3545,18,0,918875,2778
300152409700,30-015-24097,SMITH 10 COM 001,1994-07-01,147,0,3619,21,0,922494,2799
300152409700,30-015-24097,SMITH 10 COM 001,1994-08-01,148,0,2932,3,0,925426,2802
300152409700,30-015-24097,SMITH 10 COM 001,1994-09-01,149,0,0,0,0,925426,2802
300152409700,30-015-24097,SMITH 10 COM 001,1994-10-01,150,0,2378,3,0,927804,2805
300152409700,30-015-24097,SMITH 10 COM 001,1994-11-01,151,0,1773,0,0,929577,2805
300152409700,30-015-24097,SMITH 10 COM 001,1994-12-01,152,0,2078,0,0,931655,2805
300152409700,30-015-24097,SMITH 10 COM 001,1995-01-01,153,0,1375,0,0,933030,2805
300152409700,30-015-24097,SMITH 10 COM 001,1995-02-01,154,0,1451,0,0,934481,2805
300152409700,30-015-24097,SMITH 10 COM 001,1995-03-01,155,0,1890,0,0,936371,2805
300152409700,30-015-24097,SMITH 10 COM 001,1995-04-01,156,0,2020,0,0,938391,2805
300152409700,30-015-24097,SMITH 10 COM 001,1995-05-01,157,0,1704,0,0,940095,2805
300152409700,30-015-24097,SMITH 10 COM 001,1995-06-01,158,0,2179,0,0,942274,2805
300152409700,30-015-24097,SMITH 10 COM 001,1995-07-01,159,0,1469,0,0,943743,2805
300152409700,30-015-24097,SMITH 10 COM 001,1995-08-01,160,0,1978,20,0,945721,2825
300152409700,30-015-24097,SMITH 10 COM 001,1995-09-01,161,0,1674,20,0,947395,2845
300152409700,30-015-24097,SMITH 10 COM 001,1995-10-01,162,0,2408,18,0,949803,2863
300152409700,30-015-24097,SMITH 10 COM 001,1995-11-01,163,0,2176,18,0,951979,2881
300152409700,30-015-24097,SMITH 10 COM 001,1995-12-01,164,0,0,0,0,951979,2881
300152409700,30-015-24097,SMITH 10 COM 001,1996-01-01,165,0,2198,0,0,954177,2881
300152409700,30-015-24097,SMITH 10 COM 001,1996-02-01,166,0,1916,0,0,956093,2881
300152409700,30-015-24097,SMITH 10 COM 001,1996-03-01,167,0,3429,81,0,959522,2962
300152409700,30-015-24097,SMITH 10 COM 001,1996-04-01,168,0,1672,29,0,961194,2991
300152409700,30-015-24097,SMITH 10 COM 001,1996-05-01,169,0,1672,29,0,962866,3020
300152409700,30-015-24097,SMITH 10 COM 001,1996-06-01,170,0,2117,6,0,964983,3026
300152409700,30-015-24097,SMITH 10 COM 001,1996-07-01,171,0,2099,0,0,967082,3026
300152409700,30-015-24097,SMITH 10 COM 001,1996-08-01,172,0,2223,0,0,969305,3026
300152409700,30-015-24097,SMITH 10 COM 001,1996-09-01,173,0,2499,4,0,971804,3030
300152409700,30-015-24097,SMITH 10 COM 001,1996-10-01,174,0,1807,6,0,973611,3036
300152409700,30-015-24097,SMITH 10 COM 001,1996-11-01,175,0,65,0,0,973676,3036
300152409700,30-015-24097,SMITH 10 COM 001,1996-12-01,176,0,1616,0,0,975292,3036
300152409700,30-015-24097,SMITH 10 COM 001,1997-01-01,177,0,1764,0,0,977056,3036
300152409700,30-015-24097,SMITH 10 COM 001,1997-02-01,178,0,1884,0,0,978940,3036
300152409700,30-015-24097,SMITH 10 COM 001,1997-03-01,179,18,3158,0,18,982098,3036
300152409700,30-015-24097,SMITH 10 COM 001,1997-04-01,180,5,1456,0,23,983554,3036
300152409700,30-015-24097,SMITH 10 COM 001,1997-05-01,181,7,1412,0,30,984966,3036
300152409700,30-015-24097,SMITH 10 COM 001,1997-06-01,182,0,2181,0,30,987147,3036
300152409700,30-015-24097,SMITH 10 COM 001,1997-07-01,183,0,1220,0,30,988367,3036
300152409700,30-015-24097,SMITH 10 COM 001,1997-08-01,184,0,1672,0,30,990039,3036
300152409700,30-015-24097,SMITH 10 COM 001,1997-09-01,185,0,2145,0,30,992184,3036
300152409700,30-015-24097,SMITH 10 COM 001,1997-10-01,186,0,1619,0,30,993803,3036
300152409700,30-015-24097,SMITH 10 COM 001,1997-11-01,187,0,2072,0,30,995875,3036
300152409700,30-015-24097,SMITH 10 COM 001,1997-12-01,188,0,2090,0,30,997965,3036
300152409700,30-015-24097,SMITH 10 COM 001,1998-01-01,189,0,0,0,30,997965,3036
300152409700,30-015-24097,SMITH 10 COM 001,1998-02-01,190,0,610,0,30,998575,3036
300152409700,30-015-24097,SMITH 10 COM 001,1998-03-01,191,0,2240,0,30,1000815,3036
300152409700,30-015-24097,SMITH 10 COM 001,1998-04-01,192,0,696,0,30,1001511,3036
300152409700,30-015-24097,SMITH 10 COM 001,1998-05-01,193,0,491,0,30,1002002,3036
300152409700,30-015-24097,SMITH 10 COM 001,1998-06-01,194,0,27,0,30,1002029,3036
300152409700,30-015-24097,SMITH 10 COM 001,1998-07-01,195,0,1371,0,30,1003400,3036
300152409700,30-015-24097,SMITH 10 COM 001,1998-08-01,196,0,895,0,30,1004295,3036
300152409700,30-015-24097,SMITH 10 COM 001,1998-09-01,197,0,1374,0,30,1005669,3036
300152409700,30-015-24097,SMITH 10 COM 001,1998-10-01,198,0,1253,0,30,1006922,3036
300152409700,30-015-24097,SMITH 10 COM 001,1998-11-01,199,0,1455,0,30,1008377,3036
300152409700,30-015-24097,SMITH 10 COM 001,1998-12-01,200,0,0,0,30,1008377,3036
300152409700,30-015-24097,SMITH 10 COM 001,1999-01-01,201,0,1345,0,30,1009722,3036
300152409700,30-015-24097,SMITH 10 COM 001,1999-02-01,202,0,910,0,30,1010632,3036
300152409700,30-015-24097,SMITH 10 COM 001,1999-03-01,203,0,1546,0,30,1012178,3036
300152409700,30-015-24097,SMITH 10 COM 001,1999-04-01,204,0,1148,0,30,1013326,3036
300152409700,30-015-24097,SMITH 10 COM 001,1999-05-01,205,0,1138,0,30,1014464,3036
300152409700,30-015-24097,SMITH 10 COM 001,1999-06-01,206,0,960,0,30,1015424,3036
300152409700,30-015-24097,SMITH 10 COM 001,1999-07-01,207,0,1332,0,30,1016756,3036
300152409700,30-015-24097,SMITH 10 COM 001,1999-08-01,208,0,757,0,30,1017513,3036
300152409700,30-015-24097,SMITH 10 COM 001,1999-09-01,209,0,187,0,30,1017700,3036
300152409700,30-015-24097,SMITH 10 COM 001,1999-10-01,210,0,205,0,30,1017905,3036
300152409700,30-015-24097,SMITH 10 COM 001,1999-11-01,211,0,1441,0,30,1019346,3036
300152409700,30-015-24097,SMITH 10 COM 001,1999-12-01,212,0,2011,0,30,1021357,3036
300152409700,30-015-24097,SMITH 10 COM 001,2000-01-01,213,0,1404,0,30,1022761,3036
300152409700,30-015-24097,SMITH 10 COM 001,2000-02-01,214,0,1343,0,30,1024104,3036
300152409700,30-015-24097,SMITH 10 COM 001,2000-03-01,215,0,1538,0,30,1025642,3036
300152409700,30-015-24097,SMITH 10 COM 001,2000-04-01,216,0,1042,0,30,1026684,3036
300152409700,30-015-24097,SMITH 10 COM 001,2000-05-01,217,0,396,0,30,1027080,3036
300152409700,30-015-24097,SMITH 10 COM 001,2000-06-01,218,0,1463,0,30,1028543,3036
300152409700,30-015-24097,SMITH 10 COM 001,2000-07-01,219,0,1717,0,30,1030260,3036
300152409700,30-015-24097,SMITH 10 COM 001,2000-08-01,220,0,426,0,30,1030686,3036
300152409700,30-015-24097,SMITH 10 COM 001,2000-09-01,221,0,2680,6,30,1033366,3042
300152409700,30-015-24097,SMITH 10 COM 001,2000-10-01,222,0,3717,154,30,1037083,3196
300152409700,30-015-24097,SMITH 10 COM 001,2000-11-01,223,0,2552,81,30,1039635,3277
300152409700,30-015-24097,SMITH 10 COM 001,2000-12-01,224,0,2426,19,30,1042061,3296
300152409700,30-015-24097,SMITH 10 COM 001,2001-01-01,225,0,3800,121,30,1045861,3417
300152409700,30-015-24097,SMITH 10 COM 001,2001-02-01,226,0,3112,35,30,1048973,3452
300152409700,30-015-24097,SMITH 10 COM 001,2001-03-01,227,0,6507,0,30,1055480,3452
300152409700,30-015-24097,SMITH 10 COM 001,2001-04-01,228,0,2916,0,30,1058396,3452
300152409700,30-015-24097,SMITH 10 COM 001,2001-05-01,229,0,2051,0,30,1060447,3452
300152409700,30-015-24097,SMITH 10 COM 001,2001-06-01,230,0,1871,27,30,1062318,3479
300152409700,30-015-24097,SMITH 10 COM 001,2001-07-01,231,0,1609,0,30,1063927,3479
300152409700,30-015-24097,SMITH 10 COM 001,2001-08-01,232,0,3548,0,30,1067475,3479
300152409700,30-015-24097,SMITH 10 COM 001,2001-09-01,233,0,1576,0,30,1069051,3479
300152409700,30-015-24097,SMITH 10 COM 001,2001-10-01,234,0,3187,34,30,1072238,3513
300152409700,30-015-24097,SMITH 10 COM 001,2001-11-01,235,80,1430,3,110,1073668,3516
300152409700,30-015-24097,SMITH 10 COM 001,2001-12-01,236,85,1104,14,195,1074772,3530
300152409700,30-015-24097,SMITH 10 COM 001,2002-01-01,237,0,962,0,195,1075734,3530
300152409700,30-015-24097,SMITH 10 COM 001,2002-02-01,238,0,3278,6,195,1079012,3536
300152409700,30-015-24097,SMITH 10 COM 001,2002-03-01,239,0,3673,12,195,1082685,3548
300152409700,30-015-24097,SMITH 10 COM 001,2002-04-01,240,0,1012,30,195,1083697,3578
300152409700,30-015-24097,SMITH 10 COM 001,2002-05-01,241,0,1266,20,195,1084963,3598
300152409700,30-015-24097,SMITH 10 COM 001,2002-06-01,242,0,2304,42,195,1087267,3640
300152409700,30-015-24097,SMITH 10 COM 001,2002-07-01,243,0,2091,35,195,1089358,3675
300152409700,30-015-24097,SMITH 10 COM 001,2002-08-01,244,0,1162,20,195,1090520,3695
300152409700,30-015-24097,SMITH 10 COM 001,2002-09-01,245,0,2027,9,195,1092547,3704
300152409700,30-015-24097,SMITH 10 COM 001,2002-10-01,246,0,2179,14,195,1094726,3718
300152409700,30-015-24097,SMITH 10 COM 001,2002-11-01,247,0,2141,10,195,1096867,3728
300152409700,30-015-24097,SMITH 10 COM 001,2002-12-01,248,0,1826,6,195,1098693,3734
300152409700,30-015-24097,SMITH 10 COM 001,2003-01-01,249,0,2151,34,195,1100844,3768
300152409700,30-015-24097,SMITH 10 COM 001,2003-02-01,250,0,2501,8,195,1103345,3776
300152409700,30-015-24097,SMITH 10 COM 001,2003-03-01,251,0,2500,12,195,1105845,3788
300152409700,30-015-24097,SMITH 10 COM 001,2003-04-01,252,0,45,6,195,1105890,3794
300152409700,30-015-24097,SMITH 10 COM 001,2003-05-01,253,0,834,9,195,1106724,3803
300152409700,30-015-24097,SMITH 10 COM 001,2003-06-01,254,0,3674,20,195,1110398,3823
300152409700,30-015-24097,SMITH 10 COM 001,2003-07-01,255,97,4492,6,292,1114890,3829
300152409700,30-015-24097,SMITH 10 COM 001,2003-08-01,256,0,2675,0,292,1117565,3829
300152409700,30-015-24097,SMITH 10 COM 001,2003-09-01,257,0,1888,0,292,1119453,3829
300152409700,30-015-24097,SMITH 10 COM 001,2003-10-01,258,0,268,12,292,1119721,3841
300152409700,30-015-24097,SMITH 10 COM 001,2003-11-01,259,0,3330,22,292,1123051,3863
300152409700,30-015-24097,SMITH 10 COM 001,2003-12-01,260,0,3620,0,292,1126671,3863
300152409700,30-015-24097,SMITH 10 COM 001,2004-01-01,261,0,2860,15,292,1129531,3878
300152409700,30-015-24097,SMITH 10 COM 001,2004-02-01,262,0,1670,50,292,1131201,3928
300152409700,30-015-24097,SMITH 10 COM 001,2004-03-01,263,0,2784,33,292,1133985,3961
300152409700,30-015-24097,SMITH 10 COM 001,2004-04-01,264,0,5,0,292,1133990,3961
300152409700,30-015-24097,SMITH 10 COM 001,2004-05-01,265,0,3371,17,292,1137361,3978
300152409700,30-015-24097,SMITH 10 COM 001,2004-06-01,266,0,2128,27,292,1139489,4005
300152409700,30-015-24097,SMITH 10 COM 001,2004-07-01,267,0,1696,16,292,1141185,4021
300152409700,30-015-24097,SMITH 10 COM 001,2004-08-01,268,0,2211,21,292,1143396,4042
300152409700,30-015-24097,SMITH 10 COM 001,2004-09-01,269,0,793,7,292,1144189,4049
300152409700,30-015-24097,SMITH 10 COM 001,2004-10-01,270,0,428,9,292,1144617,4058
300152409700,30-015-24097,SMITH 10 COM 001,2004-11-01,271,0,784,12,292,1145401,4070
300152409700,30-015-24097,SMITH 10 COM 001,2004-12-01,272,0,1018,24,292,1146419,4094
300152409700,30-015-24097,SMITH 10 COM 001,2005-01-01,273,0,857,39,292,1147276,4133
300152409700,30-015-24097,SMITH 10 COM 001,2005-02-01,274,0,1931,57,292,1149207,4190
300152409700,30-015-24097,SMITH 10 COM 001,2005-03-01,275,0,653,22,292,1149860,4212
300152409700,30-015-24097,SMITH 10 COM 001,2005-04-01,276,0,1284,18,292,1151144,4230
300152409700,30-015-24097,SMITH 10 COM 001,2005-05-01,277,0,1128,33,292,1152272,4263
300152409700,30-015-24097,SMITH 10 COM 001,2005-06-01,278,0,1543,9,292,1153815,4272
300152409700,30-015-24097,SMITH 10 COM 001,2005-07-01,279,0,245,0,292,1154060,4272
300152409700,30-015-24097,SMITH 10 COM 001,2005-08-01,280,0,362,0,292,1154422,4272
300152409700,30-015-24097,SMITH 10 COM 001,2005-09-01,281,0,1062,0,292,1155484,4272
300152409700,30-015-24097,SMITH 10 COM 001,2005-10-01,282,195,804,0,487,1156288,4272
300152409700,30-015-24097,SMITH 10 COM 001,2005-11-01,283,0,1710,0,487,1157998,4272
300152409700,30-015-24097,SMITH 10 COM 001,2005-12-01,284,0,412,0,487,1158410,4272
300152409700,30-015-24097,SMITH 10 COM 001,2006-01-01,285,0,1050,18,487,1159460,4290
300152409700,30-015-24097,SMITH 10 COM 001,2006-02-01,286,0,1610,18,487,1161070,4308
300152409700,30-015-24097,SMITH 10 COM 001,2006-03-01,287,0,698,3,487,1161768,4311
300152409700,30-015-24097,SMITH 10 COM 001,2006-04-01,288,0,532,0,487,1162300,4311
300152409700,30-015-24097,SMITH 10 COM 001,2006-05-01,289,0,1130,15,487,1163430,4326
300152409700,30-015-24097,SMITH 10 COM 001,2006-06-01,290,0,769,0,487,1164199,4326
300152409700,30-015-24097,SMITH 10 COM 001,2006-07-01,291,0,1082,26,487,1165281,4352
300152409700,30-015-24097,SMITH 10 COM 001,2006-08-01,292,0,1287,20,487,1166568,4372
300152409700,30-015-24097,SMITH 10 COM 001,2006-09-01,293,0,639,3,487,1167207,4375
300152409700,30-015-24097,SMITH 10 COM 001,2006-10-01,294,0,854,20,487,1168061,4395
300152409700,30-015-24097,SMITH 10 COM 001,2006-11-01,295,3,768,0,490,1168829,4395
300152409700,30-015-24097,SMITH 10 COM 001,2006-12-01,296,6,788,12,496,1169617,4407
300152409700,30-015-24097,SMITH 10 COM 001,2007-01-01,297,0,759,20,496,1170376,4427
300152409700,30-015-24097,SMITH 10 COM 001,2007-02-01,298,0,548,9,496,1170924,4436
300152409700,30-015-24097,SMITH 10 COM 001,2007-03-01,299,9,560,26,505,1171484,4462
300152409700,30-015-24097,SMITH 10 COM 001,2007-04-01,300,0,624,20,505,1172108,4482
300152409700,30-015-24097,SMITH 10 COM 001,2007-05-01,301,0,957,9,505,1173065,4491
300152409700,30-015-24097,SMITH 10 COM 001,2007-06-01,302,0,667,0,505,1173732,4491
300152409700,30-015-24097,SMITH 10 COM 001,2007-07-01,303,121,408,17,626,1174140,4508
300152409700,30-015-24097,SMITH 10 COM 001,2007-08-01,304,0,424,2,626,1174564,4510
300152409700,30-015-24097,SMITH 10 COM 001,2007-09-01,305,0,366,8,626,1174930,4518
300152409700,30-015-24097,SMITH 10 COM 001,2007-10-01,306,0,472,0,626,1175402,4518
300152409700,30-015-24097,SMITH 10 COM 001,2007-11-01,307,0,888,0,626,1176290,4518
300152409700,30-015-24097,SMITH 10 COM 001,2007-12-01,308,0,635,0,626,1176925,4518
300152409700,30-015-24097,SMITH 10 COM 001,2008-01-01,309,0,379,0,626,1177304,4518
300152409700,30-015-24097,SMITH 10 COM 001,2008-02-01,310,0,475,0,626,1177779,4518
300152409700,30-015-24097,SMITH 10 COM 001,2008-03-01,311,0,202,0,626,1177981,4518
300152409700,30-015-24097,SMITH 10 COM 001,2008-04-01,312,0,405,0,626,1178386,4518
300152409700,30-015-24097,SMITH 10 COM 001,2008-05-01,313,0,2339,8,626,1180725,4526
300152409700,30-015-24097,SMITH 10 COM 001,2008-06-01,314,0,1223,44,626,1181948,4570
300152409700,30-015-24097,SMITH 10 COM 001,2008-07-01,315,0,837,11,626,1182785,4581
300152409700,30-015-24097,SMITH 10 COM 001,2008-08-01,316,0,997,0,626,1183782,4581
300152409700,30-015-24097,SMITH 10 COM 001,2008-09-01,317,0,545,0,626,1184327,4581
300152409700,30-015-24097,SMITH 10 COM 001,2008-10-01,318,0,811,0,626,1185138,4581
300152409700,30-015-24097,SMITH 10 COM 001,2008-11-01,319,0,755,0,626,1185893,4581
300152409700,30-015-24097,SMITH 10 COM 001,2008-12-01,320,0,643,30,626,1186536,4611
300152409700,30-015-24097,SMITH 10 COM 001,2009-01-01,321,0,588,14,626,1187124,4625
300152409700,30-015-24097,SMITH 10 COM 001,2009-02-01,322,0,594,0,626,1187718,4625
300152409700,30-015-24097,SMITH 10 COM 001,2009-03-01,323,0,702,22,626,1188420,4647
300152409700,30-015-24097,SMITH 10 COM 001,2009-04-01,324,0,540,5,626,1188960,4652
300152409700,30-015-24097,SMITH 10 COM 001,2009-05-01,325,0,540,11,626,1189500,4663
300152409700,30-015-24097,SMITH 10 COM 001,2009-06-01,326,0,587,8,626,1190087,4671
300152409700,30-015-24097,SMITH 10 COM 001,2009-07-01,327,0,631,0,626,1190718,4671
300152409700,30-015-24097,SMITH 10 COM 001,2009-08-01,328,0,299,5,626,1191017,4676
300152409700,30-015-24097,SMITH 10 COM 001,2009-09-01,329,0,295,8,626,1191312,4684
300152409700,30-015-24097,SMITH 10 COM 001,2009-10-01,330,0,717,28,626,1192029,4712
300152409700,30-015-24097,SMITH 10 COM 001,2009-11-01,331,0,269,6,626,1192298,4718
300152409700,30-015-24097,SMITH 10 COM 001,2009-12-01,332,0,809,25,626,1193107,4743
300152409700,30-015-24097,SMITH 10 COM 001,2010-01-01,333,0,574,11,626,1193681,4754
300152409700,30-015-24097,SMITH 10 COM 001,2010-02-01,334,0,301,14,626,1193982,4768
300152409700,30-015-24097,SMITH 10 COM 001,2010-03-01,335,0,22,0,626,1194004,4768
300152409700,30-015-24097,SMITH 10 COM 001,2010-04-01,336,0,1100,30,626,1195104,4798
300152409700,30-015-24097,SMITH 10 COM 001,2010-05-01,337,0,384,0,626,1195488,4798
300152409700,30-015-24097,SMITH 10 COM 001,2010-06-01,338,0,663,28,626,1196151,4826
300152409700,30-015-24097,SMITH 10 COM 001,2010-07-01,339,0,607,24,626,1196758,4850
300152409700,30-015-24097,SMITH 10 COM 001,2010-08-01,340,0,323,8,626,1197081,4858
300152409700,30-015-24097,SMITH 10 COM 001,2010-09-01,341,0,325,8,626,1197406,4866
300152409700,30-015-24097,SMITH 10 COM 001,2010-10-01,342,0,309,8,626,1197715,4874
300152409700,30-015-24097,SMITH 10 COM 001,2010-11-01,343,0,129,6,626,1197844,4880
300152409700,30-015-24097,SMITH 10 COM 001,2010-12-01,344,0,220,22,626,1198064,4902
300152409700,30-015-24097,SMITH 10 COM 001,2011-01-01,345,0,191,8,626,1198255,4910
300152409700,30-015-24097,SMITH 10 COM 001,2011-02-01,346,0,129,14,626,1198384,4924
300152409700,30-015-24097,SMITH 10 COM 001,2011-03-01,347,0,15,0,626,1198399,4924
300152409700,30-015-24097,SMITH 10 COM 001,2011-04-01,348,0,19,0,626,1198418,4924
300152409700,30-015-24097,SMITH 10 COM 001,2011-05-01,349,0,50,0,626,1198468,4924
300152409700,30-015-24097,SMITH 10 COM 001,2011-06-01,350,0,103,11,626,1198571,4935
300152409700,30-015-24097,SMITH 10 COM 001,2011-07-01,351,0,294,0,626,1198865,4935
300152409700,30-015-24097,SMITH 10 COM 001,2011-08-01,352,0,571,28,626,1199436,4963
300152409700,30-015-24097,SMITH 10 COM 001,2011-09-01,353,0,483,17,626,1199919,4980
300152409700,30-015-24097,SMITH 10 COM 001,2011-10-01,354,0,246,14,626,1200165,4994
300152409700,30-015-24097,SMITH 10 COM 001,2011-11-01,355,0,545,0,626,1200710,4994
300152409700,30-015-24097,SMITH 10 COM 001,2011-12-01,356,0,144,0,626,1200854,4994
300152409700,30-015-24097,SMITH 10 COM 001,2012-01-01,357,0,246,14,626,1201100,5008
300152409700,30-015-24097,SMITH 10 COM 001,2012-02-01,358,0,327,19,626,1201427,5027
300152409700,30-015-24097,SMITH 10 COM 001,2012-03-01,359,0,153,19,626,1201580,5046
300152409700,30-015-24097,SMITH 10 COM 001,2012-04-01,360,0,83,110,626,1201663,5156
300152409700,30-015-24097,SMITH 10 COM 001,2012-05-01,361,0,150,13,626,1201813,5169
300152409700,30-015-24097,SMITH 10 COM 001,2012-06-01,362,0,164,12,626,1201977,5181
300152409700,30-015-24097,SMITH 10 COM 001,2012-07-01,363,0,169,0,626,1202146,5181
300152409700,30-015-24097,SMITH 10 COM 001,2012-08-01,364,0,227,0,626,1202373,5181
300152409700,30-015-24097,SMITH 10 COM 001,2012-09-01,365,0,81,0,626,1202454,5181
300152409700,30-015-24097,SMITH 10 COM 001,2012-10-01,366,0,32,0,626,1202486,5181
300152409700,30-015-24097,SMITH 10 COM 001,2012-11-01,367,0,194,0,626,1202680,5181
300152409700,30-015-24097,SMITH 10 COM 001,2012-12-01,368,0,130,0,626,1202810,5181
300152409700,30-015-24097,SMITH 10 COM 001,2013-01-01,369,0,172,0,626,1202982,5181
300152409700,30-015-24097,SMITH 10 COM 001,2013-02-01,370,0,54,0,626,1203036,5181
300152409700,30-015-24097,SMITH 10 COM 001,2013-03-01,371,0,74,0,626,1203110,5181
300152409700,30-015-24097,SMITH 10 COM 001,2013-04-01,372,0,207,0,626,1203317,5181
300152409700,30-015-24097,SMITH 10 COM 001,2013-05-01,373,0,344,0,626,1203661,5181
300152409700,30-015-24097,SMITH 10 COM 001,2013-06-01,374,0,485,0,626,1204146,5181
300152409700,30-015-24097,SMITH 10 COM 001,2013-07-01,375,9,464,0,635,1204610,5181
300152409700,30-015-24097,SMITH 10 COM 001,2013-08-01,376,4,504,0,639,1205114,5181
300152409700,30-015-24097,SMITH 10 COM 001,2013-09-01,377,0,361,0,639,1205475,5181
300152409700,30-015-24097,SMITH 10 COM 001,2013-10-01,378,7,242,0,646,1205717,5181
300152409700,30-015-24097,SMITH 10 COM 001,2013-11-01,379,0,192,0,646,1205909,5181
300152409700,30-015-24097,SMITH 10 COM 001,2013-12-01,380,0,280,0,646,1206189,5181
300152409700,30-015-24097,SMITH 10 COM 001,2014-01-01,381,2,135,0,648,1206324,5181
300152409700,30-015-24097,SMITH 10 COM 001,2014-02-01,382,6,172,0,654,1206496,5181
300152409700,30-015-24097,SMITH 10 COM 001,2014-03-01,383,0,120,0,654,1206616,5181
300152409700,30-015-24097,SMITH 10 COM 001,2014-04-01,384,3,188,248,657,1206804,5429
300152409700,30-015-24097,SMITH 10 COM 001,2014-05-01,385,5,1113,149,662,1207917,5578
300152409700,30-015-24097,SMITH 10 COM 001,2014-06-01,386,0,699,168,662,1208616,5746
300152409700,30-015-24097,SMITH 10 COM 001,2014-07-01,387,0,916,171,662,1209532,5917
300152409700,30-015-24097,SMITH 10 COM 001,2014-08-01,388,0,433,184,662,1209965,6101
300152409700,30-015-24097,SMITH 10 COM 001,2014-09-01,389,0,378,184,662,1210343,6285
300152409700,30-015-24097,SMITH 10 COM 001,2014-10-01,390,0,663,0,662,1211006,6285
300152409700,30-015-24097,SMITH 10 COM 001,2014-11-01,391,0,729,195,662,1211735,6480
300152409700,30-015-24097,SMITH 10 COM 001,2014-12-01,392,23,789,19,685,1212524,6499
300152409700,30-015-24097,SMITH 10 COM 001,2015-01-01,393,0,332,0,685,1212856,6499
300152409700,30-015-24097,SMITH 10 COM 001,2015-02-01,394,0,125,0,685,1212981,6499
300152409700,30-015-24097,SMITH 10 COM 001,2015-03-01,395,0,0,0,685,1212981,6499
300152409700,30-015-24097,SMITH 10 COM 001,2015-04-01,396,0,0,0,685,1212981,6499
300152409700,30-015-24097,SMITH 10 COM 001,2015-05-01,397,0,0,0,685,1212981,6499
300152409700,30-015-24097,SMITH 10 COM 001,2015-06-01,398,0,0,0,685,1212981,6499
300152409700,30-015-24097,SMITH 10 COM 001,2015-07-01,399,0,0,0,685,1212981,6499
300152409700,30-015-24097,SMITH 10 COM 001,2015-08-01,400,0,0,0,685,1212981,6499
300152409700,30-015-24097,SMITH 10 COM 001,2015-09-01,401,0,0,0,685,1212981,6499
300152409700,30-015-24097,SMITH 10 COM 001,2015-10-01,402,0,0,0,685,1212981,6499
300152409700,30-015-24097,SMITH 10 COM 001,2015-11-01,403,0,83,0,685,1213064,6499
300152409700,30-015-24097,SMITH 10 COM 001,2015-12-01,404,0,0,0,685,1213064,6499
300152409700,30-015-24097,SMITH 10 COM 001,2016-01-01,405,0,0,0,685,1213064,6499
300152409700,30-015-24097,SMITH 10 COM 001,2016-02-01,406,0,37,0,685,1213101,6499
300152409700,30-015-24097,SMITH 10 COM 001,2016-03-01,407,0,36,0,685,1213137,6499
300152409700,30-015-24097,SMITH 10 COM 001,2016-04-01,408,0,30,0,685,1213167,6499
300152409700,30-015-24097,SMITH 10 COM 001,2016-05-01,409,0,19,0,685,1213186,6499
300152409700,30-015-24097,SMITH 10 COM 001,2016-06-01,410,0,22,0,685,1213208,6499
300152409700,30-015-24097,SMITH 10 COM 001,2016-07-01,411,0,47,0,685,1213255,6499
300152409700,30-015-24097,SMITH 10 COM 001,2016-08-01,412,0,29,71,685,1213284,6570
300152409700,30-015-24097,SMITH 10 COM 001,2016-09-01,413,0,10,3,685,1213294,6573
300152409700,30-015-24097,SMITH 10 COM 001,2016-10-01,414,0,36,0,685,1213330,6573
300152409700,30-015-24097,SMITH 10 COM 001,2016-11-01,415,0,16,0,685,1213346,6573
300152409700,30-015-24097,SMITH 10 COM 001,2016-12-01,416,0,11,0,685,1213357,6573
300152409700,30-015-24097,SMITH 10 COM 001,2017-01-01,417,0,42,0,685,1213399,6573
300152409700,30-015-24097,SMITH 10 COM 001,2017-02-01,418,0,32,0,685,1213431,6573
300152409700,30-015-24097,SMITH 10 COM 001,2017-03-01,419,0,17,0,685,1213448,6573
300152409700,30-015-24097,SMITH 10 COM 001,2017-04-01,420,0,24,0,685,1213472,6573
300152409700,30-015-24097,SMITH 10 COM 001,2017-05-01,421,0,24,0,685,1213496,6573
300152409700,30-015-24097,SMITH 10 COM 001,2017-06-01,422,0,13,0,685,1213509,6573
300152409700,30-015-24097,SMITH 10 COM 001,2017-07-01,423,0,17,0,685,1213526,6573
300152409700,30-015-24097,SMITH 10 COM 001,2017-08-01,424,0,4,0,685,1213530,6573
300152409700,30-015-24097,SMITH 10 COM 001,2017-09-01,425,0,0,0,685,1213530,6573
300152409700,30-015-24097,SMITH 10 COM 001,2017-10-01,426,0,0,0,685,1213530,6573
300152409700,30-015-24097,SMITH 10 COM 001,2017-11-01,427,0,0,6,685,1213530,6579
300152409700,30-015-24097,SMITH 10 COM 001,2017-12-01,428,0,0,0,685,1213530,6579
300152409700,30-015-24097,SMITH 10 COM 001,2018-01-01,429,0,0,0,685,1213530,6579
300152409700,30-015-24097,SMITH 10 COM 001,2018-02-01,430,0,0,0,685,1213530,6579
300152409700,30-015-24097,SMITH 10 COM 001,2018-03-01,431,0,0,0,685,1213530,6579
300152409700,30-015-24097,SMITH 10 COM 001,2018-04-01,432,0,6,0,685,1213536,6579
300152409700,30-015-24097,SMITH 10 COM 001,2018-05-01,433,0,0,0,685,1213536,6579
300152409700,30-015-24097,SMITH 10 COM 001,2018-06-01,434,0,3,0,685,1213539,6579
300154016200,30-015-40162,BULLSEYE 22 STATE COM 001H,2012-09-01,1,2298,2411,10053,2298,2411,10053
300154016200,30-015-40162,BULLSEYE 22 STATE COM 001H,2012-10-01,2,7305,20518,51262,9603,22929,61315
300154016200,30-015-40162,BULLSEYE 22 STATE COM 001H,2012-11-01,3,5389,16416,46238,14992,39345,107553
300154016200,30-015-40162,BULLSEYE 22 STATE COM 001H,2012-12-01,4,3832,15812,35193,18824,55157,142746
300154016200,30-015-40162,BULLSEYE 22 STATE COM 001H,2013-01-01,5,2936,15544,27688,21760,70701,170434
300154016200,30-015-40162,BULLSEYE 22 STATE COM 001H,2013-02-01,6,2288,11604,17014,24048,82305,187448
300154016200,30-015-40162,BULLSEYE 22 STATE COM 001H,2013-03-01,7,2266,11839,17556,26314,94144,205004
300154016200,30-015-40162,BULLSEYE 22 STATE COM 001H,2013-04-01,8,1876,9808,14458,28190,103952,219462
300154016200,30-015-40162,BULLSEYE 22 STATE COM 001H,2013-05-01,9,740,3189,3469,28930,107141,222931
300154016200,30-015-40162,BULLSEYE 22 STATE COM 001H,2013-06-01,10,1097,2183,2591,30027,109324,225522
300154016200,30-015-40162,BULLSEYE 22 STATE COM 001H,2013-07-01,11,1038,3092,2544,31065,112416,228066
300154016200,30-015-40162,BULLSEYE 22 STATE COM 001H,2013-08-01,12,1205,4154,4796,32270,116570,232862
300154016200,30-015-40162,BULLSEYE 22 STATE COM 001H,2013-09-01,13,1169,3390,4620,33439,119960,237482
300154016200,30-015-40162,BULLSEYE 22 STATE COM 001H,2013-10-01,14,1089,3402,4577,34528,123362,242059
300154016200,30-015-40162,BULLSEYE 22 STATE COM 001H,2013-11-01,15,923,2559,3362,35451,125921,245421
300154016200,30-015-40162,BULLSEYE 22 STATE COM 001H,2013-12-01,16,1015,2223,3473,36466,128144,248894
300154016200,30-015-40162,BULLSEYE 22 STATE COM 001H,2014-01-01,17,898,2554,3449,37364,130698,252343
300154016200,30-015-40162,BULLSEYE 22 STATE COM 001H,2014-02-01,18,888,2264,3527,38252,132962,255870
300154016200,30-015-40162,BULLSEYE 22 STATE COM 001H,2014-03-01,19,975,3055,4515,39227,136017,260385
300154016200,30-015-40162,BULLSEYE 22 STATE COM 001H,2014-04-01,20,923,3121,4252,40150,139138,264637
300154016200,30-015-40162,BULLSEYE 22 STATE COM 001H,2014-05-01,21,885,1778,4121,41035,140916,268758
300154016200,30-015-40162,BULLSEYE 22 STATE COM 001H,2014-06-01,22,785,730,3413,41820,141646,272171
300154016200,30-015-40162,BULLSEYE 22 STATE COM 001H,2014-07-01,23,845,506,3613,42665,142152,275784
300154016200,30-015-40162,BULLSEYE 22 STATE COM 001H,2014-08-01,24,749,690,2919,43414,142842,278703
300154016200,30-015-40162,BULLSEYE 22 STATE COM 001H,2014-09-01,25,762,1016,3679,44176,143858,282382
300154016200,30-015-40162,BULLSEYE 22 STATE COM 001H,2014-10-01,26,787,627,4637,44963,144485,287019
300154016200,30-015-40162,BULLSEYE 22 STATE COM 001H,2014-11-01,27,742,855,3872,45705,145340,290891
300154016200,30-015-40162,BULLSEYE 22 STATE COM 001H,2014-12-01,28,770,368,4781,46475,145708,295672
300154016200,30-015-40162,BULLSEYE 22 STATE COM 001H,2015-01-01,29,738,504,1713,47213,146212,297385
300154016200,30-015-40162,BULLSEYE 22 STATE COM 001H,2015-02-01,30,500,330,2174,47713,146542,299559
300154016200,30-015-40162,BULLSEYE 22 STATE COM 001H,2015-03-01,31,331,322,2028,48044,146864,301587
300154016200,30-015-40162,BULLSEYE 22 STATE COM 001H,2015-04-01,32,871,1879,4141,48915,148743,305728
300154016200,30-015-40162,BULLSEYE 22 STATE COM 001H,2015-05-01,33,538,2406,2102,49453,151149,307830
300154016200,30-015-40162,BULLSEYE 22 STATE COM 001H,2015-06-01,34,489,1941,1724,49942,153090,309554
300154016200,30-015-40162,BULLSEYE 22 STATE COM 001H,2015-07-01,35,517,1779,2405,50459,154869,311959
300154016200,30-015-40162,BULLSEYE 22 STATE COM 001H,2015-08-01,36,555,1509,2571,51014,156378,314530
300154016200,30-015-40162,BULLSEYE 22 STATE COM 001H,2015-09-01,37,425,330,2131,51439,156708,316661
300154016200,30-015-40162,BULLSEYE 22 STATE COM 001H,2015-10-01,38,772,1209,5031,52211,157917,321692
300154016200,30-015-40162,BULLSEYE 22 STATE COM 001H,2015-11-01,39,671,935,4483,52882,158852,326175
300154016200,30-015-40162,BULLSEYE 22 STATE COM 001H,2015-12-01,40,494,640,3126,53376,159492,329301
300154016200,30-015-40162,BULLSEYE 22 STATE COM 001H,2016-01-01,41,586,1020,2905,53962,160512,332206
300154016200,30-015-40162,BULLSEYE 22 STATE COM 001H,2016-02-01,42,520,782,2980,54482,161294,335186
300154016200,30-015-40162,BULLSEYE 22 STATE COM 001H,2016-03-01,43,446,377,1586,54928,161671,336772
300154016200,30-015-40162,BULLSEYE 22 STATE COM 001H,2016-04-01,44,447,536,2025,55375,162207,338797
300154016200,30-015-40162,BULLSEYE 22 STATE COM 001H,2016-05-01,45,463,1897,2024,55838,164104,340821
300154016200,30-015-40162,BULLSEYE 22 STATE COM 001H,2016-06-01,46,455,1970,1945,56293,166074,342766
300154016200,30-015-40162,BULLSEYE 22 STATE COM 001H,2016-07-01,47,453,1906,1667,56746,167980,344433
300154016200,30-015-40162,BULLSEYE 22 STATE COM 001H,2016-08-01,48,455,1923,1906,57201,169903,346339
300154016200,30-015-40162,BULLSEYE 22 STATE COM 001H,2016-09-01,49,380,1887,1714,57581,171790,348053
300154016200,30-015-40162,BULLSEYE 22 STATE COM 001H,2016-10-01,50,533,2387,2962,58114,174177,351015
300154016200,30-015-40162,BULLSEYE 22 STATE COM 001H,2016-11-01,51,583,2449,3813,58697,176626,354828
300154016200,30-015-40162,BULLSEYE 22 STATE COM 001H,2016-12-01,52,524,2272,2504,59221,178898,357332
300154016200,30-015-40162,BULLSEYE 22 STATE COM 001H,2017-01-01,53,585,2126,2052,59806,181024,359384
300154016200,30-015-40162,BULLSEYE 22 STATE COM 001H,2017-02-01,54,323,2122,2790,60129,183146,362174
300154016200,30-015-40162,BULLSEYE 22 STATE COM 001H,2017-03-01,55,337,2068,2447,60466,185214,364621
300154016200,30-015-40162,BULLSEYE 22 STATE COM 001H,2017-04-01,56,477,2290,3802,60943,187504,368423
300154016200,30-015-40162,BULLSEYE 22 STATE COM 001H,2017-05-01,57,395,2328,3194,61338,189832,371617
300154016200,30-015-40162,BULLSEYE 22 STATE COM 001H,2017-06-01,58,383,1742,2327,61721,191574,373944
300154016200,30-015-40162,BULLSEYE 22 STATE COM 001H,2017-07-01,59,382,2006,2120,62103,193580,376064
300154016200,30-015-40162,BULLSEYE 22 STATE COM 001H,2017-08-01,60,377,2174,2179,62480,195754,378243
300154016200,30-015-40162,BULLSEYE 22 STATE COM 001H,2017-09-01,61,395,1683,2115,62875,197437,380358
300154016200,30-015-40162,BULLSEYE 22 STATE COM 001H,2017-10-01,62,353,2208,2446,63228,199645,382804
300154016200,30-015-40162,BULLSEYE 22 STATE COM 001H,2017-11-01,63,388,2098,2428,63616,201743,385232
300154016200,30-015-40162,BULLSEYE 22 STATE COM 001H,2017-12-01,64,142,947,847,63758,202690,386079
300154016200,30-015-40162,BULLSEYE 22 STATE COM 001H,2018-01-01,65,223,737,1134,63981,203427,387213
300154016200,30-015-40162,BULLSEYE 22 STATE COM 001H,2018-02-01,66,335,1742,1772,64316,205169,388985
300154016200,30-015-40162,BULLSEYE 22 STATE COM 001H,2018-03-01,67,337,1670,2304,64653,206839,391289
300154016200,30-015-40162,BULLSEYE 22 STATE COM 001H,2018-04-01,68,369,1629,2360,65022,208468,393649
300154016200,30-015-40162,BULLSEYE 22 STATE COM 001H,2018-05-01,69,371,1875,2199,65393,210343,395848
300154016200,30-015-40162,BULLSEYE 22 STATE COM 001H,2018-06-01,70,339,1987,2543,65732,212330,398391
300154016200,30-015-40162,BULLSEYE 22 STATE COM 001H,2018-07-01,71,395,1962,2376,66127,214292,400767
300154016200,30-015-40162,BULLSEYE 22 STATE COM 001H,2018-08-01,72,327,1598,1906,66454,215890,402673
300154016200,30-015-40162,BULLSEYE 22 STATE COM 001H,2018-09-01,73,310,1817,2684,66764,217707,405357
300154016200,30-015-40162,BULLSEYE 22 STATE COM 001H,2018-10-01,74,343,1804,2032,67107,219511,407389
300154016200,30-015-40162,BULLSEYE 22 STATE COM 001H,2018-11-01,75,318,1660,2129,67425,221171,409518
300154016200,30-015-40162,BULLSEYE 22 STATE COM 001H,2018-12-01,76,346,1731,2063,67771,222902,411581
300154016200,30-015-40162,BULLSEYE 22 STATE COM 001H,2019-01-01,77,363,1697,1904,68134,224599,413485
300154016200,30-015-40162,BULLSEYE 22 STATE COM 001H,2019-02-01,78,303,1454,1895,68437,226053,415380
300154016200,30-015-40162,BULLSEYE 22 STATE COM 001H,2019-03-01,79,331,1743,1969,68768,227796,417349
300154016200,30-015-40162,BULLSEYE 22 STATE COM 001H,2019-04-01,80,324,1680,2004,69092,229476,419353
300154016200,30-015-40162,BULLSEYE 22 STATE COM 001H,2019-05-01,81,229,1396,1571,69321,230872,420924
300154016200,30-015-40162,BULLSEYE 22 STATE COM 001H,2019-06-01,82,309,1694,1842,69630,232566,422766
300154016200,30-015-40162,BULLSEYE 22 STATE COM 001H,2019-07-01,83,323,1536,2089,69953,234102,424855
300154016200,30-015-40162,BULLSEYE 22 STATE COM 001H,2019-08-01,84,281,1674,1774,70234,235776,426629
300154016200,30-015-40162,BULLSEYE 22 STATE COM 001H,2019-09-01,85,281,1566,1794,70515,237342,428423
300154016200,30-015-40162,BULLSEYE 22 STATE COM 001H,2019-10-01,86,264,1459,1519,70779,238801,429942
300154016200,30-015-40162,BULLSEYE 22 STATE COM 001H,2019-11-01,87,288,1440,1539,71067,240241,431481
300154016200,30-015-40162,BULLSEYE 22 STATE COM 001H,2019-12-01,88,301,1656,1954,71368,241897,433435
300154016200,30-015-40162,BULLSEYE 22 STATE COM 001H,2020-01-01,89,296,1652,1655,71664,243549,435090
300154016200,30-015-40162,BULLSEYE 22 STATE COM 001H,2020-02-01,90,243,1484,1154,71907,245033,436244
300154016200,30-015-40162,BULLSEYE 22 STATE COM 001H,2020-03-01,91,272,1560,1272,72179,246593,437516
300154016200,30-015-40162,BULLSEYE 22 STATE COM 001H,2020-04-01,92,247,1598,1053,72426,248191,438569
300154016200,30-015-40162,BULLSEYE 22 STATE COM 001H,2020-05-01,93,252,1677,1116,72678,249868,439685
300154016200,30-015-40162,BULLSEYE 22 STATE COM 001H,2020-06-01,94,256,1356,1163,72934,251224,440848
300154016200,30-015-40162,BULLSEYE 22 STATE COM 001H,2020-07-01,95,251,1626,1243,73185,252850,442091
300154016200,30-015-40162,BULLSEYE 22 STATE COM 001H,2020-08-01,96,82,1604,972,73267,254454,443063
300154016200,30-015-40162,BULLSEYE 22 STATE COM 001H,2020-09-01,97,204,1009,1404,73471,255463,444467
300154016200,30-015-40162,BULLSEYE 22 STATE COM 001H,2020-10-01,98,326,1503,1763,73797,256966,446230
300154016200,30-015-40162,BULLSEYE 22 STATE COM 001H,2020-11-01,99,408,1994,2958,74205,258960,449188
300154016200,30-015-40162,BULLSEYE 22 STATE COM 001H,2020-12-01,100,296,1732,1714,74501,260692,450902
300154016200,30-015-40162,BULLSEYE 22 STATE COM 001H,2021-01-01,101,243,1609,1341,74744,262301,452243
300154016200,30-015-40162,BULLSEYE 22 STATE COM 001H,2021-02-01,102,267,1587,1555,75011,263888,453798
300154016200,30-015-40162,BULLSEYE 22 STATE COM 001H,2021-03-01,103,313,1790,1930,75324,265678,455728
300154016200,30-015-40162,BULLSEYE 22 STATE COM 001H,2021-04-01,104,297,1792,2132,75621,267470,457860
300154016200,30-015-40162,BULLSEYE 22 STATE COM 001H,2021-05-01,105,306,1764,1831,75927,269234,459691
300154016200,30-015-40162,BULLSEYE 22 STATE COM 001H,2021-06-01,106,337,2170,3129,76264,271404,462820
300154016200,30-015-40162,BULLSEYE 22 STATE COM 001H,2021-07-01,107,381,2307,3198,76645,273711,466018
300154016200,30-015-40162,BULLSEYE 22 STATE COM 001H,2021-08-01,108,266,1761,1676,76911,275472,467694
300154016200,30-015-40162,BULLSEYE 22 STATE COM 001H,2021-09-01,109,268,1897,1568,77179,277369,469262
300154016200,30-015-40162,BULLSEYE 22 STATE COM 001H,2021-10-01,110,324,2210,2365,77503,279579,471627
300154016200,30-015-40162,BULLSEYE 22 STATE COM 001H,2021-11-01,111,368,2753,3925,77871,282332,475552
300154016200,30-015-40162,BULLSEYE 22 STATE COM 001H,2021-12-01,112,447,3426,5078,78318,285758,480630
300154016200,30-015-40162,BULLSEYE 22 STATE COM 001H,2022-01-01,113,401,3609,4734,78719,289367,485364
300154016200,30-015-40162,BULLSEYE 22 STATE COM 001H,2022-02-01,114,367,3500,4461,79086,292867,489825
300154016200,30-015-40162,BULLSEYE 22 STATE COM 001H,2022-03-01,115,314,3294,3271,79400,296161,493096
300154016200,30-015-40162,BULLSEYE 22 STATE COM 001H,2022-04-01,116,17,847,323,79417,297008,493419
300154016200,30-015-40162,BULLSEYE 22 STATE COM 001H,2022-05-01,117,100,1441,3,79517,298449,493422
300154016200,30-015-40162,BULLSEYE 22 STATE COM 001H,2022-06-01,118,67,1274,3,79584,299723,493425
300154016200,30-015-40162,BULLSEYE 22 STATE COM 001H,2022-07-01,119,346,2785,2367,79930,302508,495792
300154016200,30-015-40162,BULLSEYE 22 STATE COM 001H,2022-08-01,120,220,1395,1914,80150,303903,497706
300154016200,30-015-40162,BULLSEYE 22 STATE COM 001H,2022-09-01,121,0,6,3,80150,303909,497709
300154016200,30-015-40162,BULLSEYE 22 STATE COM 001H,2022-10-01,122,167,1739,352,80317,305648,498061
300154016200,30-015-40162,BULLSEYE 22 STATE COM 001H,2022-11-01,123,554,3464,4354,80871,309112,502415
300154016200,30-015-40162,BULLSEYE 22 STATE COM 001H,2022-12-01,124,411,3252,4139,81282,312364,506554
300154016200,30-015-40162,BULLSEYE 22 STATE COM 001H,2023-01-01,125,445,3901,5330,81727,316265,511884
300154016200,30-015-40162,BULLSEYE 22 STATE COM 001H,2023-02-01,126,393,3930,5335,82120,320195,517219
300154016200,30-015-40162,BULLSEYE 22 STATE COM 001H,2023-03-01,127,361,4317,5857,82481,324512,523076
300154016200,30-015-40162,BULLSEYE 22 STATE COM 001H,2023-04-01,128,327,4131,4844,82808,328643,527920
300154016200,30-015-40162,BULLSEYE 22 STATE COM 001H,2023-05-01,129,236,3007,2398,83044,331650,530318
300154016200,30-015-40162,BULLSEYE 22 STATE COM 001H,2023-06-01,130,64,1225,649,83108,332875,530967
300154016200,30-015-40162,BULLSEYE 22 STATE COM 001H,2023-07-01,131,0,36,0,83108,332911,530967
300150113500,30-015-01135,KATIE MOCK 001,1963-11-01,1,483,145,190,483,145,190
300150113500,30-015-01135,KATIE MOCK 001,1963-12-01,2,54,20,45,537,165,235
300150113500,30-015-01135,KATIE MOCK 001,1964-01-01,3,287,86,450,824,251,685
300150113500,30-015-01135,KATIE MOCK 001,1964-02-01,4,106,32,95,930,283,780
300150113500,30-015-01135,KATIE MOCK 001,1964-03-01,5,204,61,190,1134,344,970
300150113500,30-015-01135,KATIE MOCK 001,1964-04-01,6,185,56,150,1319,400,1120
300150113500,30-015-01135,KATIE MOCK 001,1964-05-01,7,44,13,35,1363,413,1155
300150113500,30-015-01135,KATIE MOCK 001,1964-06-01,8,158,47,120,1521,460,1275
300150113500,30-015-01135,KATIE MOCK 001,1964-07-01,9,151,45,115,1672,505,1390
300150113500,30-015-01135,KATIE MOCK 001,1964-08-01,10,150,45,116,1822,550,1506
300150113500,30-015-01135,KATIE MOCK 001,1964-09-01,11,102,31,42,1924,581,1548
300150113500,30-015-01135,KATIE MOCK 001,1964-10-01,12,88,26,30,2012,607,1578
300150113500,30-015-01135,KATIE MOCK 001,1964-11-01,13,86,26,31,2098,633,1609
300150113500,30-015-01135,KATIE MOCK 001,1964-12-01,14,99,30,35,2197,663,1644
300150113500,30-015-01135,KATIE MOCK 001,1965-01-01,15,90,27,30,2287,690,1674
300150113500,30-015-01135,KATIE MOCK 001,1965-02-01,16,66,20,35,2353,710,1709
300150113500,30-015-01135,KATIE MOCK 001,1965-03-01,17,91,27,43,2444,737,1752
300150113500,30-015-01135,KATIE MOCK 001,1965-04-01,18,98,29,56,2542,766,1808
300150113500,30-015-01135,KATIE MOCK 001,1965-05-01,19,92,28,75,2634,794,1883
300150113500,30-015-01135,KATIE MOCK 001,1965-06-01,20,90,27,68,2724,821,1951
300150113500,30-015-01135,KATIE MOCK 001,1965-07-01,21,81,24,60,2805,845,2011
300150113500,30-015-01135,KATIE MOCK 001,1965-08-01,22,80,24,71,2885,869,2082
300150113500,30-015-01135,KATIE MOCK 001,1965-09-01,23,63,19,60,2948,888,2142
300150113500,30-015-01135,KATIE MOCK 001,1965-10-01,24,72,22,71,3020,910,2213
300150113500,30-015-01135,KATIE MOCK 001,1965-11-01,25,70,21,70,3090,931,2283
300150113500,30-015-01135,KATIE MOCK 001,1965-12-01,26,66,19,70,3156,950,2353
300150113500,30-015-01135,KATIE MOCK 001,1966-01-01,27,51,15,50,3207,965,2403
300150113500,30-015-01135,KATIE MOCK 001,1966-02-01,28,45,20,48,3252,985,2451
300150113500,30-015-01135,KATIE MOCK 001,1966-03-01,29,30,21,45,3282,1006,2496
300150113500,30-015-01135,KATIE MOCK 001,1966-04-01,30,31,22,40,3313,1028,2536
300150113500,30-015-01135,KATIE MOCK 001,1966-05-01,31,49,35,50,3362,1063,2586
300150113500,30-015-01135,KATIE MOCK 001,1966-06-01,32,54,40,60,3416,1103,2646
300150113500,30-015-01135,KATIE MOCK 001,1966-07-01,33,50,41,63,3466,1144,2709
300150113500,30-015-01135,KATIE MOCK 001,1966-08-01,34,58,40,60,3524,1184,2769
300150113500,30-015-01135,KATIE MOCK 001,1966-09-01,35,145,120,140,3669,1304,2909
300150113500,30-015-01135,KATIE MOCK 001,1966-10-01,36,18,17,20,3687,1321,2929
300150113500,30-015-01135,KATIE MOCK 001,1966-11-01,37,94,80,90,3781,1401,3019
300150113500,30-015-01135,KATIE MOCK 001,1966-12-01,38,60,59,55,3841,1460,3074
300150113500,30-015-01135,KATIE MOCK 001,1967-01-01,39,62,63,60,3903,1523,3134
300150113500,30-015-01135,KATIE MOCK 001,1967-02-01,40,10,6,12,3913,1529,3146
300150113500,30-015-01135,KATIE MOCK 001,1967-03-01,41,58,31,55,3971,1560,3201
300150113500,30-015-01135,KATIE MOCK 001,1967-04-01,42,75,60,75,4046,1620,3276
300150113500,30-015-01135,KATIE MOCK 001,1967-05-01,43,79,63,80,4125,1683,3356
300150113500,30-015-01135,KATIE MOCK 001,1967-06-01,44,50,40,55,4175,1723,3411
300150113500,30-015-01135,KATIE MOCK 001,1967-07-01,45,23,23,25,4198,1746,3436
300150113500,30-015-01135,KATIE MOCK 001,1967-08-01,46,20,21,22,4218,1767,3458
300150113500,30-015-01135,KATIE MOCK 001,1967-09-01,47,21,22,25,4239,1789,3483
300150113500,30-015-01135,KATIE MOCK 001,1967-10-01,48,38,39,40,4277,1828,3523
300150113500,30-015-01135,KATIE MOCK 001,1967-11-01,49,31,32,35,4308,1860,3558
300150113500,30-015-01135,KATIE MOCK 001,1967-12-01,50,62,61,60,4370,1921,3618
300150113500,30-015-01135,KATIE MOCK 001,1968-01-01,51,30,38,31,4400,1959,3649
300150113500,30-015-01135,KATIE MOCK 001,1968-02-01,52,8,6,7,4408,1965,3656
300150113500,30-015-01135,KATIE MOCK 001,1968-03-01,53,31,28,29,4439,1993,3685
300150113500,30-015-01135,KATIE MOCK 001,1968-04-01,54,30,29,29,4469,2022,3714
300154389800,30-015-43898,MAD RIVER 13 STATE COM 003H,2017-01-01,1,9043,13485,21458,9043,13485,21458
300154389800,30-015-43898,MAD RIVER 13 STATE COM 003H,2017-02-01,2,22608,41430,47199,31651,54915,68657
300154389800,30-015-43898,MAD RIVER 13 STATE COM 003H,2017-03-01,3,20730,39673,40925,52381,94588,109582
300154389800,30-015-43898,MAD RIVER 13 STATE COM 003H,2017-04-01,4,2102,3512,49326,54483,98100,158908
300154389800,30-015-43898,MAD RIVER 13 STATE COM 003H,2017-05-01,5,19089,33697,58093,73572,131797,217001
300154389800,30-015-43898,MAD RIVER 13 STATE COM 003H,2017-06-01,6,15347,28433,38793,88919,160230,255794
300154389800,30-015-43898,MAD RIVER 13 STATE COM 003H,2017-07-01,7,13321,25117,33421,102240,185347,289215
300154389800,30-015-43898,MAD RIVER 13 STATE COM 003H,2017-08-01,8,11848,24443,32507,114088,209790,321722
300154389800,30-015-43898,MAD RIVER 13 STATE COM 003H,2017-09-01,9,9842,21077,30265,123930,230867,351987
300154389800,30-015-43898,MAD RIVER 13 STATE COM 003H,2017-10-01,10,9587,21525,24681,133517,252392,376668
300154389800,30-015-43898,MAD RIVER 13 STATE COM 003H,2017-11-01,11,7639,16109,19369,141156,268501,396037
300154389800,30-015-43898,MAD RIVER 13 STATE COM 003H,2017-12-01,12,6999,11607,17058,148155,280108,413095
300154389800,30-015-43898,MAD RIVER 13 STATE COM 003H,2018-01-01,13,6880,11179,17999,155035,291287,431094
300154389800,30-015-43898,MAD RIVER 13 STATE COM 003H,2018-02-01,14,5618,7377,16521,160653,298664,447615
300154389800,30-015-43898,MAD RIVER 13 STATE COM 003H,2018-03-01,15,6661,7107,21332,167314,305771,468947
300154389800,30-015-43898,MAD RIVER 13 STATE COM 003H,2018-04-01,16,6353,7375,19283,173667,313146,488230
300154389800,30-015-43898,MAD RIVER 13 STATE COM 003H,2018-05-01,17,5293,8107,18876,178960,321253,507106
300154389800,30-015-43898,MAD RIVER 13 STATE COM 003H,2018-06-01,18,5210,7378,17293,184170,328631,524399
300154389800,30-015-43898,MAD RIVER 13 STATE COM 003H,2018-07-01,19,5051,8067,16716,189221,336698,541115
300154389800,30-015-43898,MAD RIVER 13 STATE COM 003H,2018-08-01,20,4562,8176,15652,193783,344874,556767
300154389800,30-015-43898,MAD RIVER 13 STATE COM 003H,2018-09-01,21,4571,7906,13262,198354,352780,570029
300154389800,30-015-43898,MAD RIVER 13 STATE COM 003H,2018-10-01,22,4429,5616,15085,202783,358396,585114
300154389800,30-015-43898,MAD RIVER 13 STATE COM 003H,2018-11-01,23,4155,6659,13019,206938,365055,598133
300154389800,30-015-43898,MAD RIVER 13 STATE COM 003H,2018-12-01,24,4040,5428,11908,210978,370483,610041
300154389800,30-015-43898,MAD RIVER 13 STATE COM 003H,2019-01-01,25,3561,4996,9038,214539,375479,619079
300154389800,30-015-43898,MAD RIVER 13 STATE COM 003H,2019-02-01,26,2911,5729,5862,217450,381208,624941
300154389800,30-015-43898,MAD RIVER 13 STATE COM 003H,2019-03-01,27,3887,9218,14511,221337,390426,639452
300154389800,30-015-43898,MAD RIVER 13 STATE COM 003H,2019-04-01,28,4060,12773,28286,225397,403199,667738
300154389800,30-015-43898,MAD RIVER 13 STATE COM 003H,2019-05-01,29,3804,10271,41292,229201,413470,709030
300154389800,30-015-43898,MAD RIVER 13 STATE COM 003H,2019-06-01,30,3363,10368,40453,232564,423838,749483
300154389800,30-015-43898,MAD RIVER 13 STATE COM 003H,2019-07-01,31,3209,8983,38452,235773,432821,787935
300154389800,30-015-43898,MAD RIVER 13 STATE COM 003H,2019-08-01,32,3367,8472,31641,239140,441293,819576
300154389800,30-015-43898,MAD RIVER 13 STATE COM 003H,2019-09-01,33,3111,8914,31475,242251,450207,851051
300154389800,30-015-43898,MAD RIVER 13 STATE COM 003H,2019-10-01,34,3036,8990,28925,245287,459197,879976
300154389800,30-015-43898,MAD RIVER 13 STATE COM 003H,2019-11-01,35,2952,7234,24600,248239,466431,904576
300154389800,30-015-43898,MAD RIVER 13 STATE COM 003H,2019-12-01,36,2881,9403,17771,251120,475834,922347
300154389800,30-015-43898,MAD RIVER 13 STATE COM 003H,2020-01-01,37,1650,4332,8349,252770,480166,930696
300154389800,30-015-43898,MAD RIVER 13 STATE COM 003H,2020-02-01,38,3904,5344,17404,256674,485510,948100
300154389800,30-015-43898,MAD RIVER 13 STATE COM 003H,2020-03-01,39,3677,6090,15268,260351,491600,963368
300154389800,30-015-43898,MAD RIVER 13 STATE COM 003H,2020-04-01,40,2309,7097,10251,262660,498697,973619
300154389800,30-015-43898,MAD RIVER 13 STATE COM 003H,2020-05-01,41,0,0,0,262660,498697,973619
300154389800,30-015-43898,MAD RIVER 13 STATE COM 003H,2020-06-01,42,3506,11897,8671,266166,510594,982290
300154389800,30-015-43898,MAD RIVER 13 STATE COM 003H,2020-07-01,43,2583,11185,16732,268749,521779,999022
300154389800,30-015-43898,MAD RIVER 13 STATE COM 003H,2020-08-01,44,2775,10390,14909,271524,532169,1013931
300154389800,30-015-43898,MAD RIVER 13 STATE COM 003H,2020-09-01,45,2444,10724,15075,273968,542893,1029006
300154389800,30-015-43898,MAD RIVER 13 STATE COM 003H,2020-10-01,46,2334,11798,12961,276302,554691,1041967
300154389800,30-015-43898,MAD RIVER 13 STATE COM 003H,2020-11-01,47,1997,11295,10422,278299,565986,1052389
300154389800,30-015-43898,MAD RIVER 13 STATE COM 003H,2020-12-01,48,1684,11044,10592,279983,577030,1062981
300154389800,30-015-43898,MAD RIVER 13 STATE COM 003H,2021-01-01,49,1861,14095,12220,281844,591125,1075201
300154389800,30-015-43898,MAD RIVER 13 STATE COM 003H,2021-02-01,50,1492,11763,10585,283336,602888,1085786
300154389800,30-015-43898,MAD RIVER 13 STATE COM 003H,2021-03-01,51,1867,13532,12190,285203,616420,1097976
300154389800,30-015-43898,MAD RIVER 13 STATE COM 003H,2021-04-01,52,2228,13114,10565,287431,629534,1108541
300154389800,30-015-43898,MAD RIVER 13 STATE COM 003H,2021-05-01,53,2002,7122,9121,289433,636656,1117662
300154389800,30-015-43898,MAD RIVER 13 STATE COM 003H,2021-06-01,54,1906,10338,8453,291339,646994,1126115
300154389800,30-015-43898,MAD RIVER 13 STATE COM 003H,2021-07-01,55,2032,9137,8969,293371,656131,1135084
300154389800,30-015-43898,MAD RIVER 13 STATE COM 003H,2021-08-01,56,2041,15622,9752,295412,671753,1144836
300154389800,30-015-43898,MAD RIVER 13 STATE COM 003H,2021-09-01,57,1790,29223,8943,297202,700976,1153779
300154389800,30-015-43898,MAD RIVER 13 STATE COM 003H,2021-10-01,58,1836,16112,8539,299038,717088,1162318
300154389800,30-015-43898,MAD RIVER 13 STATE COM 003H,2021-11-01,59,1776,27283,7265,300814,744371,1169583
300154389800,30-015-43898,MAD RIVER 13 STATE COM 003H,2021-12-01,60,1913,10616,7284,302727,754987,1176867
300154389800,30-015-43898,MAD RIVER 13 STATE COM 003H,2022-01-01,61,1478,5892,6432,304205,760879,1183299
300154389800,30-015-43898,MAD RIVER 13 STATE COM 003H,2022-02-01,62,2002,6118,8005,306207,766997,1191304
300154389800,30-015-43898,MAD RIVER 13 STATE COM 003H,2022-03-01,63,1931,8044,8717,308138,775041,1200021
300154389800,30-015-43898,MAD RIVER 13 STATE COM 003H,2022-04-01,64,1615,5699,4927,309753,780740,1204948
300154389800,30-015-43898,MAD RIVER 13 STATE COM 003H,2022-05-01,65,2346,8599,6954,312099,789339,1211902
300154389800,30-015-43898,MAD RIVER 13 STATE COM 003H,2022-06-01,66,2014,7392,7347,314113,796731,1219249
300154389800,30-015-43898,MAD RIVER 13 STATE COM 003H,2022-07-01,67,943,3406,3213,315056,800137,1222462
300154389800,30-015-43898,MAD RIVER 13 STATE COM 003H,2022-08-01,68,786,2081,2421,315842,802218,1224883
300154389800,30-015-43898,MAD RIVER 13 STATE COM 003H,2022-09-01,69,2066,8815,5311,317908,811033,1230194
300154389800,30-015-43898,MAD RIVER 13 STATE COM 003H,2022-10-01,70,1575,10736,7083,319483,821769,1237277
300154389800,30-015-43898,MAD RIVER 13 STATE COM 003H,2022-11-01,71,373,3999,1996,319856,825768,1239273
300154389800,30-015-43898,MAD RIVER 13 STATE COM 003H,2022-12-01,72,2176,16852,7647,322032,842620,1246920
300154389800,30-015-43898,MAD RIVER 13 STATE COM 003H,2023-01-01,73,1742,14373,7587,323774,856993,1254507
300154389800,30-015-43898,MAD RIVER 13 STATE COM 003H,2023-02-01,74,1371,11929,7517,325145,868922,1262024
300154389800,30-015-43898,MAD RIVER 13 STATE COM 003H,2023-03-01,75,1743,16688,10399,326888,885610,1272423
300154389800,30-015-43898,MAD RIVER 13 STATE COM 003H,2023-04-01,76,2770,13744,12252,329658,899354,1284675
300154389800,30-015-43898,MAD RIVER 13 STATE COM 003H,2023-05-01,77,5232,24426,19063,334890,923780,1303738
300154389800,30-015-43898,MAD RIVER 13 STATE COM 003H,2023-06-01,78,4220,22788,14750,339110,946568,1318488
300153496000,30-015-34960,SWISHER BJE STATE 001,2008-05-01,1,378,52861,478,378,52861,478
300153496000,30-015-34960,SWISHER BJE STATE 001,2008-06-01,2,332,49677,112,710,102538,590
300153496000,30-015-34960,SWISHER BJE STATE 001,2008-07-01,3,260,49035,99,970,151573,689
300153496000,30-015-34960,SWISHER BJE STATE 001,2008-08-01,4,231,47916,89,1201,199489,778
300153496000,30-015-34960,SWISHER BJE STATE 001,2008-09-01,5,193,45065,79,1394,244554,857
300153496000,30-015-34960,SWISHER BJE STATE 001,2008-10-01,6,171,42499,95,1565,287053,952
300153496000,30-015-34960,SWISHER BJE STATE 001,2008-11-01,7,175,42518,78,1740,329571,1030
300153496000,30-015-34960,SWISHER BJE STATE 001,2008-12-01,8,175,42492,82,1915,372063,1112
300153496000,30-015-34960,SWISHER BJE STATE 001,2009-01-01,9,187,40114,65,2102,412177,1177
300153496000,30-015-34960,SWISHER BJE STATE 001,2009-02-01,10,163,37320,66,2265,449497,1243
300153496000,30-015-34960,SWISHER BJE STATE 001,2009-03-01,11,174,40718,51,2439,490215,1294
300153496000,30-015-34960,SWISHER BJE STATE 001,2009-04-01,12,159,38796,48,2598,529011,1342
300153496000,30-015-34960,SWISHER BJE STATE 001,2009-05-01,13,157,39396,72,2755,568407,1414
300153496000,30-015-34960,SWISHER BJE STATE 001,2009-06-01,14,144,37440,59,2899,605847,1473
300153496000,30-015-34960,SWISHER BJE STATE 001,2009-07-01,15,144,38016,66,3043,643863,1539
300153496000,30-015-34960,SWISHER BJE STATE 001,2009-08-01,16,139,37329,47,3182,681192,1586
300153496000,30-015-34960,SWISHER BJE STATE 001,2009-09-01,17,138,35429,65,3320,716621,1651
300153496000,30-015-34960,SWISHER BJE STATE 001,2009-10-01,18,138,35976,75,3458,752597,1726
300153496000,30-015-34960,SWISHER BJE STATE 001,2009-11-01,19,127,34217,64,3585,786814,1790
300153496000,30-015-34960,SWISHER BJE STATE 001,2009-12-01,20,127,34799,62,3712,821613,1852
300153496000,30-015-34960,SWISHER BJE STATE 001,2010-01-01,21,126,34083,62,3838,855696,1914
300153496000,30-015-34960,SWISHER BJE STATE 001,2010-02-01,22,111,30485,56,3949,886181,1970
300153496000,30-015-34960,SWISHER BJE STATE 001,2010-03-01,23,121,33297,62,4070,919478,2032
300153496000,30-015-34960,SWISHER BJE STATE 001,2010-04-01,24,114,31646,41,4184,951124,2073
300153496000,30-015-34960,SWISHER BJE STATE 001,2010-05-01,25,110,32206,46,4294,983330,2119
300153496000,30-015-34960,SWISHER BJE STATE 001,2010-06-01,26,92,29540,30,4386,1012870,2149
300153496000,30-015-34960,SWISHER BJE STATE 001,2010-07-01,27,86,30808,38,4472,1043678,2187
300153496000,30-015-34960,SWISHER BJE STATE 001,2010-08-01,28,88,28849,37,4560,1072527,2224
300153496000,30-015-34960,SWISHER BJE STATE 001,2010-09-01,29,89,27072,26,4649,1099599,2250
300153496000,30-015-34960,SWISHER BJE STATE 001,2010-10-01,30,79,28218,27,4728,1127817,2277
300153496000,30-015-34960,SWISHER BJE STATE 001,2010-11-01,31,93,28148,18,4821,1155965,2295
300153496000,30-015-34960,SWISHER BJE STATE 001,2010-12-01,32,107,29037,30,4928,1185002,2325
300153496000,30-015-34960,SWISHER BJE STATE 001,2011-01-01,33,81,26163,21,5009,1211165,2346
300153496000,30-015-34960,SWISHER BJE STATE 001,2011-02-01,34,63,23862,26,5072,1235027,2372
300153496000,30-015-34960,SWISHER BJE STATE 001,2011-03-01,35,57,27196,48,5129,1262223,2420
300153496000,30-015-34960,SWISHER BJE STATE 001,2011-04-01,36,55,26539,46,5184,1288762,2466
300153496000,30-015-34960,SWISHER BJE STATE 001,2011-05-01,37,47,26888,66,5231,1315650,2532
300153496000,30-015-34960,SWISHER BJE STATE 001,2011-06-01,38,53,23962,0,5284,1339612,2532
300153496000,30-015-34960,SWISHER BJE STATE 001,2011-07-01,39,53,20108,39,5337,1359720,2571
300153496000,30-015-34960,SWISHER BJE STATE 001,2011-08-01,40,46,25053,46,5383,1384773,2617
300153496000,30-015-34960,SWISHER BJE STATE 001,2011-09-01,41,56,23597,71,5439,1408370,2688
300153496000,30-015-34960,SWISHER BJE STATE 001,2011-10-01,42,42,23437,60,5481,1431807,2748
300153496000,30-015-34960,SWISHER BJE STATE 001,2011-11-01,43,44,24540,44,5525,1456347,2792
300153496000,30-015-34960,SWISHER BJE STATE 001,2011-12-01,44,31,25411,68,5556,1481758,2860
300153496000,30-015-34960,SWISHER BJE STATE 001,2012-01-01,45,67,24384,13,5623,1506142,2873
300153496000,30-015-34960,SWISHER BJE STATE 001,2012-02-01,46,36,22430,60,5659,1528572,2933
300153496000,30-015-34960,SWISHER BJE STATE 001,2012-03-01,47,46,22923,6,5705,1551495,2939
300153496000,30-015-34960,SWISHER BJE STATE 001,2012-04-01,48,40,22091,63,5745,1573586,3002
300153496000,30-015-34960,SWISHER BJE STATE 001,2012-05-01,49,49,20130,62,5794,1593716,3064
300153496000,30-015-34960,SWISHER BJE STATE 001,2012-06-01,50,41,23405,107,5835,1617121,3171
300153496000,30-015-34960,SWISHER BJE STATE 001,2012-07-01,51,44,23242,46,5879,1640363,3217
300153496000,30-015-34960,SWISHER BJE STATE 001,2012-08-01,52,37,23307,42,5916,1663670,3259
300153496000,30-015-34960,SWISHER BJE STATE 001,2012-09-01,53,31,21516,45,5947,1685186,3304
300153496000,30-015-34960,SWISHER BJE STATE 001,2012-10-01,54,25,20240,46,5972,1705426,3350
300153496000,30-015-34960,SWISHER BJE STATE 001,2012-11-01,55,40,19747,9,6012,1725173,3359
300153496000,30-015-34960,SWISHER BJE STATE 001,2012-12-01,56,31,20661,53,6043,1745834,3412
300153496000,30-015-34960,SWISHER BJE STATE 001,2013-01-01,57,59,19325,121,6102,1765159,3533
300153496000,30-015-34960,SWISHER BJE STATE 001,2013-02-01,58,23,16492,3,6125,1781651,3536
300153496000,30-015-34960,SWISHER BJE STATE 001,2013-03-01,59,9,3170,0,6134,1784821,3536
300153496000,30-015-34960,SWISHER BJE STATE 001,2013-04-01,60,33,14491,78,6167,1799312,3614
300153496000,30-015-34960,SWISHER BJE STATE 001,2013-05-01,61,37,17520,10,6204,1816832,3624
300153496000,30-015-34960,SWISHER BJE STATE 001,2013-06-01,62,37,20360,6,6241,1837192,3630
300153496000,30-015-34960,SWISHER BJE STATE 001,2013-07-01,63,31,19139,26,6272,1856331,3656
300153496000,30-015-34960,SWISHER BJE STATE 001,2013-08-01,64,37,19205,0,6309,1875536,3656
300153496000,30-015-34960,SWISHER BJE STATE 001,2013-09-01,65,19,18826,26,6328,1894362,3682
300153496000,30-015-34960,SWISHER BJE STATE 001,2013-10-01,66,7,20087,0,6335,1914449,3682
300153496000,30-015-34960,SWISHER BJE STATE 001,2013-11-01,67,16,17597,0,6351,1932046,3682
300153496000,30-015-34960,SWISHER BJE STATE 001,2013-12-01,68,4,19210,0,6355,1951256,3682
300153496000,30-015-34960,SWISHER BJE STATE 001,2014-01-01,69,21,13285,0,6376,1964541,3682
300153496000,30-015-34960,SWISHER BJE STATE 001,2014-02-01,70,7,15349,0,6383,1979890,3682
300153496000,30-015-34960,SWISHER BJE STATE 001,2014-03-01,71,85,13545,0,6468,1993435,3682
300153496000,30-015-34960,SWISHER BJE STATE 001,2014-04-01,72,0,17785,0,6468,2011220,3682
300153496000,30-015-34960,SWISHER BJE STATE 001,2014-05-01,73,31,18300,25,6499,2029520,3707
300153496000,30-015-34960,SWISHER BJE STATE 001,2014-06-01,74,4,14669,10,6503,2044189,3717
300153496000,30-015-34960,SWISHER BJE STATE 001,2014-07-01,75,11,13234,2270,6514,2057423,5987
300153496000,30-015-34960,SWISHER BJE STATE 001,2014-08-01,76,11,14520,1109,6525,2071943,7096
300153496000,30-015-34960,SWISHER BJE STATE 001,2014-09-01,77,12,9957,698,6537,2081900,7794
300153496000,30-015-34960,SWISHER BJE STATE 001,2014-10-01,78,0,8086,103,6537,2089986,7897
300153496000,30-015-34960,SWISHER BJE STATE 001,2014-11-01,79,0,9338,303,6537,2099324,8200
300153496000,30-015-34960,SWISHER BJE STATE 001,2014-12-01,80,28,16153,240,6565,2115477,8440
300153496000,30-015-34960,SWISHER BJE STATE 001,2015-01-01,81,12,16508,94,6577,2131985,8534
300153496000,30-015-34960,SWISHER BJE STATE 001,2015-02-01,82,0,15325,275,6577,2147310,8809
300153496000,30-015-34960,SWISHER BJE STATE 001,2015-03-01,83,12,16837,588,6589,2164147,9397
300153496000,30-015-34960,SWISHER BJE STATE 001,2015-04-01,84,0,16668,140,6589,2180815,9537
300153496000,30-015-34960,SWISHER BJE STATE 001,2015-05-01,85,0,14750,460,6589,2195565,9997
300153496000,30-015-34960,SWISHER BJE STATE 001,2015-06-01,86,0,11173,6,6589,2206738,10003
300153496000,30-015-34960,SWISHER BJE STATE 001,2015-07-01,87,0,11878,12,6589,2218616,10015
300153496000,30-015-34960,SWISHER BJE STATE 001,2015-08-01,88,0,13214,121,6589,2231830,10136
300153496000,30-015-34960,SWISHER BJE STATE 001,2015-09-01,89,0,14128,0,6589,2245958,10136
300153496000,30-015-34960,SWISHER BJE STATE 001,2015-10-01,90,0,10179,0,6589,2256137,10136
300153496000,30-015-34960,SWISHER BJE STATE 001,2015-11-01,91,0,9442,0,6589,2265579,10136
300153496000,30-015-34960,SWISHER BJE STATE 001,2015-12-01,92,1,8076,0,6590,2273655,10136
300153496000,30-015-34960,SWISHER BJE STATE 001,2016-01-01,93,0,3938,0,6590,2277593,10136
300153496000,30-015-34960,SWISHER BJE STATE 001,2016-02-01,94,220,7083,0,6810,2284676,10136
300153496000,30-015-34960,SWISHER BJE STATE 001,2016-03-01,95,0,31,0,6810,2284707,10136
300153496000,30-015-34960,SWISHER BJE STATE 001,2016-04-01,96,0,2772,0,6810,2287479,10136
300153496000,30-015-34960,SWISHER BJE STATE 001,2016-05-01,97,14,1571,0,6824,2289050,10136
300153496000,30-015-34960,SWISHER BJE STATE 001,2016-06-01,98,0,592,0,6824,2289642,10136
300153496000,30-015-34960,SWISHER BJE STATE 001,2016-07-01,99,0,393,0,6824,2290035,10136
300153496000,30-015-34960,SWISHER BJE STATE 001,2016-08-01,100,0,325,0,6824,2290360,10136
300153496000,30-015-34960,SWISHER BJE STATE 001,2016-09-01,101,0,566,0,6824,2290926,10136
300153496000,30-015-34960,SWISHER BJE STATE 001,2016-10-01,102,0,1145,3,6824,2292071,10139
300153496000,30-015-34960,SWISHER BJE STATE 001,2016-11-01,103,0,685,0,6824,2292756,10139
300153496000,30-015-34960,SWISHER BJE STATE 001,2016-12-01,104,0,406,0,6824,2293162,10139
300153496000,30-015-34960,SWISHER BJE STATE 001,2017-01-01,105,0,109,0,6824,2293271,10139
300153496000,30-015-34960,SWISHER BJE STATE 001,2017-02-01,106,0,500,0,6824,2293771,10139
300153496000,30-015-34960,SWISHER BJE STATE 001,2017-03-01,107,0,981,0,6824,2294752,10139
300153496000,30-015-34960,SWISHER BJE STATE 001,2017-04-01,108,0,10213,0,6824,2304965,10139
300153496000,30-015-34960,SWISHER BJE STATE 001,2017-05-01,109,0,12471,0,6824,2317436,10139
300153496000,30-015-34960,SWISHER BJE STATE 001,2017-06-01,110,0,12731,0,6824,2330167,10139
300153496000,30-015-34960,SWISHER BJE STATE 001,2017-07-01,111,0,12893,0,6824,2343060,10139
300153496000,30-015-34960,SWISHER BJE STATE 001,2017-08-01,112,0,11887,0,6824,2354947,10139
300153496000,30-015-34960,SWISHER BJE STATE 001,2017-09-01,113,0,12235,0,6824,2367182,10139
300153496000,30-015-34960,SWISHER BJE STATE 001,2017-10-01,114,0,13345,0,6824,2380527,10139
300153496000,30-015-34960,SWISHER BJE STATE 001,2017-11-01,115,0,12539,0,6824,2393066,10139
300153496000,30-015-34960,SWISHER BJE STATE 001,2017-12-01,116,0,9914,0,6824,2402980,10139
300153496000,30-015-34960,SWISHER BJE STATE 001,2018-01-01,117,0,11379,0,6824,2414359,10139
300153496000,30-015-34960,SWISHER BJE STATE 001,2018-02-01,118,0,12154,0,6824,2426513,10139
300153496000,30-015-34960,SWISHER BJE STATE 001,2018-03-01,119,0,13243,0,6824,2439756,10139
300153496000,30-015-34960,SWISHER BJE STATE 001,2018-04-01,120,0,10931,0,6824,2450687,10139
300153496000,30-015-34960,SWISHER BJE STATE 001,2018-05-01,121,2,12187,15,6826,2462874,10154
300153496000,30-015-34960,SWISHER BJE STATE 001,2018-06-01,122,11,12765,38,6837,2475639,10192
300153496000,30-015-34960,SWISHER BJE STATE 001,2018-07-01,123,10,12884,1,6847,2488523,10193
300153496000,30-015-34960,SWISHER BJE STATE 001,2018-08-01,124,3,12745,2,6850,2501268,10195
300153496000,30-015-34960,SWISHER BJE STATE 001,2018-09-01,125,30,11829,7,6880,2513097,10202
300153496000,30-015-34960,SWISHER BJE STATE 001,2018-10-01,126,2,11223,0,6882,2524320,10202
300153496000,30-015-34960,SWISHER BJE STATE 001,2018-11-01,127,39,12031,9,6921,2536351,10211
300153496000,30-015-34960,SWISHER BJE STATE 001,2018-12-01,128,23,12215,8,6944,2548566,10219
300153496000,30-015-34960,SWISHER BJE STATE 001,2019-01-01,129,27,11702,1,6971,2560268,10220
300153496000,30-015-34960,SWISHER BJE STATE 001,2019-02-01,130,24,10936,3,6995,2571204,10223
300153496000,30-015-34960,SWISHER BJE STATE 001,2019-03-01,131,19,11932,73,7014,2583136,10296
300153496000,30-015-34960,SWISHER BJE STATE 001,2019-04-01,132,51,11422,339,7065,2594558,10635
300153496000,30-015-34960,SWISHER BJE STATE 001,2019-05-01,133,35,10737,589,7100,2605295,11224
300153496000,30-015-34960,SWISHER BJE STATE 001,2019-06-01,134,0,11366,195,7100,2616661,11419
300153496000,30-015-34960,SWISHER BJE STATE 001,2019-07-01,135,7,11633,407,7107,2628294,11826
300153496000,30-015-34960,SWISHER BJE STATE 001,2019-08-01,136,2,11225,231,7109,2639519,12057
300153496000,30-015-34960,SWISHER BJE STATE 001,2019-09-01,137,4,10724,63,7113,2650243,12120
300153496000,30-015-34960,SWISHER BJE STATE 001,2019-10-01,138,2,11279,148,7115,2661522,12268
300153496000,30-015-34960,SWISHER BJE STATE 001,2019-11-01,139,18,10275,335,7133,2671797,12603
300153496000,30-015-34960,SWISHER BJE STATE 001,2019-12-01,140,7,10879,424,7140,2682676,13027
300153496000,30-015-34960,SWISHER BJE STATE 001,2020-01-01,141,13,11293,288,7153,2693969,13315
300153496000,30-015-34960,SWISHER BJE STATE 001,2020-02-01,142,0,10577,543,7153,2704546,13858
300153496000,30-015-34960,SWISHER BJE STATE 001,2020-03-01,143,0,11273,23,7153,2715819,13881
300153496000,30-015-34960,SWISHER BJE STATE 001,2020-04-01,144,0,10960,50,7153,2726779,13931
300153496000,30-015-34960,SWISHER BJE STATE 001,2020-05-01,145,2,9924,26,7155,2736703,13957
300153496000,30-015-34960,SWISHER BJE STATE 001,2020-06-01,146,6,10097,14,7161,2746800,13971
300153496000,30-015-34960,SWISHER BJE STATE 001,2020-07-01,147,9,10641,45,7170,2757441,14016
300153496000,30-015-34960,SWISHER BJE STATE 001,2020-08-01,148,3,10607,98,7173,2768048,14114
300153496000,30-015-34960,SWISHER BJE STATE 001,2020-09-01,149,2,10035,15,7175,2778083,14129
300153496000,30-015-34960,SWISHER BJE STATE 001,2020-10-01,150,3,10688,12,7178,2788771,14141
300153496000,30-015-34960,SWISHER BJE STATE 001,2020-11-01,151,9,10569,39,7187,2799340,14180
300153496000,30-015-34960,SWISHER BJE STATE 001,2020-12-01,152,9,10808,97,7196,2810148,14277
300153496000,30-015-34960,SWISHER BJE STATE 001,2021-01-01,153,4,10601,79,7200,2820749,14356
300153496000,30-015-34960,SWISHER BJE STATE 001,2021-02-01,154,1,9416,72,7201,2830165,14428
300153496000,30-015-34960,SWISHER BJE STATE 001,2021-03-01,155,2,9164,39,7203,2839329,14467
300153496000,30-015-34960,SWISHER BJE STATE 001,2021-04-01,156,0,10036,52,7203,2849365,14519
300153496000,30-015-34960,SWISHER BJE STATE 001,2021-05-01,157,1,9987,160,7204,2859352,14679
300153496000,30-015-34960,SWISHER BJE STATE 001,2021-06-01,158,3,9871,23,7207,2869223,14702
300153496000,30-015-34960,SWISHER BJE STATE 001,2021-07-01,159,0,10147,17,7207,2879370,14719
300153496000,30-015-34960,SWISHER BJE STATE 001,2021-08-01,160,2,9723,27,7209,2889093,14746
300153496000,30-015-34960,SWISHER BJE STATE 001,2021-09-01,161,2,9677,13,7211,2898770,14759
300153496000,30-015-34960,SWISHER BJE STATE 001,2021-10-01,162,4,9878,16,7215,2908648,14775
300153496000,30-015-34960,SWISHER BJE STATE 001,2021-11-01,163,1,9661,22,7216,2918309,14797
300153496000,30-015-34960,SWISHER BJE STATE 001,2021-12-01,164,1,9897,31,7217,2928206,14828
300153496000,30-015-34960,SWISHER BJE STATE 001,2022-01-01,165,2,9336,51,7219,2937542,14879
300153496000,30-015-34960,SWISHER BJE STATE 001,2022-02-01,166,0,8766,27,7219,2946308,14906
300153496000,30-015-34960,SWISHER BJE STATE 001,2022-03-01,167,10,9681,32,7229,2955989,14938
300153496000,30-015-34960,SWISHER BJE STATE 001,2022-04-01,168,0,9136,26,7229,2965125,14964
300153496000,30-015-34960,SWISHER BJE STATE 001,2022-05-01,169,12,9664,42,7241,2974789,15006
300153496000,30-015-34960,SWISHER BJE STATE 001,2022-06-01,170,5,9148,31,7246,2983937,15037
300153496000,30-015-34960,SWISHER BJE STATE 001,2022-07-01,171,0,9584,31,7246,2993521,15068
300153496000,30-015-34960,SWISHER BJE STATE 001,2022-08-01,172,0,9392,26,7246,3002913,15094
300153496000,30-015-34960,SWISHER BJE STATE 001,2022-09-01,173,0,9171,23,7246,3012084,15117
300153496000,30-015-34960,SWISHER BJE STATE 001,2022-10-01,174,0,9401,45,7246,3021485,15162
300153496000,30-015-34960,SWISHER BJE STATE 001,2022-11-01,175,0,8698,21,7246,3030183,15183
300153496000,30-015-34960,SWISHER BJE STATE 001,2022-12-01,176,0,8764,24,7246,3038947,15207
300153496000,30-015-34960,SWISHER BJE STATE 001,2023-01-01,177,0,5871,30,7246,3044818,15237
300153496000,30-015-34960,SWISHER BJE STATE 001,2023-02-01,178,1,8293,51,7247,3053111,15288
300153496000,30-015-34960,SWISHER BJE STATE 001,2023-03-01,179,0,9647,54,7247,3062758,15342
300153496000,30-015-34960,SWISHER BJE STATE 001,2023-04-01,180,0,9215,50,7247,3071973,15392
300153496000,30-015-34960,SWISHER BJE STATE 001,2023-05-01,181,0,9347,30,7247,3081320,15422
300153496000,30-015-34960,SWISHER BJE STATE 001,2023-06-01,182,0,8955,46,7247,3090275,15468
300153496000,30-015-34960,SWISHER BJE STATE 001,2023-07-01,183,0,8784,62,7247,3099059,15530
300154172000,30-015-41720,TAOS FEDERAL 005H,2015-01-01,1,12779,16910,16046,12779,16910,16046
300154172000,30-015-41720,TAOS FEDERAL 005H,2015-02-01,2,15453,42749,24637,28232,59659,40683
300154172000,30-015-41720,TAOS FEDERAL 005H,2015-03-01,3,13413,64504,26980,41645,124163,67663
300154172000,30-015-41720,TAOS FEDERAL 005H,2015-04-01,4,8707,49442,19319,50352,173605,86982
300154172000,30-015-41720,TAOS FEDERAL 005H,2015-05-01,5,7465,40079,18144,57817,213684,105126
300154172000,30-015-41720,TAOS FEDERAL 005H,2015-06-01,6,6008,39078,14070,63825,252762,119196
300154172000,30-015-41720,TAOS FEDERAL 005H,2015-07-01,7,5254,39777,14382,69079,292539,133578
300154172000,30-015-41720,TAOS FEDERAL 005H,2015-08-01,8,4401,36949,13147,73480,329488,146725
300154172000,30-015-41720,TAOS FEDERAL 005H,2015-09-01,9,4149,33281,11596,77629,362769,158321
300154172000,30-015-41720,TAOS FEDERAL 005H,2015-10-01,10,3686,30537,10806,81315,393306,169127
300154172000,30-015-41720,TAOS FEDERAL 005H,2015-11-01,11,3305,26925,9495,84620,420231,178622
300154172000,30-015-41720,TAOS FEDERAL 005H,2015-12-01,12,2841,21734,7679,87461,441965,186301
300154172000,30-015-41720,TAOS FEDERAL 005H,2016-01-01,13,2469,15503,5979,89930,457468,192280
300154172000,30-015-41720,TAOS FEDERAL 005H,2016-02-01,14,3065,18299,8240,92995,475767,200520
300154172000,30-015-41720,TAOS FEDERAL 005H,2016-03-01,15,2816,19489,7664,95811,495256,208184
300154172000,30-015-41720,TAOS FEDERAL 005H,2016-04-01,16,2903,20793,6933,98714,516049,215117
300154172000,30-015-41720,TAOS FEDERAL 005H,2016-05-01,17,2450,22213,6855,101164,538262,221972
300154172000,30-015-41720,TAOS FEDERAL 005H,2016-06-01,18,2419,22470,8301,103583,560732,230273
300154172000,30-015-41720,TAOS FEDERAL 005H,2016-07-01,19,2017,23509,7112,105600,584241,237385
300154172000,30-015-41720,TAOS FEDERAL 005H,2016-08-01,20,2141,22805,7233,107741,607046,244618
300154172000,30-015-41720,TAOS FEDERAL 005H,2016-09-01,21,1897,21522,6809,109638,628568,251427
300154172000,30-015-41720,TAOS FEDERAL 005H,2016-10-01,22,1575,19917,6492,111213,648485,257919
300154172000,30-015-41720,TAOS FEDERAL 005H,2016-11-01,23,1632,17097,5521,112845,665582,263440
300154172000,30-015-41720,TAOS FEDERAL 005H,2016-12-01,24,1870,16522,5006,114715,682104,268446
300154172000,30-015-41720,TAOS FEDERAL 005H,2017-01-01,25,1450,16304,5054,116165,698408,273500
300154172000,30-015-41720,TAOS FEDERAL 005H,2017-02-01,26,1596,14146,3130,117761,712554,276630
300154172000,30-015-41720,TAOS FEDERAL 005H,2017-03-01,27,1366,14644,4165,119127,727198,280795
300154172000,30-015-41720,TAOS FEDERAL 005H,2017-04-01,28,1634,13695,3778,120761,740893,284573
300154172000,30-015-41720,TAOS FEDERAL 005H,2017-05-01,29,1564,14214,4028,122325,755107,288601
300154172000,30-015-41720,TAOS FEDERAL 005H,2017-06-01,30,1403,15086,4189,123728,770193,292790
300154172000,30-015-41720,TAOS FEDERAL 005H,2017-07-01,31,1396,13783,3987,125124,783976,296777
300154172000,30-015-41720,TAOS FEDERAL 005H,2017-08-01,32,1474,13993,4391,126598,797969,301168
300154172000,30-015-41720,TAOS FEDERAL 005H,2017-09-01,33,1356,13353,4328,127954,811322,305496
300154172000,30-015-41720,TAOS FEDERAL 005H,2017-10-01,34,1132,13612,4700,129086,824934,310196
300154172000,30-015-41720,TAOS FEDERAL 005H,2017-11-01,35,1439,12725,4363,130525,837659,314559
300154172000,30-015-41720,TAOS FEDERAL 005H,2017-12-01,36,1225,12766,3934,131750,850425,318493
300154172000,30-015-41720,TAOS FEDERAL 005H,2018-01-01,37,948,10806,2675,132698,861231,321168
300154172000,30-015-41720,TAOS FEDERAL 005H,2018-02-01,38,1018,10192,4027,133716,871423,325195
300154172000,30-015-41720,TAOS FEDERAL 005H,2018-03-01,39,1314,12411,4777,135030,883834,329972
300154172000,30-015-41720,TAOS FEDERAL 005H,2018-04-01,40,924,17806,3577,135954,901640,333549
300154172000,30-015-41720,TAOS FEDERAL 005H,2018-05-01,41,1235,12049,4385,137189,913689,337934
300154172000,30-015-41720,TAOS FEDERAL 005H,2018-06-01,42,1088,11234,4040,138277,924923,341974
300154172000,30-015-41720,TAOS FEDERAL 005H,2018-07-01,43,918,11874,4035,139195,936797,346009
300154172000,30-015-41720,TAOS FEDERAL 005H,2018-08-01,44,1219,11740,4388,140414,948537,350397
300154172000,30-015-41720,TAOS FEDERAL 005H,2018-09-01,45,1014,11324,4126,141428,959861,354523
300154172000,30-015-41720,TAOS FEDERAL 005H,2018-10-01,46,933,10913,3919,142361,970774,358442
300154172000,30-015-41720,TAOS FEDERAL 005H,2018-11-01,47,699,8498,2949,143060,979272,361391
300154172000,30-015-41720,TAOS FEDERAL 005H,2018-12-01,48,823,8788,3464,143883,988060,364855
300154172000,30-015-41720,TAOS FEDERAL 005H,2019-01-01,49,815,8723,3046,144698,996783,367901
300154172000,30-015-41720,TAOS FEDERAL 005H,2019-02-01,50,794,7632,2713,145492,1004415,370614
300154172000,30-015-41720,TAOS FEDERAL 005H,2019-03-01,51,893,8125,3712,146385,1012540,374326
300154172000,30-015-41720,TAOS FEDERAL 005H,2019-04-01,52,886,6977,3687,147271,1019517,378013
300154172000,30-015-41720,TAOS FEDERAL 005H,2019-05-01,53,953,6969,3501,148224,1026486,381514
300154172000,30-015-41720,TAOS FEDERAL 005H,2019-06-01,54,848,8043,3438,149072,1034529,384952
300154172000,30-015-41720,TAOS FEDERAL 005H,2019-07-01,55,923,9275,3229,149995,1043804,388181
300154172000,30-015-41720,TAOS FEDERAL 005H,2019-08-01,56,862,9618,3514,150857,1053422,391695
300154172000,30-015-41720,TAOS FEDERAL 005H,2019-09-01,57,674,9578,3675,151531,1063000,395370
300154172000,30-015-41720,TAOS FEDERAL 005H,2019-10-01,58,1083,10436,4120,152614,1073436,399490
300154172000,30-015-41720,TAOS FEDERAL 005H,2019-11-01,59,884,10053,3860,153498,1083489,403350
300154172000,30-015-41720,TAOS FEDERAL 005H,2019-12-01,60,764,9707,3423,154262,1093196,406773
300154172000,30-015-41720,TAOS FEDERAL 005H,2020-01-01,61,824,9696,3420,155086,1102892,410193
300154172000,30-015-41720,TAOS FEDERAL 005H,2020-02-01,62,741,8825,3191,155827,1111717,413384
300154172000,30-015-41720,TAOS FEDERAL 005H,2020-03-01,63,863,6272,3374,156690,1117989,416758
300154172000,30-015-41720,TAOS FEDERAL 005H,2020-04-01,64,0,21,0,156690,1118010,416758
300154172000,30-015-41720,TAOS FEDERAL 005H,2020-05-01,65,0,0,0,156690,1118010,416758
300154172000,30-015-41720,TAOS FEDERAL 005H,2020-06-01,66,795,12299,3162,157485,1130309,419920
300154172000,30-015-41720,TAOS FEDERAL 005H,2020-07-01,67,565,5915,1808,158050,1136224,421728
300154172000,30-015-41720,TAOS FEDERAL 005H,2020-08-01,68,610,6835,2681,158660,1143059,424409
300154172000,30-015-41720,TAOS FEDERAL 005H,2020-09-01,69,942,8427,3210,159602,1151486,427619
300154172000,30-015-41720,TAOS FEDERAL 005H,2020-10-01,70,782,8625,3749,160384,1160111,431368
300154172000,30-015-41720,TAOS FEDERAL 005H,2020-11-01,71,549,8374,2619,160933,1168485,433987
300154172000,30-015-41720,TAOS FEDERAL 005H,2020-12-01,72,1086,8320,1440,162019,1176805,435427
300154172000,30-015-41720,TAOS FEDERAL 005H,2021-01-01,73,806,7858,2699,162825,1184663,438126
300154172000,30-015-41720,TAOS FEDERAL 005H,2021-02-01,74,654,6703,2716,163479,1191366,440842
300154172000,30-015-41720,TAOS FEDERAL 005H,2021-03-01,75,680,8072,2497,164159,1199438,443339
300154172000,30-015-41720,TAOS FEDERAL 005H,2021-04-01,76,771,7679,2364,164930,1207117,445703
300154172000,30-015-41720,TAOS FEDERAL 005H,2021-05-01,77,411,8075,2178,165341,1215192,447881
300154172000,30-015-41720,TAOS FEDERAL 005H,2021-06-01,78,642,6684,2078,165983,1221876,449959
300154172000,30-015-41720,TAOS FEDERAL 005H,2021-07-01,79,579,8120,3483,166562,1229996,453442
300154172000,30-015-41720,TAOS FEDERAL 005H,2021-08-01,80,853,7787,2991,167415,1237783,456433
300154172000,30-015-41720,TAOS FEDERAL 005H,2021-09-01,81,675,7992,3082,168090,1245775,459515
300154172000,30-015-41720,TAOS FEDERAL 005H,2021-10-01,82,534,8629,2926,168624,1254404,462441
300154172000,30-015-41720,TAOS FEDERAL 005H,2021-11-01,83,765,8362,3069,169389,1262766,465510
300154172000,30-015-41720,TAOS FEDERAL 005H,2021-12-01,84,521,8307,2944,169910,1271073,468454
300154172000,30-015-41720,TAOS FEDERAL 005H,2022-01-01,85,723,7994,2801,170633,1279067,471255
300154172000,30-015-41720,TAOS FEDERAL 005H,2022-02-01,86,448,6514,2026,171081,1285581,473281
300154172000,30-015-41720,TAOS FEDERAL 005H,2022-03-01,87,305,5984,719,171386,1291565,474000
300154172000,30-015-41720,TAOS FEDERAL 005H,2022-04-01,88,530,6158,1840,171916,1297723,475840
300154172000,30-015-41720,TAOS FEDERAL 005H,2022-05-01,89,407,5445,1596,172323,1303168,477436
300154172000,30-015-41720,TAOS FEDERAL 005H,2022-06-01,90,305,6275,1852,172628,1309443,479288
300154172000,30-015-41720,TAOS FEDERAL 005H,2022-07-01,91,411,6049,1857,173039,1315492,481145
300154172000,30-015-41720,TAOS FEDERAL 005H,2022-08-01,92,522,5847,1898,173561,1321339,483043
300154172000,30-015-41720,TAOS FEDERAL 005H,2022-09-01,93,477,6078,2017,174038,1327417,485060
300154172000,30-015-41720,TAOS FEDERAL 005H,2022-10-01,94,481,5947,1973,174519,1333364,487033
300154172000,30-015-41720,TAOS FEDERAL 005H,2022-11-01,95,248,5139,1773,174767,1338503,488806
300154172000,30-015-41720,TAOS FEDERAL 005H,2022-12-01,96,648,5361,2082,175415,1343864,490888
300154172000,30-015-41720,TAOS FEDERAL 005H,2023-01-01,97,479,4899,1933,175894,1348763,492821
300154172000,30-015-41720,TAOS FEDERAL 005H,2023-02-01,98,454,5179,1508,176348,1353942,494329
300154172000,30-015-41720,TAOS FEDERAL 005H,2023-03-01,99,521,5656,1755,176869,1359598,496084
300154172000,30-015-41720,TAOS FEDERAL 005H,2023-04-01,100,456,5532,1838,177325,1365130,497922
300154172000,30-015-41720,TAOS FEDERAL 005H,2023-05-01,101,487,5872,1994,177812,1371002,499916
300154172000,30-015-41720,TAOS FEDERAL 005H,2023-06-01,102,304,2519,1353,178116,1373521,501269
300153288900,30-015-32889,HUMIDOR BMJ STATE COM 001,2004-03-01,1,0,2206,3,0,2206,3
300153288900,30-015-32889,HUMIDOR BMJ STATE COM 001,2004-04-01,2,0,71977,240,0,74183,243
300153288900,30-015-32889,HUMIDOR BMJ STATE COM 001,2004-05-01,3,0,48495,134,0,122678,377
300153288900,30-015-32889,HUMIDOR BMJ STATE COM 001,2004-06-01,4,0,31566,93,0,154244,470
300153288900,30-015-32889,HUMIDOR BMJ STATE COM 001,2004-07-01,5,0,23323,54,0,177567,524
300153288900,30-015-32889,HUMIDOR BMJ STATE COM 001,2004-08-01,6,0,18709,56,0,196276,580
300153288900,30-015-32889,HUMIDOR BMJ STATE COM 001,2004-09-01,7,0,15217,44,0,211493,624
300153288900,30-015-32889,HUMIDOR BMJ STATE COM 001,2004-10-01,8,0,13960,34,0,225453,658
300153288900,30-015-32889,HUMIDOR BMJ STATE COM 001,2004-11-01,9,0,12326,25,0,237779,683
300153288900,30-015-32889,HUMIDOR BMJ STATE COM 001,2004-12-01,10,0,12199,24,0,249978,707
300153288900,30-015-32889,HUMIDOR BMJ STATE COM 001,2005-01-01,11,0,11975,29,0,261953,736
300153288900,30-015-32889,HUMIDOR BMJ STATE COM 001,2005-02-01,12,0,10566,31,0,272519,767
300153288900,30-015-32889,HUMIDOR BMJ STATE COM 001,2005-03-01,13,0,11051,27,0,283570,794
300153288900,30-015-32889,HUMIDOR BMJ STATE COM 001,2005-04-01,14,0,9707,20,0,293277,814
300153288900,30-015-32889,HUMIDOR BMJ STATE COM 001,2005-05-01,15,0,10239,35,0,303516,849
300153288900,30-015-32889,HUMIDOR BMJ STATE COM 001,2005-06-01,16,0,9049,24,0,312565,873
300153288900,30-015-32889,HUMIDOR BMJ STATE COM 001,2005-07-01,17,0,8884,17,0,321449,890
300153288900,30-015-32889,HUMIDOR BMJ STATE COM 001,2005-08-01,18,0,7963,17,0,329412,907
300153288900,30-015-32889,HUMIDOR BMJ STATE COM 001,2005-09-01,19,0,7963,12,0,337375,919
300153288900,30-015-32889,HUMIDOR BMJ STATE COM 001,2005-10-01,20,0,8645,21,0,346020,940
300153288900,30-015-32889,HUMIDOR BMJ STATE COM 001,2005-11-01,21,0,7989,18,0,354009,958
300153288900,30-015-32889,HUMIDOR BMJ STATE COM 001,2005-12-01,22,0,7391,10,0,361400,968
300153288900,30-015-32889,HUMIDOR BMJ STATE COM 001,2006-01-01,23,0,8131,18,0,369531,986
300153288900,30-015-32889,HUMIDOR BMJ STATE COM 001,2006-02-01,24,0,6621,22,0,376152,1008
300153288900,30-015-32889,HUMIDOR BMJ STATE COM 001,2006-03-01,25,0,6758,10,0,382910,1018
300153288900,30-015-32889,HUMIDOR BMJ STATE COM 001,2006-04-01,26,0,7144,15,0,390054,1033
300153288900,30-015-32889,HUMIDOR BMJ STATE COM 001,2006-05-01,27,0,7170,19,0,397224,1052
300153288900,30-015-32889,HUMIDOR BMJ STATE COM 001,2006-06-01,28,0,6654,11,0,403878,1063
300153288900,30-015-32889,HUMIDOR BMJ STATE COM 001,2006-07-01,29,0,6968,16,0,410846,1079
300153288900,30-015-32889,HUMIDOR BMJ STATE COM 001,2006-08-01,30,0,7164,17,0,418010,1096
300153288900,30-015-32889,HUMIDOR BMJ STATE COM 001,2006-09-01,31,0,6863,17,0,424873,1113
300153288900,30-015-32889,HUMIDOR BMJ STATE COM 001,2006-10-01,32,0,6535,14,0,431408,1127
300153288900,30-015-32889,HUMIDOR BMJ STATE COM 001,2006-11-01,33,0,5845,10,0,437253,1137
300153288900,30-015-32889,HUMIDOR BMJ STATE COM 001,2006-12-01,34,0,6359,16,0,443612,1153
300153288900,30-015-32889,HUMIDOR BMJ STATE COM 001,2007-01-01,35,0,6113,18,0,449725,1171
300153288900,30-015-32889,HUMIDOR BMJ STATE COM 001,2007-02-01,36,0,6137,15,0,455862,1186
300153288900,30-015-32889,HUMIDOR BMJ STATE COM 001,2007-03-01,37,0,6511,15,0,462373,1201
300153288900,30-015-32889,HUMIDOR BMJ STATE COM 001,2007-04-01,38,0,5489,17,0,467862,1218
300153288900,30-015-32889,HUMIDOR BMJ STATE COM 001,2007-05-01,39,0,6240,18,0,474102,1236
300153288900,30-015-32889,HUMIDOR BMJ STATE COM 001,2007-06-01,40,0,5739,19,0,479841,1255
300153288900,30-015-32889,HUMIDOR BMJ STATE COM 001,2007-07-01,41,0,5281,10,0,485122,1265
300153288900,30-015-32889,HUMIDOR BMJ STATE COM 001,2007-08-01,42,0,5059,11,0,490181,1276
300153288900,30-015-32889,HUMIDOR BMJ STATE COM 001,2007-09-01,43,0,5535,31,0,495716,1307
300153288900,30-015-32889,HUMIDOR BMJ STATE COM 001,2007-10-01,44,0,4754,15,0,500470,1322
300153288900,30-015-32889,HUMIDOR BMJ STATE COM 001,2007-11-01,45,0,4520,6,0,504990,1328
300153288900,30-015-32889,HUMIDOR BMJ STATE COM 001,2007-12-01,46,0,4102,0,0,509092,1328
300153288900,30-015-32889,HUMIDOR BMJ STATE COM 001,2008-01-01,47,0,2751,5,0,511843,1333
300153288900,30-015-32889,HUMIDOR BMJ STATE COM 001,2008-02-01,48,0,116,0,0,511959,1333
300153288900,30-015-32889,HUMIDOR BMJ STATE COM 001,2008-03-01,49,0,11388,366,0,523347,1699
300153288900,30-015-32889,HUMIDOR BMJ STATE COM 001,2008-04-01,50,0,8188,286,0,531535,1985
300153288900,30-015-32889,HUMIDOR BMJ STATE COM 001,2008-05-01,51,0,7015,93,0,538550,2078
300153288900,30-015-32889,HUMIDOR BMJ STATE COM 001,2008-06-01,52,0,5960,43,0,544510,2121
300153288900,30-015-32889,HUMIDOR BMJ STATE COM 001,2008-07-01,53,0,5529,35,0,550039,2156
300153288900,30-015-32889,HUMIDOR BMJ STATE COM 001,2008-08-01,54,0,5288,59,0,555327,2215
300153288900,30-015-32889,HUMIDOR BMJ STATE COM 001,2008-09-01,55,0,4677,70,0,560004,2285
300153288900,30-015-32889,HUMIDOR BMJ STATE COM 001,2008-10-01,56,0,4541,65,0,564545,2350
300153288900,30-015-32889,HUMIDOR BMJ STATE COM 001,2008-11-01,57,0,4426,34,0,568971,2384
300153288900,30-015-32889,HUMIDOR BMJ STATE COM 001,2008-12-01,58,0,4346,29,0,573317,2413
300153288900,30-015-32889,HUMIDOR BMJ STATE COM 001,2009-01-01,59,0,4265,29,0,577582,2442
300153288900,30-015-32889,HUMIDOR BMJ STATE COM 001,2009-02-01,60,0,3732,24,0,581314,2466
300153288900,30-015-32889,HUMIDOR BMJ STATE COM 001,2009-03-01,61,0,4043,30,0,585357,2496
300153288900,30-015-32889,HUMIDOR BMJ STATE COM 001,2009-04-01,62,0,3795,26,0,589152,2522
300153288900,30-015-32889,HUMIDOR BMJ STATE COM 001,2009-05-01,63,0,3753,30,0,592905,2552
300153288900,30-015-32889,HUMIDOR BMJ STATE COM 001,2009-06-01,64,0,450,6,0,593355,2558
300153288900,30-015-32889,HUMIDOR BMJ STATE COM 001,2009-07-01,65,0,87,0,0,593442,2558
300153288900,30-015-32889,HUMIDOR BMJ STATE COM 001,2009-08-01,66,0,62,0,0,593504,2558
300153288900,30-015-32889,HUMIDOR BMJ STATE COM 001,2009-09-01,67,0,120,0,0,593624,2558
300153288900,30-015-32889,HUMIDOR BMJ STATE COM 001,2009-10-01,68,0,106,0,0,593730,2558
300153288900,30-015-32889,HUMIDOR BMJ STATE COM 001,2009-11-01,69,0,103,0,0,593833,2558
300153288900,30-015-32889,HUMIDOR BMJ STATE COM 001,2009-12-01,70,0,115,0,0,593948,2558
300153288900,30-015-32889,HUMIDOR BMJ STATE COM 001,2010-01-01,71,0,44,0,0,593992,2558
300153288900,30-015-32889,HUMIDOR BMJ STATE COM 001,2010-02-01,72,0,124,0,0,594116,2558
300153288900,30-015-32889,HUMIDOR BMJ STATE COM 001,2010-03-01,73,0,156,2,0,594272,2560
300153288900,30-015-32889,HUMIDOR BMJ STATE COM 001,2010-04-01,74,0,262,0,0,594534,2560
300153288900,30-015-32889,HUMIDOR BMJ STATE COM 001,2010-05-01,75,0,2217,2118,0,596751,4678
300153288900,30-015-32889,HUMIDOR BMJ STATE COM 001,2010-06-01,76,0,513,952,0,597264,5630
300153288900,30-015-32889,HUMIDOR BMJ STATE COM 001,2010-07-01,77,0,66,0,0,597330,5630
300153288900,30-015-32889,HUMIDOR BMJ STATE COM 001,2010-08-01,78,0,97,0,0,597427,5630
300153288900,30-015-32889,HUMIDOR BMJ STATE COM 001,2010-09-01,79,0,25,0,0,597452,5630
300153288900,30-015-32889,HUMIDOR BMJ STATE COM 001,2010-10-01,80,0,213,0,0,597665,5630
300153288900,30-015-32889,HUMIDOR BMJ STATE COM 001,2010-11-01,81,0,264,0,0,597929,5630
300153288900,30-015-32889,HUMIDOR BMJ STATE COM 001,2010-12-01,82,0,284,0,0,598213,5630
300153288900,30-015-32889,HUMIDOR BMJ STATE COM 001,2011-01-01,83,0,297,0,0,598510,5630
300153288900,30-015-32889,HUMIDOR BMJ STATE COM 001,2011-02-01,84,0,289,0,0,598799,5630
300153288900,30-015-32889,HUMIDOR BMJ STATE COM 001,2011-03-01,85,0,65,0,0,598864,5630
300153288900,30-015-32889,HUMIDOR BMJ STATE COM 001,2011-04-01,86,0,132,264,0,598996,5894
300153288900,30-015-32889,HUMIDOR BMJ STATE COM 001,2011-05-01,87,0,20,210,0,599016,6104
300153288900,30-015-32889,HUMIDOR BMJ STATE COM 001,2011-06-01,88,0,102,996,0,599118,7100
300153288900,30-015-32889,HUMIDOR BMJ STATE COM 001,2011-07-01,89,0,220,4082,0,599338,11182
300153288900,30-015-32889,HUMIDOR BMJ STATE COM 001,2011-08-01,90,0,198,4801,0,599536,15983
300153288900,30-015-32889,HUMIDOR BMJ STATE COM 001,2011-09-01,91,0,335,4665,0,599871,20648
300153288900,30-015-32889,HUMIDOR BMJ STATE COM 001,2011-10-01,92,0,396,4144,0,600267,24792
300153288900,30-015-32889,HUMIDOR BMJ STATE COM 001,2011-11-01,93,0,401,4514,0,600668,29306
300153288900,30-015-32889,HUMIDOR BMJ STATE COM 001,2011-12-01,94,0,431,4379,0,601099,33685
300153288900,30-015-32889,HUMIDOR BMJ STATE COM 001,2012-01-01,95,0,382,4610,0,601481,38295
300153288900,30-015-32889,HUMIDOR BMJ STATE COM 001,2012-02-01,96,0,808,3448,0,602289,41743
300153288900,30-015-32889,HUMIDOR BMJ STATE COM 001,2012-03-01,97,0,504,1077,0,602793,42820
300153288900,30-015-32889,HUMIDOR BMJ STATE COM 001,2012-04-01,98,0,2,0,0,602795,42820
300153288900,30-015-32889,HUMIDOR BMJ STATE COM 001,2012-05-01,99,0,6,202,0,602801,43022
300153288900,30-015-32889,HUMIDOR BMJ STATE COM 001,2012-06-01,100,0,42,971,0,602843,43993
300153288900,30-015-32889,HUMIDOR BMJ STATE COM 001,2012-07-01,101,0,25,212,0,602868,44205
300153288900,30-015-32889,HUMIDOR BMJ STATE COM 001,2012-08-01,102,0,9,0,0,602877,44205
300153288900,30-015-32889,HUMIDOR BMJ STATE COM 001,2012-09-01,103,0,13,0,0,602890,44205
300153288900,30-015-32889,HUMIDOR BMJ STATE COM 001,2012-10-01,104,0,0,0,0,602890,44205
300153288900,30-015-32889,HUMIDOR BMJ STATE COM 001,2012-11-01,105,0,2,0,0,602892,44205
300153288900,30-015-32889,HUMIDOR BMJ STATE COM 001,2012-12-01,106,0,5,0,0,602897,44205
300153288900,30-015-32889,HUMIDOR BMJ STATE COM 001,2013-01-01,107,0,13,0,0,602910,44205
300153288900,30-015-32889,HUMIDOR BMJ STATE COM 001,2013-02-01,108,0,5,0,0,602915,44205
300153288900,30-015-32889,HUMIDOR BMJ STATE COM 001,2013-03-01,109,0,2,0,0,602917,44205
300153288900,30-015-32889,HUMIDOR BMJ STATE COM 001,2013-04-01,110,0,0,0,0,602917,44205
300153288900,30-015-32889,HUMIDOR BMJ STATE COM 001,2013-05-01,111,0,1,0,0,602918,44205
300153288900,30-015-32889,HUMIDOR BMJ STATE COM 001,2013-06-01,112,0,0,0,0,602918,44205
300153288900,30-015-32889,HUMIDOR BMJ STATE COM 001,2013-07-01,113,0,3,0,0,602921,44205
300153288900,30-015-32889,HUMIDOR BMJ STATE COM 001,2013-08-01,114,0,3,0,0,602924,44205
300153288900,30-015-32889,HUMIDOR BMJ STATE COM 001,2013-09-01,115,0,2,0,0,602926,44205
300153288900,30-015-32889,HUMIDOR BMJ STATE COM 001,2013-10-01,116,0,0,0,0,602926,44205
300153288900,30-015-32889,HUMIDOR BMJ STATE COM 001,2013-11-01,117,0,1,0,0,602927,44205
300153288900,30-015-32889,HUMIDOR BMJ STATE COM 001,2013-12-01,118,0,1,0,0,602928,44205
300153288900,30-015-32889,HUMIDOR BMJ STATE COM 001,2014-01-01,119,0,0,0,0,602928,44205
300153288900,30-015-32889,HUMIDOR BMJ STATE COM 001,2014-02-01,120,0,0,0,0,602928,44205
300153288900,30-015-32889,HUMIDOR BMJ STATE COM 001,2014-03-01,121,0,0,0,0,602928,44205
300153288900,30-015-32889,HUMIDOR BMJ STATE COM 001,2014-04-01,122,0,0,0,0,602928,44205
300153288900,30-015-32889,HUMIDOR BMJ STATE COM 001,2014-05-01,123,0,0,0,0,602928,44205
300153288900,30-015-32889,HUMIDOR BMJ STATE COM 001,2014-06-01,124,0,0,0,0,602928,44205
300153288900,30-015-32889,HUMIDOR BMJ STATE COM 001,2014-07-01,125,0,0,0,0,602928,44205
300153288900,30-015-32889,HUMIDOR BMJ STATE COM 001,2014-08-01,126,0,114,0,0,603042,44205
300153288900,30-015-32889,HUMIDOR BMJ STATE COM 001,2014-09-01,127,0,0,0,0,603042,44205
300153288900,30-015-32889,HUMIDOR BMJ STATE COM 001,2014-10-01,128,0,0,0,0,603042,44205
300153288900,30-015-32889,HUMIDOR BMJ STATE COM 001,2014-11-01,129,0,0,0,0,603042,44205
300153288900,30-015-32889,HUMIDOR BMJ STATE COM 001,2014-12-01,130,0,1,0,0,603043,44205
300153288900,30-015-32889,HUMIDOR BMJ STATE COM 001,2015-01-01,131,0,0,0,0,603043,44205
300153288900,30-015-32889,HUMIDOR BMJ STATE COM 001,2015-02-01,132,0,1,0,0,603044,44205
300153288900,30-015-32889,HUMIDOR BMJ STATE COM 001,2015-03-01,133,9,0,10,9,603044,44215
300153288900,30-015-32889,HUMIDOR BMJ STATE COM 001,2015-04-01,134,0,1,0,9,603045,44215
300153288900,30-015-32889,HUMIDOR BMJ STATE COM 001,2015-05-01,135,0,0,0,9,603045,44215
300153288900,30-015-32889,HUMIDOR BMJ STATE COM 001,2015-06-01,136,0,0,0,9,603045,44215
300153288900,30-015-32889,HUMIDOR BMJ STATE COM 001,2015-07-01,137,9,1,25,18,603046,44240
300153288900,30-015-32889,HUMIDOR BMJ STATE COM 001,2015-08-01,138,0,0,0,18,603046,44240
300153288900,30-015-32889,HUMIDOR BMJ STATE COM 001,2015-09-01,139,5,0,0,23,603046,44240
300153288900,30-015-32889,HUMIDOR BMJ STATE COM 001,2015-10-01,140,3,0,0,26,603046,44240
300153288900,30-015-32889,HUMIDOR BMJ STATE COM 001,2015-11-01,141,0,2,0,26,603048,44240
300153288900,30-015-32889,HUMIDOR BMJ STATE COM 001,2015-12-01,142,0,4,0,26,603052,44240
300153288900,30-015-32889,HUMIDOR BMJ STATE COM 001,2016-01-01,143,0,1,0,26,603053,44240
300153288900,30-015-32889,HUMIDOR BMJ STATE COM 001,2016-02-01,144,6,0,13,32,603053,44253
300153288900,30-015-32889,HUMIDOR BMJ STATE COM 001,2016-03-01,145,2,5,15,34,603058,44268
300153288900,30-015-32889,HUMIDOR BMJ STATE COM 001,2016-04-01,146,0,13,0,34,603071,44268
300153288900,30-015-32889,HUMIDOR BMJ STATE COM 001,2016-05-01,147,3,3,15,37,603074,44283
300153288900,30-015-32889,HUMIDOR BMJ STATE COM 001,2016-06-01,148,0,10,0,37,603084,44283
300153288900,30-015-32889,HUMIDOR BMJ STATE COM 001,2016-07-01,149,5,1,15,42,603085,44298
300153288900,30-015-32889,HUMIDOR BMJ STATE COM 001,2016-08-01,150,5,0,15,47,603085,44313
300153288900,30-015-32889,HUMIDOR BMJ STATE COM 001,2016-09-01,151,6,1,150,53,603086,44463
300153288900,30-015-32889,HUMIDOR BMJ STATE COM 001,2016-10-01,152,6,1,15,59,603087,44478
300153288900,30-015-32889,HUMIDOR BMJ STATE COM 001,2016-11-01,153,4,0,15,63,603087,44493
300153288900,30-015-32889,HUMIDOR BMJ STATE COM 001,2016-12-01,154,5,0,15,68,603087,44508
300153288900,30-015-32889,HUMIDOR BMJ STATE COM 001,2017-01-01,155,5,0,15,73,603087,44523
300153288900,30-015-32889,HUMIDOR BMJ STATE COM 001,2017-02-01,156,0,0,0,73,603087,44523
300153288900,30-015-32889,HUMIDOR BMJ STATE COM 001,2017-03-01,157,0,25,0,73,603112,44523
300153288900,30-015-32889,HUMIDOR BMJ STATE COM 001,2017-04-01,158,0,51,18,73,603163,44541
300153288900,30-015-32889,HUMIDOR BMJ STATE COM 001,2017-05-01,159,0,30,6,73,603193,44547
300153288900,30-015-32889,HUMIDOR BMJ STATE COM 001,2017-06-01,160,4,14,12,77,603207,44559
300153288900,30-015-32889,HUMIDOR BMJ STATE COM 001,2017-07-01,161,7,3,39,84,603210,44598
300153288900,30-015-32889,HUMIDOR BMJ STATE COM 001,2017-08-01,162,32,58,147,116,603268,44745
300153288900,30-015-32889,HUMIDOR BMJ STATE COM 001,2017-09-01,163,0,30,866,116,603298,45611
300153288900,30-015-32889,HUMIDOR BMJ STATE COM 001,2017-10-01,164,0,215,1134,116,603513,46745
300153288900,30-015-32889,HUMIDOR BMJ STATE COM 001,2017-11-01,165,0,216,1170,116,603729,47915
300153288900,30-015-32889,HUMIDOR BMJ STATE COM 001,2017-12-01,166,0,222,832,116,603951,48747
300153288900,30-015-32889,HUMIDOR BMJ STATE COM 001,2018-01-01,167,0,363,439,116,604314,49186
300153288900,30-015-32889,HUMIDOR BMJ STATE COM 001,2018-02-01,168,0,334,444,116,604648,49630
300153288900,30-015-32889,HUMIDOR BMJ STATE COM 001,2018-03-01,169,0,311,108,116,604959,49738
300153288900,30-015-32889,HUMIDOR BMJ STATE COM 001,2018-04-01,170,0,335,23,116,605294,49761
300153288900,30-015-32889,HUMIDOR BMJ STATE COM 001,2018-05-01,171,0,418,84,116,605712,49845
300153288900,30-015-32889,HUMIDOR BMJ STATE COM 001,2018-06-01,172,0,396,153,116,606108,49998
300153288900,30-015-32889,HUMIDOR BMJ STATE COM 001,2018-07-01,173,0,345,124,116,606453,50122
300153288900,30-015-32889,HUMIDOR BMJ STATE COM 001,2018-08-01,174,0,212,448,116,606665,50570
300153288900,30-015-32889,HUMIDOR BMJ STATE COM 001,2018-09-01,175,0,244,175,116,606909,50745
300153288900,30-015-32889,HUMIDOR BMJ STATE COM 001,2018-10-01,176,0,283,93,116,607192,50838
300153288900,30-015-32889,HUMIDOR BMJ STATE COM 001,2018-11-01,177,0,447,30,116,607639,50868
300153288900,30-015-32889,HUMIDOR BMJ STATE COM 001,2018-12-01,178,0,294,218,116,607933,51086
300153288900,30-015-32889,HUMIDOR BMJ STATE COM 001,2019-01-01,179,0,233,686,116,608166,51772
300153288900,30-015-32889,HUMIDOR BMJ STATE COM 001,2019-02-01,180,0,13,651,116,608179,52423
300153288900,30-015-32889,HUMIDOR BMJ STATE COM 001,2019-03-01,181,1,10,556,117,608189,52979
300153288900,30-015-32889,HUMIDOR BMJ STATE COM 001,2019-04-01,182,0,34,531,117,608223,53510
300153288900,30-015-32889,HUMIDOR BMJ STATE COM 001,2019-05-01,183,0,124,86,117,608347,53596
300153288900,30-015-32889,HUMIDOR BMJ STATE COM 001,2019-06-01,184,0,118,450,117,608465,54046
300153288900,30-015-32889,HUMIDOR BMJ STATE COM 001,2019-07-01,185,0,191,242,117,608656,54288
300153288900,30-015-32889,HUMIDOR BMJ STATE COM 001,2019-08-01,186,0,249,180,117,608905,54468
300153288900,30-015-32889,HUMIDOR BMJ STATE COM 001,2019-09-01,187,0,235,382,117,609140,54850
300153288900,30-015-32889,HUMIDOR BMJ STATE COM 001,2019-10-01,188,0,275,77,117,609415,54927
300153288900,30-015-32889,HUMIDOR BMJ STATE COM 001,2019-11-01,189,0,261,99,117,609676,55026
300153288900,30-015-32889,HUMIDOR BMJ STATE COM 001,2019-12-01,190,0,229,139,117,609905,55165
300153288900,30-015-32889,HUMIDOR BMJ STATE COM 001,2020-01-01,191,0,389,99,117,610294,55264
300153288900,30-015-32889,HUMIDOR BMJ STATE COM 001,2020-02-01,192,0,477,0,117,610771,55264
300153288900,30-015-32889,HUMIDOR BMJ STATE COM 001,2020-03-01,193,0,386,0,117,611157,55264
300153288900,30-015-32889,HUMIDOR BMJ STATE COM 001,2020-04-01,194,0,32,35,117,611189,55299
300153288900,30-015-32889,HUMIDOR BMJ STATE COM 001,2020-05-01,195,0,6,0,117,611195,55299
300153288900,30-015-32889,HUMIDOR BMJ STATE COM 001,2020-06-01,196,0,5,0,117,611200,55299
300153288900,30-015-32889,HUMIDOR BMJ STATE COM 001,2020-07-01,197,0,0,0,117,611200,55299
300153288900,30-015-32889,HUMIDOR BMJ STATE COM 001,2020-08-01,198,0,1,0,117,611201,55299
300153288900,30-015-32889,HUMIDOR BMJ STATE COM 001,2020-09-01,199,0,0,0,117,611201,55299
300153288900,30-015-32889,HUMIDOR BMJ STATE COM 001,2020-10-01,200,0,0,0,117,611201,55299
300153288900,30-015-32889,HUMIDOR BMJ STATE COM 001,2020-11-01,201,0,0,0,117,611201,55299
300153288900,30-015-32889,HUMIDOR BMJ STATE COM 001,2020-12-01,202,0,0,0,117,611201,55299
300153288900,30-015-32889,HUMIDOR BMJ STATE COM 001,2021-01-01,203,0,0,0,117,611201,55299
300153288900,30-015-32889,HUMIDOR BMJ STATE COM 001,2021-02-01,204,0,27,0,117,611228,55299
300153288900,30-015-32889,HUMIDOR BMJ STATE COM 001,2021-03-01,205,0,347,3,117,611575,55302
300153288900,30-015-32889,HUMIDOR BMJ STATE COM 001,2021-04-01,206,0,169,0,117,611744,55302
300153288900,30-015-32889,HUMIDOR BMJ STATE COM 001,2021-05-01,207,0,199,0,117,611943,55302
300153288900,30-015-32889,HUMIDOR BMJ STATE COM 001,2021-06-01,208,0,265,45,117,612208,55347
300153288900,30-015-32889,HUMIDOR BMJ STATE COM 001,2021-07-01,209,0,238,0,117,612446,55347
300153288900,30-015-32889,HUMIDOR BMJ STATE COM 001,2021-08-01,210,0,284,0,117,612730,55347
300153288900,30-015-32889,HUMIDOR BMJ STATE COM 001,2021-09-01,211,0,477,0,117,613207,55347
300153288900,30-015-32889,HUMIDOR BMJ STATE COM 001,2021-10-01,212,0,506,0,117,613713,55347
300153288900,30-015-32889,HUMIDOR BMJ STATE COM 001,2021-11-01,213,0,464,0,117,614177,55347
300153288900,30-015-32889,HUMIDOR BMJ STATE COM 001,2021-12-01,214,0,453,0,117,614630,55347
300153288900,30-015-32889,HUMIDOR BMJ STATE COM 001,2022-01-01,215,0,364,238,117,614994,55585
300153288900,30-015-32889,HUMIDOR BMJ STATE COM 001,2022-02-01,216,0,242,276,117,615236,55861
300153288900,30-015-32889,HUMIDOR BMJ STATE COM 001,2022-03-01,217,0,35,112,117,615271,55973
300153288900,30-015-32889,HUMIDOR BMJ STATE COM 001,2022-04-01,218,0,27,0,117,615298,55973
300153288900,30-015-32889,HUMIDOR BMJ STATE COM 001,2022-05-01,219,0,9,0,117,615307,55973
300153288900,30-015-32889,HUMIDOR BMJ STATE COM 001,2022-06-01,220,0,7,0,117,615314,55973
300153288900,30-015-32889,HUMIDOR BMJ STATE COM 001,2022-07-01,221,0,15,0,117,615329,55973
300153288900,30-015-32889,HUMIDOR BMJ STATE COM 001,2022-08-01,222,0,14,0,117,615343,55973
300153288900,30-015-32889,HUMIDOR BMJ STATE COM 001,2022-09-01,223,0,39,0,117,615382,55973
300153288900,30-015-32889,HUMIDOR BMJ STATE COM 001,2022-10-01,224,0,11,0,117,615393,55973
300153288900,30-015-32889,HUMIDOR BMJ STATE COM 001,2022-11-01,225,0,11,0,117,615404,55973
300153288900,30-015-32889,HUMIDOR BMJ STATE COM 001,2022-12-01,226,0,3,0,117,615407,55973
300153288900,30-015-32889,HUMIDOR BMJ STATE COM 001,2023-01-01,227,0,0,0,117,615407,55973
300153288900,30-015-32889,HUMIDOR BMJ STATE COM 001,2023-02-01,228,0,1,0,117,615408,55973
300153553600,30-015-35536,SPANISH CEDAR STATE 001,2007-12-01,1,0,7236,16,0,7236,16
300153553600,30-015-35536,SPANISH CEDAR STATE 001,2008-01-01,2,0,1738,1,0,8974,17
300153553600,30-015-35536,SPANISH CEDAR STATE 001,2008-02-01,3,0,462,0,0,9436,17
300153553600,30-015-35536,SPANISH CEDAR STATE 001,2008-03-01,4,0,25,0,0,9461,17
300154446200,30-015-44462,ARCHDUKE 19 W2AP FEDERAL COM 001H,2018-03-01,1,3111,36378,57290,3111,36378,57290
300154446200,30-015-44462,ARCHDUKE 19 W2AP FEDERAL COM 001H,2018-04-01,2,13508,152651,68999,16619,189029,126289
300154446200,30-015-44462,ARCHDUKE 19 W2AP FEDERAL COM 001H,2018-05-01,3,9538,137359,58510,26157,326388,184799
300154446200,30-015-44462,ARCHDUKE 19 W2AP FEDERAL COM 001H,2018-06-01,4,6652,105643,38706,32809,432031,223505
300154446200,30-015-44462,ARCHDUKE 19 W2AP FEDERAL COM 001H,2018-07-01,5,5346,80001,29115,38155,512032,252620
300154446200,30-015-44462,ARCHDUKE 19 W2AP FEDERAL COM 001H,2018-08-01,6,3970,64044,33194,42125,576076,285814
300154446200,30-015-44462,ARCHDUKE 19 W2AP FEDERAL COM 001H,2018-09-01,7,3332,50206,16061,45457,626282,301875
300154446200,30-015-44462,ARCHDUKE 19 W2AP FEDERAL COM 001H,2018-10-01,8,1850,26865,8357,47307,653147,310232
300154446200,30-015-44462,ARCHDUKE 19 W2AP FEDERAL COM 001H,2018-11-01,9,2927,35653,15241,50234,688800,325473
300154446200,30-015-44462,ARCHDUKE 19 W2AP FEDERAL COM 001H,2018-12-01,10,3591,45959,16962,53825,734759,342435
300154446200,30-015-44462,ARCHDUKE 19 W2AP FEDERAL COM 001H,2019-01-01,11,3199,39552,13554,57024,774311,355989
300154446200,30-015-44462,ARCHDUKE 19 W2AP FEDERAL COM 001H,2019-02-01,12,2705,28578,13503,59729,802889,369492
300154446200,30-015-44462,ARCHDUKE 19 W2AP FEDERAL COM 001H,2019-03-01,13,2873,30236,13374,62602,833125,382866
300154446200,30-015-44462,ARCHDUKE 19 W2AP FEDERAL COM 001H,2019-04-01,14,2776,27013,18043,65378,860138,400909
300154446200,30-015-44462,ARCHDUKE 19 W2AP FEDERAL COM 001H,2019-05-01,15,2416,24741,13402,67794,884879,414311
300154446200,30-015-44462,ARCHDUKE 19 W2AP FEDERAL COM 001H,2019-06-01,16,2696,27445,12403,70490,912324,426714
300154446200,30-015-44462,ARCHDUKE 19 W2AP FEDERAL COM 001H,2019-07-01,17,2780,38928,13106,73270,951252,439820
300154446200,30-015-44462,ARCHDUKE 19 W2AP FEDERAL COM 001H,2019-08-01,18,2067,27815,9670,75337,979067,449490
300154446200,30-015-44462,ARCHDUKE 19 W2AP FEDERAL COM 001H,2019-09-01,19,2266,30166,11725,77603,1009233,461215
300154446200,30-015-44462,ARCHDUKE 19 W2AP FEDERAL COM 001H,2019-10-01,20,2428,30689,11628,80031,1039922,472843
300154446200,30-015-44462,ARCHDUKE 19 W2AP FEDERAL COM 001H,2019-11-01,21,2289,29158,10052,82320,1069080,482895
300154446200,30-015-44462,ARCHDUKE 19 W2AP FEDERAL COM 001H,2019-12-01,22,2022,25977,9486,84342,1095057,492381
300154446200,30-015-44462,ARCHDUKE 19 W2AP FEDERAL COM 001H,2020-01-01,23,2001,26094,10128,86343,1121151,502509
300154446200,30-015-44462,ARCHDUKE 19 W2AP FEDERAL COM 001H,2020-02-01,24,2033,27702,10292,88376,1148853,512801
300154446200,30-015-44462,ARCHDUKE 19 W2AP FEDERAL COM 001H,2020-03-01,25,1868,27721,8931,90244,1176574,521732
300154446200,30-015-44462,ARCHDUKE 19 W2AP FEDERAL COM 001H,2020-04-01,26,275,5147,1461,90519,1181721,523193
300154446200,30-015-44462,ARCHDUKE 19 W2AP FEDERAL COM 001H,2020-05-01,27,611,7985,2665,91130,1189706,525858
300154446200,30-015-44462,ARCHDUKE 19 W2AP FEDERAL COM 001H,2020-06-01,28,2267,29999,14161,93397,1219705,540019
300154446200,30-015-44462,ARCHDUKE 19 W2AP FEDERAL COM 001H,2020-07-01,29,2000,31556,11363,95397,1251261,551382
300154446200,30-015-44462,ARCHDUKE 19 W2AP FEDERAL COM 001H,2020-08-01,30,1762,26918,10372,97159,1278179,561754
300154446200,30-015-44462,ARCHDUKE 19 W2AP FEDERAL COM 001H,2020-09-01,31,1609,21854,9452,98768,1300033,571206
300154446200,30-015-44462,ARCHDUKE 19 W2AP FEDERAL COM 001H,2020-10-01,32,1560,23480,8172,100328,1323513,579378
300154446200,30-015-44462,ARCHDUKE 19 W2AP FEDERAL COM 001H,2020-11-01,33,1503,20665,9398,101831,1344178,588776
300154446200,30-015-44462,ARCHDUKE 19 W2AP FEDERAL COM 001H,2020-12-01,34,1192,17404,7242,103023,1361582,596018
300154446200,30-015-44462,ARCHDUKE 19 W2AP FEDERAL COM 001H,2021-01-01,35,1484,20959,7979,104507,1382541,603997
300154446200,30-015-44462,ARCHDUKE 19 W2AP FEDERAL COM 001H,2021-02-01,36,1251,15198,6277,105758,1397739,610274
300154446200,30-015-44462,ARCHDUKE 19 W2AP FEDERAL COM 001H,2021-03-01,37,1495,21322,8181,107253,1419061,618455
300154446200,30-015-44462,ARCHDUKE 19 W2AP FEDERAL COM 001H,2021-04-01,38,1393,20601,7795,108646,1439662,626250
300154446200,30-015-44462,ARCHDUKE 19 W2AP FEDERAL COM 001H,2021-05-01,39,1364,21286,7888,110010,1460948,634138
300154446200,30-015-44462,ARCHDUKE 19 W2AP FEDERAL COM 001H,2021-06-01,40,1261,19518,7121,111271,1480466,641259
300154446200,30-015-44462,ARCHDUKE 19 W2AP FEDERAL COM 001H,2021-07-01,41,1301,20516,7147,112572,1500982,648406
300154446200,30-015-44462,ARCHDUKE 19 W2AP FEDERAL COM 001H,2021-08-01,42,1256,19756,6943,113828,1520738,655349
300154446200,30-015-44462,ARCHDUKE 19 W2AP FEDERAL COM 001H,2021-09-01,43,1157,18764,7311,114985,1539502,662660
300154446200,30-015-44462,ARCHDUKE 19 W2AP FEDERAL COM 001H,2021-10-01,44,1243,19865,7478,116228,1559367,670138
300154446200,30-015-44462,ARCHDUKE 19 W2AP FEDERAL COM 001H,2021-11-01,45,1136,18984,6490,117364,1578351,676628
300154446200,30-015-44462,ARCHDUKE 19 W2AP FEDERAL COM 001H,2021-12-01,46,1026,19007,6740,118390,1597358,683368
300154446200,30-015-44462,ARCHDUKE 19 W2AP FEDERAL COM 001H,2022-01-01,47,1608,17142,5360,119998,1614500,688728
300154446200,30-015-44462,ARCHDUKE 19 W2AP FEDERAL COM 001H,2022-02-01,48,633,13799,4574,120631,1628299,693302
300154446200,30-015-44462,ARCHDUKE 19 W2AP FEDERAL COM 001H,2022-03-01,49,1193,17577,5912,121824,1645876,699214
300154446200,30-015-44462,ARCHDUKE 19 W2AP FEDERAL COM 001H,2022-04-01,50,1060,15329,4993,122884,1661205,704207
300154446200,30-015-44462,ARCHDUKE 19 W2AP FEDERAL COM 001H,2022-05-01,51,1064,16609,5183,123948,1677814,709390
300154446200,30-015-44462,ARCHDUKE 19 W2AP FEDERAL COM 001H,2022-06-01,52,1087,16465,5439,125035,1694279,714829
300154446200,30-015-44462,ARCHDUKE 19 W2AP FEDERAL COM 001H,2022-07-01,53,1177,17866,5722,126212,1712145,720551
300154446200,30-015-44462,ARCHDUKE 19 W2AP FEDERAL COM 001H,2022-08-01,54,1083,16848,5042,127295,1728993,725593
300154446200,30-015-44462,ARCHDUKE 19 W2AP FEDERAL COM 001H,2022-09-01,55,1090,16215,5553,128385,1745208,731146
300154446200,30-015-44462,ARCHDUKE 19 W2AP FEDERAL COM 001H,2022-10-01,56,1079,16311,6433,129464,1761519,737579
300154446200,30-015-44462,ARCHDUKE 19 W2AP FEDERAL COM 001H,2022-11-01,57,921,12399,6795,130385,1773918,744374
300154446200,30-015-44462,ARCHDUKE 19 W2AP FEDERAL COM 001H,2022-12-01,58,1031,13640,6386,131416,1787558,750760
300154446200,30-015-44462,ARCHDUKE 19 W2AP FEDERAL COM 001H,2023-01-01,59,405,5924,4339,131821,1793482,755099
300154446200,30-015-44462,ARCHDUKE 19 W2AP FEDERAL COM 001H,2023-02-01,60,946,12193,6694,132767,1805675,761793
300154446200,30-015-44462,ARCHDUKE 19 W2AP FEDERAL COM 001H,2023-03-01,61,1289,13133,10013,134056,1818808,771806
300154446200,30-015-44462,ARCHDUKE 19 W2AP FEDERAL COM 001H,2023-04-01,62,987,17821,8423,135043,1836629,780229
300154446200,30-015-44462,ARCHDUKE 19 W2AP FEDERAL COM 001H,2023-05-01,63,1064,17421,9157,136107,1854050,789386
300154446200,30-015-44462,ARCHDUKE 19 W2AP FEDERAL COM 001H,2023-06-01,64,635,11383,4791,136742,1865433,794177
300154446200,30-015-44462,ARCHDUKE 19 W2AP FEDERAL COM 001H,2023-07-01,65,890,14869,5040,137632,1880302,799217
300153553600,30-015-35536,SPANISH CEDAR STATE 001,2008-04-01,1,0,49,58,0,9510,75
300153553600,30-015-35536,SPANISH CEDAR STATE 001,2008-05-01,2,0,31,127,0,9541,202
300153553600,30-015-35536,SPANISH CEDAR STATE 001,2008-06-01,3,0,4,81,0,9545,283
300153553600,30-015-35536,SPANISH CEDAR STATE 001,2008-07-01,1,247,0,3492,247,9545,3775
300153553600,30-015-35536,SPANISH CEDAR STATE 001,2008-08-01,2,251,499,3204,498,10044,6979
300153553600,30-015-35536,SPANISH CEDAR STATE 001,2008-09-01,3,98,688,1081,596,10732,8060
300153553600,30-015-35536,SPANISH CEDAR STATE 001,2008-10-01,4,131,633,3345,727,11365,11405
300153553600,30-015-35536,SPANISH CEDAR STATE 001,2008-11-01,5,204,1008,2924,931,12373,14329
300153553600,30-015-35536,SPANISH CEDAR STATE 001,2008-12-01,6,223,1398,3168,1154,13771,17497
300153553600,30-015-35536,SPANISH CEDAR STATE 001,2009-01-01,7,185,1397,3116,1339,15168,20613
300153553600,30-015-35536,SPANISH CEDAR STATE 001,2009-02-01,8,162,1251,2599,1501,16419,23212
300153553600,30-015-35536,SPANISH CEDAR STATE 001,2009-03-01,9,132,867,2322,1633,17286,25534
300153553600,30-015-35536,SPANISH CEDAR STATE 001,2009-04-01,10,112,626,2065,1745,17912,27599
300153553600,30-015-35536,SPANISH CEDAR STATE 001,2009-05-01,11,114,690,2101,1859,18602,29700
300153553600,30-015-35536,SPANISH CEDAR STATE 001,2009-06-01,12,95,496,1753,1954,19098,31453
300153553600,30-015-35536,SPANISH CEDAR STATE 001,2009-07-01,13,108,504,2057,2062,19602,33510
300153553600,30-015-35536,SPANISH CEDAR STATE 001,2009-08-01,14,90,424,1612,2152,20026,35122
300153553600,30-015-35536,SPANISH CEDAR STATE 001,2009-09-01,15,86,336,1786,2238,20362,36908
300153553600,30-015-35536,SPANISH CEDAR STATE 001,2009-10-01,16,88,275,1725,2326,20637,38633
300153553600,30-015-35536,SPANISH CEDAR STATE 001,2009-11-01,17,73,199,1601,2399,20836,40234
300153553600,30-015-35536,SPANISH CEDAR STATE 001,2009-12-01,18,89,177,1645,2488,21013,41879
300153553600,30-015-35536,SPANISH CEDAR STATE 001,2010-01-01,19,77,230,1484,2565,21243,43363
300153553600,30-015-35536,SPANISH CEDAR STATE 001,2010-02-01,20,75,262,1427,2640,21505,44790
300153553600,30-015-35536,SPANISH CEDAR STATE 001,2010-03-01,21,80,496,1495,2720,22001,46285
300153553600,30-015-35536,SPANISH CEDAR STATE 001,2010-04-01,22,67,529,1395,2787,22530,47680
300153553600,30-015-35536,SPANISH CEDAR STATE 001,2010-05-01,23,72,491,1407,2859,23021,49087
300153553600,30-015-35536,SPANISH CEDAR STATE 001,2010-06-01,24,50,382,1253,2909,23403,50340
300153553600,30-015-35536,SPANISH CEDAR STATE 001,2010-07-01,25,81,582,1580,2990,23985,51920
300153553600,30-015-35536,SPANISH CEDAR STATE 001,2010-08-01,26,33,264,710,3023,24249,52630
300153553600,30-015-35536,SPANISH CEDAR STATE 001,2010-09-01,1,0,4481,2196,3023,28730,54826
300153553600,30-015-35536,SPANISH CEDAR STATE 001,2010-10-01,2,88,5675,975,3111,34405,55801
300153553600,30-015-35536,SPANISH CEDAR STATE 001,2010-11-01,3,54,4057,438,3165,38462,56239
300153553600,30-015-35536,SPANISH CEDAR STATE 001,2010-12-01,4,19,3523,258,3184,41985,56497
300153553600,30-015-35536,SPANISH CEDAR STATE 001,2011-01-01,5,6,3534,190,3190,45519,56687
300153553600,30-015-35536,SPANISH CEDAR STATE 001,2011-02-01,6,30,2917,93,3220,48436,56780
300153553600,30-015-35536,SPANISH CEDAR STATE 001,2011-03-01,7,17,2598,200,3237,51034,56980
300153553600,30-015-35536,SPANISH CEDAR STATE 001,2011-04-01,8,0,4305,166,3237,55339,57146
300153553600,30-015-35536,SPANISH CEDAR STATE 001,2011-05-01,9,3,3727,54,3240,59066,57200
300153553600,30-015-35536,SPANISH CEDAR STATE 001,2011-06-01,10,0,3015,114,3240,62081,57314
300153553600,30-015-35536,SPANISH CEDAR STATE 001,2011-07-01,11,0,2856,35,3240,64937,57349
300153553600,30-015-35536,SPANISH CEDAR STATE 001,2011-08-01,12,0,2537,8,3240,67474,57357
300153553600,30-015-35536,SPANISH CEDAR STATE 001,2011-09-01,13,0,1799,6,3240,69273,57363
300153553600,30-015-35536,SPANISH CEDAR STATE 001,2011-10-01,14,0,1371,0,3240,70644,57363
300153553600,30-015-35536,SPANISH CEDAR STATE 001,2011-11-01,15,0,2691,697,3240,73335,58060
300153553600,30-015-35536,SPANISH CEDAR STATE 001,2011-12-01,16,0,2390,0,3240,75725,58060
300153553600,30-015-35536,SPANISH CEDAR STATE 001,2012-01-01,17,0,1707,0,3240,77432,58060
300153553600,30-015-35536,SPANISH CEDAR STATE 001,2012-02-01,18,0,344,0,3240,77776,58060
300153553600,30-015-35536,SPANISH CEDAR STATE 001,2012-03-01,19,0,1390,8,3240,79166,58068
300153553600,30-015-35536,SPANISH CEDAR STATE 001,2012-04-01,20,0,766,0,3240,79932,58068
300153553600,30-015-35536,SPANISH CEDAR STATE 001,2012-05-01,21,0,1137,0,3240,81069,58068
300153553600,30-015-35536,SPANISH CEDAR STATE 001,2012-06-01,22,0,1531,0,3240,82600,58068
300153553600,30-015-35536,SPANISH CEDAR STATE 001,2012-07-01,23,0,1115,0,3240,83715,58068
300153553600,30-015-35536,SPANISH CEDAR STATE 001,2012-08-01,24,0,1002,0,3240,84717,58068
300153553600,30-015-35536,SPANISH CEDAR STATE 001,2012-09-01,25,0,856,0,3240,85573,58068
300153553600,30-015-35536,SPANISH CEDAR STATE 001,2012-10-01,26,0,857,0,3240,86430,58068
300153553600,30-015-35536,SPANISH CEDAR STATE 001,2012-11-01,27,0,1057,188,3240,87487,58256
300153553600,30-015-35536,SPANISH CEDAR STATE 001,2012-12-01,28,0,1534,374,3240,89021,58630
300153553600,30-015-35536,SPANISH CEDAR STATE 001,2013-01-01,29,0,1531,0,3240,90552,58630
300153553600,30-015-35536,SPANISH CEDAR STATE 001,2013-02-01,30,0,1117,0,3240,91669,58630
300153553600,30-015-35536,SPANISH CEDAR STATE 001,2013-03-01,31,0,1007,0,3240,92676,58630
300153553600,30-015-35536,SPANISH CEDAR STATE 001,2013-04-01,32,0,841,0,3240,93517,58630
300153553600,30-015-35536,SPANISH CEDAR STATE 001,2013-05-01,33,0,808,0,3240,94325,58630
300153553600,30-015-35536,SPANISH CEDAR STATE 001,2013-06-01,34,0,722,0,3240,95047,58630
300153553600,30-015-35536,SPANISH CEDAR STATE 001,2013-07-01,35,0,729,0,3240,95776,58630
300153553600,30-015-35536,SPANISH CEDAR STATE 001,2013-08-01,36,0,702,0,3240,96478,58630
300153553600,30-015-35536,SPANISH CEDAR STATE 001,2013-09-01,37,0,363,0,3240,96841,58630
300153553600,30-015-35536,SPANISH CEDAR STATE 001,2013-10-01,38,0,23,0,3240,96864,58630
300153553600,30-015-35536,SPANISH CEDAR STATE 001,2013-11-01,39,0,0,0,3240,96864,58630
300153553600,30-015-35536,SPANISH CEDAR STATE 001,2013-12-01,40,0,0,0,3240,96864,58630
300153553600,30-015-35536,SPANISH CEDAR STATE 001,2014-01-01,41,0,0,0,3240,96864,58630
300153553600,30-015-35536,SPANISH CEDAR STATE 001,2014-02-01,42,0,0,0,3240,96864,58630
300153553600,30-015-35536,SPANISH CEDAR STATE 001,2014-03-01,43,0,0,0,3240,96864,58630
300153553600,30-015-35536,SPANISH CEDAR STATE 001,2014-04-01,44,0,3022,364,3240,99886,58994
300153553600,30-015-35536,SPANISH CEDAR STATE 001,2014-05-01,45,0,2403,302,3240,102289,59296
300153553600,30-015-35536,SPANISH CEDAR STATE 001,2014-06-01,46,0,1446,151,3240,103735,59447
300153553600,30-015-35536,SPANISH CEDAR STATE 001,2014-07-01,47,0,1774,94,3240,105509,59541
300153553600,30-015-35536,SPANISH CEDAR STATE 001,2014-08-01,48,20,1904,26,3260,107413,59567
300153553600,30-015-35536,SPANISH CEDAR STATE 001,2014-09-01,49,0,1841,6,3260,109254,59573
300153553600,30-015-35536,SPANISH CEDAR STATE 001,2014-10-01,50,5,1741,25,3265,110995,59598
300153553600,30-015-35536,SPANISH CEDAR STATE 001,2014-11-01,51,0,1589,14,3265,112584,59612
300153553600,30-015-35536,SPANISH CEDAR STATE 001,2014-12-01,52,0,1367,33,3265,113951,59645
300153553600,30-015-35536,SPANISH CEDAR STATE 001,2015-01-01,53,6,1455,61,3271,115406,59706
300153553600,30-015-35536,SPANISH CEDAR STATE 001,2015-02-01,54,36,1140,15,3307,116546,59721
300153553600,30-015-35536,SPANISH CEDAR STATE 001,2015-03-01,55,3,1475,73,3310,118021,59794
300153553600,30-015-35536,SPANISH CEDAR STATE 001,2015-04-01,56,16,1435,90,3326,119456,59884
300153553600,30-015-35536,SPANISH CEDAR STATE 001,2015-05-01,57,3,1554,96,3329,121010,59980
300153553600,30-015-35536,SPANISH CEDAR STATE 001,2015-06-01,58,0,1452,62,3329,122462,60042
300153553600,30-015-35536,SPANISH CEDAR STATE 001,2015-07-01,59,0,258,18,3329,122720,60060
300153553600,30-015-35536,SPANISH CEDAR STATE 001,2015-08-01,60,0,899,0,3329,123619,60060
300153553600,30-015-35536,SPANISH CEDAR STATE 001,2015-09-01,61,22,1228,128,3351,124847,60188
300153553600,30-015-35536,SPANISH CEDAR STATE 001,2015-10-01,62,2,1376,182,3353,126223,60370
300153553600,30-015-35536,SPANISH CEDAR STATE 001,2015-11-01,63,0,1368,66,3353,127591,60436
300153553600,30-015-35536,SPANISH CEDAR STATE 001,2015-12-01,64,0,1648,30,3353,129239,60466
300153553600,30-015-35536,SPANISH CEDAR STATE 001,2016-01-01,65,0,1244,18,3353,130483,60484
300153553600,30-015-35536,SPANISH CEDAR STATE 001,2016-02-01,66,0,898,45,3353,131381,60529
300153553600,30-015-35536,SPANISH CEDAR STATE 001,2016-03-01,67,0,900,0,3353,132281,60529
300153553600,30-015-35536,SPANISH CEDAR STATE 001,2016-04-01,68,0,965,0,3353,133246,60529
300153553600,30-015-35536,SPANISH CEDAR STATE 001,2016-05-01,69,0,1214,0,3353,134460,60529
300153553600,30-015-35536,SPANISH CEDAR STATE 001,2016-06-01,70,0,1033,17,3353,135493,60546
300153553600,30-015-35536,SPANISH CEDAR STATE 001,2016-07-01,71,0,982,12,3353,136475,60558
300153553600,30-015-35536,SPANISH CEDAR STATE 001,2016-08-01,72,0,1274,0,3353,137749,60558
300153553600,30-015-35536,SPANISH CEDAR STATE 001,2016-09-01,73,0,1373,65,3353,139122,60623
300153553600,30-015-35536,SPANISH CEDAR STATE 001,2016-10-01,74,0,1318,74,3353,140440,60697
300153553600,30-015-35536,SPANISH CEDAR STATE 001,2016-11-01,75,0,385,23,3353,140825,60720
300153553600,30-015-35536,SPANISH CEDAR STATE 001,2016-12-01,76,0,0,0,3353,140825,60720
300153553600,30-015-35536,SPANISH CEDAR STATE 001,2017-01-01,77,0,3,0,3353,140828,60720
300153553600,30-015-35536,SPANISH CEDAR STATE 001,2017-02-01,78,0,0,0,3353,140828,60720
300153553600,30-015-35536,SPANISH CEDAR STATE 001,2017-03-01,79,0,6,0,3353,140834,60720
300153553600,30-015-35536,SPANISH CEDAR STATE 001,2017-04-01,80,0,213,0,3353,141047,60720
300153553600,30-015-35536,SPANISH CEDAR STATE 001,2017-05-01,81,0,2136,0,3353,143183,60720
300153553600,30-015-35536,SPANISH CEDAR STATE 001,2017-06-01,82,0,2117,0,3353,145300,60720
300153553600,30-015-35536,SPANISH CEDAR STATE 001,2017-07-01,83,0,1722,0,3353,147022,60720
300153553600,30-015-35536,SPANISH CEDAR STATE 001,2017-08-01,84,0,1532,0,3353,148554,60720
300153553600,30-015-35536,SPANISH CEDAR STATE 001,2017-09-01,85,0,1338,0,3353,149892,60720
300153553600,30-015-35536,SPANISH CEDAR STATE 001,2017-10-01,86,0,1330,0,3353,151222,60720
300153553600,30-015-35536,SPANISH CEDAR STATE 001,2017-11-01,87,2,1203,0,3355,152425,60720
300153553600,30-015-35536,SPANISH CEDAR STATE 001,2017-12-01,88,4,1150,0,3359,153575,60720
300153553600,30-015-35536,SPANISH CEDAR STATE 001,2018-01-01,89,0,1061,0,3359,154636,60720
300153553600,30-015-35536,SPANISH CEDAR STATE 001,2018-02-01,90,0,931,14,3359,155567,60734
300153553600,30-015-35536,SPANISH CEDAR STATE 001,2018-03-01,91,0,1793,469,3359,157360,61203
300153553600,30-015-35536,SPANISH CEDAR STATE 001,2018-04-01,92,0,1438,116,3359,158798,61319
300153553600,30-015-35536,SPANISH CEDAR STATE 001,2018-05-01,93,0,1565,114,3359,160363,61433
300153553600,30-015-35536,SPANISH CEDAR STATE 001,2018-06-01,94,4,1203,60,3363,161566,61493
300153553600,30-015-35536,SPANISH CEDAR STATE 001,2018-07-01,95,0,1184,20,3363,162750,61513
300153553600,30-015-35536,SPANISH CEDAR STATE 001,2018-08-01,96,0,1302,48,3363,164052,61561
300153553600,30-015-35536,SPANISH CEDAR STATE 001,2018-09-01,97,0,1174,79,3363,165226,61640
300153553600,30-015-35536,SPANISH CEDAR STATE 001,2018-10-01,98,0,891,5,3363,166117,61645
300153553600,30-015-35536,SPANISH CEDAR STATE 001,2018-11-01,99,0,685,0,3363,166802,61645
300153553600,30-015-35536,SPANISH CEDAR STATE 001,2018-12-01,100,0,920,0,3363,167722,61645
300153553600,30-015-35536,SPANISH CEDAR STATE 001,2019-01-01,101,0,760,0,3363,168482,61645
300153553600,30-015-35536,SPANISH CEDAR STATE 001,2019-02-01,102,0,674,0,3363,169156,61645
300153553600,30-015-35536,SPANISH CEDAR STATE 001,2019-03-01,103,0,1279,0,3363,170435,61645
300153553600,30-015-35536,SPANISH CEDAR STATE 001,2019-04-01,104,0,1206,0,3363,171641,61645
300153553600,30-015-35536,SPANISH CEDAR STATE 001,2019-05-01,105,0,1100,0,3363,172741,61645
300153553600,30-015-35536,SPANISH CEDAR STATE 001,2019-06-01,106,0,722,0,3363,173463,61645
300153553600,30-015-35536,SPANISH CEDAR STATE 001,2019-07-01,107,3,1455,0,3366,174918,61645
300153553600,30-015-35536,SPANISH CEDAR STATE 001,2019-08-01,108,0,1216,0,3366,176134,61645
300153553600,30-015-35536,SPANISH CEDAR STATE 001,2019-09-01,109,0,1142,0,3366,177276,61645
300153553600,30-015-35536,SPANISH CEDAR STATE 001,2019-10-01,110,0,1048,0,3366,178324,61645
300153553600,30-015-35536,SPANISH CEDAR STATE 001,2019-11-01,111,0,1015,0,3366,179339,61645
300153553600,30-015-35536,SPANISH CEDAR STATE 001,2019-12-01,112,0,1004,0,3366,180343,61645
300153553600,30-015-35536,SPANISH CEDAR STATE 001,2020-01-01,113,0,963,0,3366,181306,61645
300153553600,30-015-35536,SPANISH CEDAR STATE 001,2020-02-01,114,0,859,0,3366,182165,61645
300153553600,30-015-35536,SPANISH CEDAR STATE 001,2020-03-01,115,0,851,0,3366,183016,61645
300153553600,30-015-35536,SPANISH CEDAR STATE 001,2020-04-01,116,0,28,0,3366,183044,61645
300153553600,30-015-35536,SPANISH CEDAR STATE 001,2020-05-01,117,0,75,0,3366,183119,61645
300153553600,30-015-35536,SPANISH CEDAR STATE 001,2020-06-01,118,0,87,0,3366,183206,61645
300153553600,30-015-35536,SPANISH CEDAR STATE 001,2020-07-01,119,0,483,0,3366,183689,61645
300153553600,30-015-35536,SPANISH CEDAR STATE 001,2020-08-01,120,22,849,66,3388,184538,61711
300153553600,30-015-35536,SPANISH CEDAR STATE 001,2020-09-01,121,0,262,0,3388,184800,61711
300153553600,30-015-35536,SPANISH CEDAR STATE 001,2020-10-01,122,0,490,0,3388,185290,61711
300153553600,30-015-35536,SPANISH CEDAR STATE 001,2020-11-01,123,0,549,0,3388,185839,61711
300153553600,30-015-35536,SPANISH CEDAR STATE 001,2020-12-01,124,0,491,0,3388,186330,61711
300153553600,30-015-35536,SPANISH CEDAR STATE 001,2021-01-01,125,0,621,0,3388,186951,61711
300153553600,30-015-35536,SPANISH CEDAR STATE 001,2021-02-01,126,0,1,0,3388,186952,61711
300153553600,30-015-35536,SPANISH CEDAR STATE 001,2021-03-01,127,0,153,0,3388,187105,61711
300153553600,30-015-35536,SPANISH CEDAR STATE 001,2021-04-01,128,0,154,0,3388,187259,61711
300153553600,30-015-35536,SPANISH CEDAR STATE 001,2021-05-01,129,0,341,0,3388,187600,61711
300153553600,30-015-35536,SPANISH CEDAR STATE 001,2021-06-01,130,0,29,0,3388,187629,61711
300153553600,30-015-35536,SPANISH CEDAR STATE 001,2021-07-01,131,0,439,0,3388,188068,61711
300153553600,30-015-35536,SPANISH CEDAR STATE 001,2021-08-01,132,0,175,0,3388,188243,61711
300153553600,30-015-35536,SPANISH CEDAR STATE 001,2021-09-01,133,0,260,0,3388,188503,61711
300153553600,30-015-35536,SPANISH CEDAR STATE 001,2021-10-01,134,0,209,0,3388,188712,61711
300153553600,30-015-35536,SPANISH CEDAR STATE 001,2021-11-01,135,0,15,0,3388,188727,61711
300153553600,30-015-35536,SPANISH CEDAR STATE 001,2021-12-01,136,0,8,0,3388,188735,61711
300153553600,30-015-35536,SPANISH CEDAR STATE 001,2022-01-01,137,0,12,0,3388,188747,61711
300153553600,30-015-35536,SPANISH CEDAR STATE 001,2022-02-01,138,0,15,0,3388,188762,61711
300153553600,30-015-35536,SPANISH CEDAR STATE 001,2022-03-01,139,0,35,0,3388,188797,61711
300153553600,30-015-35536,SPANISH CEDAR STATE 001,2022-04-01,140,0,8,0,3388,188805,61711
300153553600,30-015-35536,SPANISH CEDAR STATE 001,2022-05-01,141,0,25,0,3388,188830,61711
300153553600,30-015-35536,SPANISH CEDAR STATE 001,2022-06-01,142,0,22,0,3388,188852,61711
300153553600,30-015-35536,SPANISH CEDAR STATE 001,2022-07-01,143,0,1,0,3388,188853,61711
300153553600,30-015-35536,SPANISH CEDAR STATE 001,2022-08-01,144,0,16,0,3388,188869,61711
300153553600,30-015-35536,SPANISH CEDAR STATE 001,2022-09-01,145,0,11,0,3388,188880,61711
300153553600,30-015-35536,SPANISH CEDAR STATE 001,2022-10-01,146,0,25,0,3388,188905,61711
300153553600,30-015-35536,SPANISH CEDAR STATE 001,2022-11-01,147,0,22,0,3388,188927,61711
300153553600,30-015-35536,SPANISH CEDAR STATE 001,2022-12-01,148,0,18,0,3388,188945,61711
300153553600,30-015-35536,SPANISH CEDAR STATE 001,2023-01-01,149,0,13,0,3388,188958,61711
300153553600,30-015-35536,SPANISH CEDAR STATE 001,2023-02-01,150,0,17,0,3388,188975,61711
300153553600,30-015-35536,SPANISH CEDAR STATE 001,2023-03-01,151,0,31,0,3388,189006,61711
300153553600,30-015-35536,SPANISH CEDAR STATE 001,2023-04-01,152,0,17,0,3388,189023,61711
300153553600,30-015-35536,SPANISH CEDAR STATE 001,2023-05-01,153,0,16,0,3388,189039,61711
300153553600,30-015-35536,SPANISH CEDAR STATE 001,2023-06-01,154,0,23,0,3388,189062,61711
300153553600,30-015-35536,SPANISH CEDAR STATE 001,2023-07-01,155,0,18,0,3388,189080,61711
300152442900,30-015-24429,LOVING 1 STATE 002,1983-09-01,1,0,31724,431,0,31724,431
300152442900,30-015-24429,LOVING 1 STATE 002,1983-10-01,2,0,36899,327,0,68623,758
300152442900,30-015-24429,LOVING 1 STATE 002,1983-11-01,3,0,0,0,0,68623,758
300152442900,30-015-24429,LOVING 1 STATE 002,1983-12-01,4,0,33428,213,0,102051,971
300152442900,30-015-24429,LOVING 1 STATE 002,1984-01-01,5,0,0,0,0,102051,971
300152442900,30-015-24429,LOVING 1 STATE 002,1984-02-01,6,0,32177,270,0,134228,1241
300152442900,30-015-24429,LOVING 1 STATE 002,1984-03-01,7,0,32101,243,0,166329,1484
300152442900,30-015-24429,LOVING 1 STATE 002,1984-04-01,8,0,34454,300,0,200783,1784
300152442900,30-015-24429,LOVING 1 STATE 002,1984-05-01,9,0,35169,309,0,235952,2093
300152442900,30-015-24429,LOVING 1 STATE 002,1984-06-01,10,0,0,0,0,235952,2093
300152442900,30-015-24429,LOVING 1 STATE 002,1984-07-01,11,0,21949,195,0,257901,2288
300152442900,30-015-24429,LOVING 1 STATE 002,1984-08-01,12,0,66624,132,0,324525,2420
300152442900,30-015-24429,LOVING 1 STATE 002,1984-09-01,13,0,15569,102,0,340094,2522
300152442900,30-015-24429,LOVING 1 STATE 002,1984-10-01,14,0,32501,321,0,372595,2843
300152442900,30-015-24429,LOVING 1 STATE 002,1984-11-01,15,0,2129,6,0,374724,2849
300152442900,30-015-24429,LOVING 1 STATE 002,1984-12-01,16,0,24034,216,0,398758,3065
300152442900,30-015-24429,LOVING 1 STATE 002,1985-01-01,17,0,34427,300,0,433185,3365
300152442900,30-015-24429,LOVING 1 STATE 002,1985-02-01,18,0,32098,321,0,465283,3686
300152442900,30-015-24429,LOVING 1 STATE 002,1985-03-01,19,0,27715,218,0,492998,3904
300152442900,30-015-24429,LOVING 1 STATE 002,1985-04-01,20,0,32426,297,0,525424,4201
300152442900,30-015-24429,LOVING 1 STATE 002,1985-05-01,21,0,33544,282,0,558968,4483
300152442900,30-015-24429,LOVING 1 STATE 002,1985-06-01,22,0,32054,303,0,591022,4786
300152442900,30-015-24429,LOVING 1 STATE 002,1985-07-01,23,0,24802,27,0,615824,4813
300152442900,30-015-24429,LOVING 1 STATE 002,1985-08-01,24,0,32361,255,0,648185,5068
300152442900,30-015-24429,LOVING 1 STATE 002,1985-09-01,25,0,33401,360,0,681586,5428
300152442900,30-015-24429,LOVING 1 STATE 002,1985-10-01,26,0,33771,324,0,715357,5752
300152442900,30-015-24429,LOVING 1 STATE 002,1985-11-01,27,0,23748,199,0,739105,5951
300152442900,30-015-24429,LOVING 1 STATE 002,1985-12-01,28,0,33684,342,0,772789,6293
300152442900,30-015-24429,LOVING 1 STATE 002,1986-01-01,29,0,33072,307,0,805861,6600
300152442900,30-015-24429,LOVING 1 STATE 002,1986-02-01,30,0,29302,278,0,835163,6878
300152442900,30-015-24429,LOVING 1 STATE 002,1986-03-01,31,0,19985,112,0,855148,6990
300152442900,30-015-24429,LOVING 1 STATE 002,1986-04-01,32,0,30990,274,0,886138,7264
300152442900,30-015-24429,LOVING 1 STATE 002,1986-05-01,33,0,23846,107,0,909984,7371
300152442900,30-015-24429,LOVING 1 STATE 002,1986-06-01,34,0,21422,348,0,931406,7719
300152442900,30-015-24429,LOVING 1 STATE 002,1986-07-01,35,0,23939,180,0,955345,7899
300152442900,30-015-24429,LOVING 1 STATE 002,1986-08-01,36,0,23696,191,0,979041,8090
300152442900,30-015-24429,LOVING 1 STATE 002,1986-09-01,37,0,20420,166,0,999461,8256
300152442900,30-015-24429,LOVING 1 STATE 002,1986-10-01,38,0,22955,229,0,1022416,8485
300152442900,30-015-24429,LOVING 1 STATE 002,1986-11-01,39,0,17646,207,0,1040062,8692
300152442900,30-015-24429,LOVING 1 STATE 002,1986-12-01,40,0,23868,302,0,1063930,8994
300152442900,30-015-24429,LOVING 1 STATE 002,1987-01-01,41,0,25704,219,0,1089634,9213
300152442900,30-015-24429,LOVING 1 STATE 002,1987-02-01,42,0,22371,135,0,1112005,9348
300152442900,30-015-24429,LOVING 1 STATE 002,1987-03-01,43,0,24316,248,0,1136321,9596
300152442900,30-015-24429,LOVING 1 STATE 002,1987-04-01,44,0,21976,194,0,1158297,9790
300152442900,30-015-24429,LOVING 1 STATE 002,1987-05-01,45,0,22468,216,0,1180765,10006
300152442900,30-015-24429,LOVING 1 STATE 002,1987-06-01,46,0,20697,186,0,1201462,10192
300152442900,30-015-24429,LOVING 1 STATE 002,1987-07-01,47,0,20082,134,0,1221544,10326
300152442900,30-015-24429,LOVING 1 STATE 002,1987-08-01,48,0,19492,180,0,1241036,10506
300152442900,30-015-24429,LOVING 1 STATE 002,1987-09-01,49,0,18719,197,0,1259755,10703
300152442900,30-015-24429,LOVING 1 STATE 002,1987-10-01,50,0,20566,214,0,1280321,10917
300152442900,30-015-24429,LOVING 1 STATE 002,1987-11-01,51,0,18934,185,0,1299255,11102
300152442900,30-015-24429,LOVING 1 STATE 002,1987-12-01,52,0,18339,186,0,1317594,11288
300152442900,30-015-24429,LOVING 1 STATE 002,1988-01-01,53,0,18292,180,0,1335886,11468
300152442900,30-015-24429,LOVING 1 STATE 002,1988-02-01,54,0,15179,159,0,1351065,11627
300152442900,30-015-24429,LOVING 1 STATE 002,1988-03-01,55,0,17311,178,0,1368376,11805
300152442900,30-015-24429,LOVING 1 STATE 002,1988-04-01,56,0,17348,174,0,1385724,11979
300152442900,30-015-24429,LOVING 1 STATE 002,1988-05-01,57,0,17487,184,0,1403211,12163
300152442900,30-015-24429,LOVING 1 STATE 002,1988-06-01,58,0,16387,168,0,1419598,12331
300152442900,30-015-24429,LOVING 1 STATE 002,1988-07-01,59,0,16713,162,0,1436311,12493
300152442900,30-015-24429,LOVING 1 STATE 002,1988-08-01,60,0,16899,179,0,1453210,12672
300152442900,30-015-24429,LOVING 1 STATE 002,1988-09-01,61,0,15807,135,0,1469017,12807
300152442900,30-015-24429,LOVING 1 STATE 002,1988-10-01,62,0,16092,132,0,1485109,12939
300152442900,30-015-24429,LOVING 1 STATE 002,1988-11-01,63,0,15373,0,0,1500482,12939
300152442900,30-015-24429,LOVING 1 STATE 002,1988-12-01,64,0,15239,168,0,1515721,13107
300152442900,30-015-24429,LOVING 1 STATE 002,1989-01-01,65,0,14310,150,0,1530031,13257
300152442900,30-015-24429,LOVING 1 STATE 002,1989-02-01,66,0,12045,129,0,1542076,13386
300152442900,30-015-24429,LOVING 1 STATE 002,1989-03-01,67,0,13618,162,0,1555694,13548
300152442900,30-015-24429,LOVING 1 STATE 002,1989-04-01,68,0,13357,123,0,1569051,13671
300152442900,30-015-24429,LOVING 1 STATE 002,1989-05-01,69,0,14525,121,0,1583576,13792
300152442900,30-015-24429,LOVING 1 STATE 002,1989-06-01,70,0,13829,134,0,1597405,13926
300152442900,30-015-24429,LOVING 1 STATE 002,1989-07-01,71,0,12478,102,0,1609883,14028
300152442900,30-015-24429,LOVING 1 STATE 002,1989-08-01,72,0,11618,143,0,1621501,14171
300152442900,30-015-24429,LOVING 1 STATE 002,1989-09-01,73,0,15590,159,0,1637091,14330
300152442900,30-015-24429,LOVING 1 STATE 002,1989-10-01,74,0,16897,207,0,1653988,14537
300152442900,30-015-24429,LOVING 1 STATE 002,1989-11-01,75,0,15811,174,0,1669799,14711
300152442900,30-015-24429,LOVING 1 STATE 002,1989-12-01,76,0,15120,168,0,1684919,14879
300152442900,30-015-24429,LOVING 1 STATE 002,1990-01-01,77,0,16428,129,0,1701347,15008
300152442900,30-015-24429,LOVING 1 STATE 002,1990-02-01,78,0,13661,147,0,1715008,15155
300152442900,30-015-24429,LOVING 1 STATE 002,1990-03-01,79,0,14478,180,0,1729486,15335
300152442900,30-015-24429,LOVING 1 STATE 002,1990-04-01,80,0,10582,78,0,1740068,15413
300152442900,30-015-24429,LOVING 1 STATE 002,1990-05-01,81,0,10939,126,0,1751007,15539
300152442900,30-015-24429,LOVING 1 STATE 002,1990-06-01,82,0,11127,75,0,1762134,15614
300152442900,30-015-24429,LOVING 1 STATE 002,1990-07-01,83,0,11752,135,0,1773886,15749
300152442900,30-015-24429,LOVING 1 STATE 002,1990-08-01,84,0,9701,117,0,1783587,15866
300152442900,30-015-24429,LOVING 1 STATE 002,1990-09-01,85,0,7758,76,0,1791345,15942
300152442900,30-015-24429,LOVING 1 STATE 002,1990-10-01,86,0,4849,135,0,1796194,16077
300152442900,30-015-24429,LOVING 1 STATE 002,1990-11-01,87,0,8588,38,0,1804782,16115
300152442900,30-015-24429,LOVING 1 STATE 002,1990-12-01,88,0,6045,32,0,1810827,16147
300152442900,30-015-24429,LOVING 1 STATE 002,1991-01-01,89,0,9146,32,0,1819973,16179
300152442900,30-015-24429,LOVING 1 STATE 002,1991-02-01,90,0,13112,84,0,1833085,16263
300152442900,30-015-24429,LOVING 1 STATE 002,1991-03-01,91,0,18344,248,0,1851429,16511
300152442900,30-015-24429,LOVING 1 STATE 002,1991-04-01,92,0,17847,180,0,1869276,16691
300152442900,30-015-24429,LOVING 1 STATE 002,1991-05-01,93,0,18104,186,0,1887380,16877
300152442900,30-015-24429,LOVING 1 STATE 002,1991-06-01,94,0,16810,240,0,1904190,17117
300152442900,30-015-24429,LOVING 1 STATE 002,1991-07-01,95,0,17174,248,0,1921364,17365
300152442900,30-015-24429,LOVING 1 STATE 002,1991-08-01,96,0,15755,180,0,1937119,17545
300152442900,30-015-24429,LOVING 1 STATE 002,1991-09-01,97,0,12645,177,0,1949764,17722
300152442900,30-015-24429,LOVING 1 STATE 002,1991-10-01,98,0,10743,132,0,1960507,17854
300152442900,30-015-24429,LOVING 1 STATE 002,1991-11-01,99,0,11479,207,0,1971986,18061
300152442900,30-015-24429,LOVING 1 STATE 002,1991-12-01,100,0,10340,216,0,1982326,18277
300152442900,30-015-24429,LOVING 1 STATE 002,1992-01-01,101,0,13908,162,0,1996234,18439
300152442900,30-015-24429,LOVING 1 STATE 002,1992-02-01,102,0,12794,180,0,2009028,18619
300152442900,30-015-24429,LOVING 1 STATE 002,1992-03-01,103,0,14776,198,0,2023804,18817
300152442900,30-015-24429,LOVING 1 STATE 002,1992-04-01,104,0,12837,162,0,2036641,18979
300152442900,30-015-24429,LOVING 1 STATE 002,1992-05-01,105,0,13083,171,0,2049724,19150
300152442900,30-015-24429,LOVING 1 STATE 002,1992-06-01,106,0,11670,150,0,2061394,19300
300152442900,30-015-24429,LOVING 1 STATE 002,1992-07-01,107,0,10360,57,0,2071754,19357
300152442900,30-015-24429,LOVING 1 STATE 002,1992-08-01,108,0,11678,120,0,2083432,19477
300152442900,30-015-24429,LOVING 1 STATE 002,1992-09-01,109,0,11896,237,0,2095328,19714
300152442900,30-015-24429,LOVING 1 STATE 002,1992-10-01,110,0,12079,159,0,2107407,19873
300152442900,30-015-24429,LOVING 1 STATE 002,1992-11-01,111,0,11519,111,0,2118926,19984
300152442900,30-015-24429,LOVING 1 STATE 002,1992-12-01,112,0,11536,123,0,2130462,20107
300152442900,30-015-24429,LOVING 1 STATE 002,1993-01-01,113,0,9562,156,0,2140024,20263
300152442900,30-015-24429,LOVING 1 STATE 002,1993-02-01,114,0,5644,114,0,2145668,20377
300152442900,30-015-24429,LOVING 1 STATE 002,1993-03-01,115,0,5765,30,0,2151433,20407
300152442900,30-015-24429,LOVING 1 STATE 002,1993-04-01,116,0,4383,51,0,2155816,20458
300152442900,30-015-24429,LOVING 1 STATE 002,1993-05-01,117,0,1172,0,0,2156988,20458
300152442900,30-015-24429,LOVING 1 STATE 002,1993-06-01,118,0,932,0,0,2157920,20458
300152442900,30-015-24429,LOVING 1 STATE 002,1993-07-01,119,0,1591,0,0,2159511,20458
300152442900,30-015-24429,LOVING 1 STATE 002,1993-08-01,120,0,1313,0,0,2160824,20458
300152442900,30-015-24429,LOVING 1 STATE 002,1993-09-01,121,0,922,0,0,2161746,20458
300152442900,30-015-24429,LOVING 1 STATE 002,1993-10-01,122,0,1319,0,0,2163065,20458
300152442900,30-015-24429,LOVING 1 STATE 002,1993-11-01,123,0,1309,0,0,2164374,20458
300152442900,30-015-24429,LOVING 1 STATE 002,1993-12-01,124,0,1476,0,0,2165850,20458
300152442900,30-015-24429,LOVING 1 STATE 002,1994-01-01,125,0,794,0,0,2166644,20458
300152442900,30-015-24429,LOVING 1 STATE 002,1994-02-01,126,0,90,0,0,2166734,20458
300152442900,30-015-24429,LOVING 1 STATE 002,1994-03-01,127,0,3508,507,0,2170242,20965
300152442900,30-015-24429,LOVING 1 STATE 002,1994-04-01,128,0,4975,330,0,2175217,21295
300152442900,30-015-24429,LOVING 1 STATE 002,1994-05-01,129,0,7059,294,0,2182276,21589
300152442900,30-015-24429,LOVING 1 STATE 002,1994-06-01,130,0,6964,177,0,2189240,21766
300152442900,30-015-24429,LOVING 1 STATE 002,1994-07-01,131,0,7556,192,0,2196796,21958
300152442900,30-015-24429,LOVING 1 STATE 002,1994-08-01,132,0,8088,189,0,2204884,22147
300152442900,30-015-24429,LOVING 1 STATE 002,1994-09-01,133,0,0,0,0,2204884,22147
300152442900,30-015-24429,LOVING 1 STATE 002,1994-10-01,134,0,8312,171,0,2213196,22318
300152442900,30-015-24429,LOVING 1 STATE 002,1994-11-01,135,0,7402,123,0,2220598,22441
300152442900,30-015-24429,LOVING 1 STATE 002,1994-12-01,136,0,7402,123,0,2228000,22564
300152442900,30-015-24429,LOVING 1 STATE 002,1995-01-01,137,0,7402,123,0,2235402,22687
300152442900,30-015-24429,LOVING 1 STATE 002,1995-02-01,138,0,7527,159,0,2242929,22846
300152442900,30-015-24429,LOVING 1 STATE 002,1995-03-01,139,0,7314,180,0,2250243,23026
300152442900,30-015-24429,LOVING 1 STATE 002,1995-04-01,140,0,7939,150,0,2258182,23176
300152442900,30-015-24429,LOVING 1 STATE 002,1995-05-01,141,0,6885,102,0,2265067,23278
300152442900,30-015-24429,LOVING 1 STATE 002,1995-06-01,142,0,7815,216,0,2272882,23494
300152442900,30-015-24429,LOVING 1 STATE 002,1995-07-01,143,0,8295,141,0,2281177,23635
300152442900,30-015-24429,LOVING 1 STATE 002,1995-08-01,144,0,8082,162,0,2289259,23797
300152442900,30-015-24429,LOVING 1 STATE 002,1995-09-01,145,0,7942,195,0,2297201,23992
300152442900,30-015-24429,LOVING 1 STATE 002,1995-10-01,146,0,8531,162,0,2305732,24154
300152442900,30-015-24429,LOVING 1 STATE 002,1995-11-01,147,0,7539,162,0,2313271,24316
300152442900,30-015-24429,LOVING 1 STATE 002,1995-12-01,148,0,0,0,0,2313271,24316
300152442900,30-015-24429,LOVING 1 STATE 002,1996-01-01,149,0,8200,171,0,2321471,24487
300152442900,30-015-24429,LOVING 1 STATE 002,1996-02-01,150,0,8225,174,0,2329696,24661
300152442900,30-015-24429,LOVING 1 STATE 002,1996-03-01,151,0,8579,175,0,2338275,24836
300152442900,30-015-24429,LOVING 1 STATE 002,1996-04-01,152,0,8326,162,0,2346601,24998
300152442900,30-015-24429,LOVING 1 STATE 002,1996-05-01,153,0,8295,93,0,2354896,25091
300152442900,30-015-24429,LOVING 1 STATE 002,1996-06-01,154,0,7498,129,0,2362394,25220
300152442900,30-015-24429,LOVING 1 STATE 002,1996-07-01,155,0,8382,198,0,2370776,25418
300152442900,30-015-24429,LOVING 1 STATE 002,1996-08-01,156,0,8342,180,0,2379118,25598
300152442900,30-015-24429,LOVING 1 STATE 002,1996-09-01,157,0,7878,144,0,2386996,25742
300152442900,30-015-24429,LOVING 1 STATE 002,1996-10-01,158,0,8026,174,0,2395022,25916
300152442900,30-015-24429,LOVING 1 STATE 002,1996-11-01,159,0,7538,165,0,2402560,26081
300152442900,30-015-24429,LOVING 1 STATE 002,1996-12-01,160,0,7569,150,0,2410129,26231
300152442900,30-015-24429,LOVING 1 STATE 002,1997-01-01,161,0,7177,117,0,2417306,26348
300152442900,30-015-24429,LOVING 1 STATE 002,1997-02-01,162,0,6604,114,0,2423910,26462
300152442900,30-015-24429,LOVING 1 STATE 002,1997-03-01,163,0,7682,219,0,2431592,26681
300152442900,30-015-24429,LOVING 1 STATE 002,1997-04-01,164,0,7833,344,0,2439425,27025
300152442900,30-015-24429,LOVING 1 STATE 002,1997-05-01,165,0,7403,318,0,2446828,27343
300152442900,30-015-24429,LOVING 1 STATE 002,1997-06-01,166,0,8204,318,0,2455032,27661
300152442900,30-015-24429,LOVING 1 STATE 002,1997-07-01,167,0,7236,101,0,2462268,27762
300152442900,30-015-24429,LOVING 1 STATE 002,1997-08-01,168,0,7293,318,0,2469561,28080
300152442900,30-015-24429,LOVING 1 STATE 002,1997-09-01,169,0,7165,318,0,2476726,28398
300152442900,30-015-24429,LOVING 1 STATE 002,1997-10-01,170,0,7338,203,0,2484064,28601
300152442900,30-015-24429,LOVING 1 STATE 002,1997-11-01,171,0,6664,146,0,2490728,28747
300152442900,30-015-24429,LOVING 1 STATE 002,1997-12-01,172,0,6843,26,0,2497571,28773
300152442900,30-015-24429,LOVING 1 STATE 002,1998-01-01,173,0,6001,146,0,2503572,28919
300152442900,30-015-24429,LOVING 1 STATE 002,1998-02-01,174,0,5190,285,0,2508762,29204
300152442900,30-015-24429,LOVING 1 STATE 002,1998-03-01,175,0,0,39,0,2508762,29243
300152442900,30-015-24429,LOVING 1 STATE 002,1998-04-01,176,0,4466,186,0,2513228,29429
300152442900,30-015-24429,LOVING 1 STATE 002,1998-05-01,177,0,7357,275,0,2520585,29704
300152442900,30-015-24429,LOVING 1 STATE 002,1998-06-01,178,0,6541,61,0,2527126,29765
300152442900,30-015-24429,LOVING 1 STATE 002,1998-07-01,179,0,6078,128,0,2533204,29893
300152442900,30-015-24429,LOVING 1 STATE 002,1998-08-01,180,0,7115,108,0,2540319,30001
300152442900,30-015-24429,LOVING 1 STATE 002,1998-09-01,181,0,7181,153,0,2547500,30154
300152442900,30-015-24429,LOVING 1 STATE 002,1998-10-01,182,0,7859,0,0,2555359,30154
300152442900,30-015-24429,LOVING 1 STATE 002,1998-11-01,183,0,6892,342,0,2562251,30496
300152442900,30-015-24429,LOVING 1 STATE 002,1998-12-01,184,0,7294,171,0,2569545,30667
300152442900,30-015-24429,LOVING 1 STATE 002,1999-01-01,185,0,7270,117,0,2576815,30784
300152442900,30-015-24429,LOVING 1 STATE 002,1999-02-01,186,0,5978,102,0,2582793,30886
300152442900,30-015-24429,LOVING 1 STATE 002,1999-03-01,187,0,4226,52,0,2587019,30938
300152442900,30-015-24429,LOVING 1 STATE 002,1999-04-01,188,0,50996,150,0,2638015,31088
300152442900,30-015-24429,LOVING 1 STATE 002,1999-05-01,189,0,6059,132,0,2644074,31220
300152442900,30-015-24429,LOVING 1 STATE 002,1999-06-01,190,0,5821,5,0,2649895,31225
300152442900,30-015-24429,LOVING 1 STATE 002,1999-07-01,191,0,6061,79,0,2655956,31304
300152442900,30-015-24429,LOVING 1 STATE 002,1999-08-01,192,0,6536,240,0,2662492,31544
300152442900,30-015-24429,LOVING 1 STATE 002,1999-09-01,193,0,4610,64,0,2667102,31608
300152442900,30-015-24429,LOVING 1 STATE 002,1999-10-01,194,0,3564,17,0,2670666,31625
300152442900,30-015-24429,LOVING 1 STATE 002,1999-11-01,195,0,3508,108,0,2674174,31733
300152442900,30-015-24429,LOVING 1 STATE 002,1999-12-01,196,0,3702,171,0,2677876,31904
300152442900,30-015-24429,LOVING 1 STATE 002,2000-01-01,197,0,3514,123,0,2681390,32027
300152442900,30-015-24429,LOVING 1 STATE 002,2000-02-01,198,0,4309,132,0,2685699,32159
300152442900,30-015-24429,LOVING 1 STATE 002,2000-03-01,199,0,5074,114,0,2690773,32273
300152442900,30-015-24429,LOVING 1 STATE 002,2000-04-01,200,0,3625,105,0,2694398,32378
300152442900,30-015-24429,LOVING 1 STATE 002,2000-05-01,201,0,6579,420,0,2700977,32798
300152442900,30-015-24429,LOVING 1 STATE 002,2000-06-01,202,0,6826,348,0,2707803,33146
300152442900,30-015-24429,LOVING 1 STATE 002,2000-07-01,203,0,6947,147,0,2714750,33293
300152442900,30-015-24429,LOVING 1 STATE 002,2000-08-01,204,0,6879,150,0,2721629,33443
300152442900,30-015-24429,LOVING 1 STATE 002,2000-09-01,205,0,5236,138,0,2726865,33581
300152442900,30-015-24429,LOVING 1 STATE 002,2000-10-01,206,0,6930,180,0,2733795,33761
300152442900,30-015-24429,LOVING 1 STATE 002,2000-11-01,207,0,6644,180,0,2740439,33941
300152442900,30-015-24429,LOVING 1 STATE 002,2000-12-01,208,0,6940,159,0,2747379,34100
300152442900,30-015-24429,LOVING 1 STATE 002,2001-01-01,209,0,6817,153,0,2754196,34253
300152442900,30-015-24429,LOVING 1 STATE 002,2001-02-01,210,0,6654,174,0,2760850,34427
300152442900,30-015-24429,LOVING 1 STATE 002,2001-03-01,211,0,7251,171,0,2768101,34598
300152442900,30-015-24429,LOVING 1 STATE 002,2001-04-01,212,0,6831,162,0,2774932,34760
300152442900,30-015-24429,LOVING 1 STATE 002,2001-05-01,213,0,6937,144,0,2781869,34904
300152442900,30-015-24429,LOVING 1 STATE 002,2001-06-01,214,0,0,0,0,2781869,34904
300152442900,30-015-24429,LOVING 1 STATE 002,2001-07-01,215,0,7423,174,0,2789292,35078
300152442900,30-015-24429,LOVING 1 STATE 002,2001-08-01,216,0,6922,141,0,2796214,35219
300152442900,30-015-24429,LOVING 1 STATE 002,2001-09-01,217,0,6434,150,0,2802648,35369
300152442900,30-015-24429,LOVING 1 STATE 002,2001-10-01,218,0,6182,132,0,2808830,35501
300152442900,30-015-24429,LOVING 1 STATE 002,2001-11-01,219,0,5964,150,0,2814794,35651
300152442900,30-015-24429,LOVING 1 STATE 002,2001-12-01,220,0,6596,144,0,2821390,35795
300152442900,30-015-24429,LOVING 1 STATE 002,2002-01-01,221,0,7977,213,0,2829367,36008
300152442900,30-015-24429,LOVING 1 STATE 002,2002-02-01,222,0,7172,168,0,2836539,36176
300152442900,30-015-24429,LOVING 1 STATE 002,2002-03-01,223,0,7515,195,0,2844054,36371
300152442900,30-015-24429,LOVING 1 STATE 002,2002-04-01,224,0,6871,171,0,2850925,36542
300152442900,30-015-24429,LOVING 1 STATE 002,2002-05-01,225,0,7302,177,0,2858227,36719
300152442900,30-015-24429,LOVING 1 STATE 002,2002-06-01,226,0,6735,156,0,2864962,36875
300152442900,30-015-24429,LOVING 1 STATE 002,2002-07-01,227,0,7302,165,0,2872264,37040
300152442900,30-015-24429,LOVING 1 STATE 002,2002-08-01,228,0,7138,183,0,2879402,37223
300152442900,30-015-24429,LOVING 1 STATE 002,2002-09-01,229,0,6607,141,0,2886009,37364
300152442900,30-015-24429,LOVING 1 STATE 002,2002-10-01,230,0,6813,162,0,2892822,37526
300152442900,30-015-24429,LOVING 1 STATE 002,2002-11-01,231,0,6307,144,0,2899129,37670
300152442900,30-015-24429,LOVING 1 STATE 002,2002-12-01,232,0,6958,174,0,2906087,37844
300152442900,30-015-24429,LOVING 1 STATE 002,2003-01-01,233,0,6396,147,0,2912483,37991
300152442900,30-015-24429,LOVING 1 STATE 002,2003-02-01,234,0,2617,138,0,2915100,38129
300152442900,30-015-24429,LOVING 1 STATE 002,2003-03-01,235,0,2035,156,0,2917135,38285
300152442900,30-015-24429,LOVING 1 STATE 002,2003-04-01,236,0,6070,141,0,2923205,38426
300152442900,30-015-24429,LOVING 1 STATE 002,2003-05-01,237,0,5358,147,0,2928563,38573
300152442900,30-015-24429,LOVING 1 STATE 002,2003-06-01,238,0,4729,147,0,2933292,38720
300152442900,30-015-24429,LOVING 1 STATE 002,2003-07-01,239,0,4222,270,0,2937514,38990
300152442900,30-015-24429,LOVING 1 STATE 002,2003-08-01,240,0,5232,162,0,2942746,39152
300152442900,30-015-24429,LOVING 1 STATE 002,2003-09-01,241,0,5715,153,0,2948461,39305
300152442900,30-015-24429,LOVING 1 STATE 002,2003-10-01,242,0,5711,171,0,2954172,39476
300152442900,30-015-24429,LOVING 1 STATE 002,2003-11-01,243,0,4945,135,0,2959117,39611
300152442900,30-015-24429,LOVING 1 STATE 002,2003-12-01,244,0,5282,162,0,2964399,39773
300152442900,30-015-24429,LOVING 1 STATE 002,2004-01-01,245,0,5102,138,0,2969501,39911
300152442900,30-015-24429,LOVING 1 STATE 002,2004-02-01,246,0,4915,147,0,2974416,40058
300152442900,30-015-24429,LOVING 1 STATE 002,2004-03-01,247,0,5008,150,0,2979424,40208
300152442900,30-015-24429,LOVING 1 STATE 002,2004-04-01,248,0,4578,159,0,2984002,40367
300152442900,30-015-24429,LOVING 1 STATE 002,2004-05-01,249,0,4450,177,0,2988452,40544
300152442900,30-015-24429,LOVING 1 STATE 002,2004-06-01,250,0,3903,135,0,2992355,40679
300152442900,30-015-24429,LOVING 1 STATE 002,2004-07-01,251,0,3905,165,0,2996260,40844
300152442900,30-015-24429,LOVING 1 STATE 002,2004-08-01,252,0,3986,156,0,3000246,41000
300152442900,30-015-24429,LOVING 1 STATE 002,2004-09-01,253,0,3387,117,0,3003633,41117
300152442900,30-015-24429,LOVING 1 STATE 002,2004-10-01,254,0,3272,159,0,3006905,41276
300152442900,30-015-24429,LOVING 1 STATE 002,2004-11-01,255,0,2850,138,0,3009755,41414
300152442900,30-015-24429,LOVING 1 STATE 002,2004-12-01,256,0,2052,87,0,3011807,41501
300152442900,30-015-24429,LOVING 1 STATE 002,2005-01-01,257,0,622,38,0,3012429,41539
300152442900,30-015-24429,LOVING 1 STATE 002,2005-02-01,258,0,423,3,0,3012852,41542
300152442900,30-015-24429,LOVING 1 STATE 002,2005-03-01,259,0,687,18,0,3013539,41560
300152442900,30-015-24429,LOVING 1 STATE 002,2005-04-01,260,0,535,0,0,3014074,41560
300152442900,30-015-24429,LOVING 1 STATE 002,2005-05-01,261,0,338,18,0,3014412,41578
300152442900,30-015-24429,LOVING 1 STATE 002,2005-06-01,262,0,769,0,0,3015181,41578
300152442900,30-015-24429,LOVING 1 STATE 002,2005-07-01,263,0,368,0,0,3015549,41578
300152442900,30-015-24429,LOVING 1 STATE 002,2005-08-01,264,0,308,0,0,3015857,41578
300152442900,30-015-24429,LOVING 1 STATE 002,2005-09-01,265,0,251,0,0,3016108,41578
300152442900,30-015-24429,LOVING 1 STATE 002,2005-10-01,266,0,210,0,0,3016318,41578
300152442900,30-015-24429,LOVING 1 STATE 002,2005-11-01,267,0,128,0,0,3016446,41578
300152442900,30-015-24429,LOVING 1 STATE 002,2005-12-01,268,0,158,0,0,3016604,41578
300152442900,30-015-24429,LOVING 1 STATE 002,2006-01-01,269,0,177,0,0,3016781,41578
300152442900,30-015-24429,LOVING 1 STATE 002,2006-02-01,270,0,275,90,0,3017056,41668
300152442900,30-015-24429,LOVING 1 STATE 002,2006-03-01,271,0,0,3,0,3017056,41671
300152442900,30-015-24429,LOVING 1 STATE 002,2006-04-01,272,0,210,0,0,3017266,41671
300152442900,30-015-24429,LOVING 1 STATE 002,2006-05-01,273,0,271,0,0,3017537,41671
300152442900,30-015-24429,LOVING 1 STATE 002,2006-06-01,274,0,0,0,0,3017537,41671
300152442900,30-015-24429,LOVING 1 STATE 002,2006-07-01,275,0,287,12,0,3017824,41683
300152442900,30-015-24429,LOVING 1 STATE 002,2006-08-01,276,0,261,0,0,3018085,41683
300152442900,30-015-24429,LOVING 1 STATE 002,2006-09-01,277,0,198,0,0,3018283,41683
300152442900,30-015-24429,LOVING 1 STATE 002,2006-10-01,278,0,12,0,0,3018295,41683
300152442900,30-015-24429,LOVING 1 STATE 002,2006-11-01,279,0,165,0,0,3018460,41683
300152442900,30-015-24429,LOVING 1 STATE 002,2006-12-01,280,0,87,0,0,3018547,41683
300152442900,30-015-24429,LOVING 1 STATE 002,2007-01-01,281,0,93,0,0,3018640,41683
300152442900,30-015-24429,LOVING 1 STATE 002,2007-02-01,282,0,415,0,0,3019055,41683
300152442900,30-015-24429,LOVING 1 STATE 002,2007-03-01,283,0,154,0,0,3019209,41683
300152442900,30-015-24429,LOVING 1 STATE 002,2007-04-01,284,0,169,0,0,3019378,41683
300152442900,30-015-24429,LOVING 1 STATE 002,2007-05-01,285,0,421,0,0,3019799,41683
300152442900,30-015-24429,LOVING 1 STATE 002,2007-06-01,286,0,167,0,0,3019966,41683
300152442900,30-015-24429,LOVING 1 STATE 002,2007-07-01,287,0,145,0,0,3020111,41683
300154448300,30-015-44483,EL PRESIDENTE STATE 24 27 2 WA 005H,2018-08-01,1,12528,21635,41294,12528,21635,41294
300154448300,30-015-44483,EL PRESIDENTE STATE 24 27 2 WA 005H,2018-09-01,2,2977,5177,20648,15505,26812,61942
300154448300,30-015-44483,EL PRESIDENTE STATE 24 27 2 WA 005H,2018-10-01,3,5564,26959,41234,21069,53771,103176
300154448300,30-015-44483,EL PRESIDENTE STATE 24 27 2 WA 005H,2018-11-01,4,2209,6129,12534,23278,59900,115710
300154448300,30-015-44483,EL PRESIDENTE STATE 24 27 2 WA 005H,2018-12-01,5,4038,10068,20805,27316,69968,136515
300154448300,30-015-44483,EL PRESIDENTE STATE 24 27 2 WA 005H,2019-01-01,6,3788,12454,23142,31104,82422,159657
300154448300,30-015-44483,EL PRESIDENTE STATE 24 27 2 WA 005H,2019-02-01,7,3045,13753,23948,34149,96175,183605
300154448300,30-015-44483,EL PRESIDENTE STATE 24 27 2 WA 005H,2019-03-01,8,2919,16778,25220,37068,112953,208825
300154448300,30-015-44483,EL PRESIDENTE STATE 24 27 2 WA 005H,2019-04-01,9,2484,12986,16998,39552,125939,225823
300154448300,30-015-44483,EL PRESIDENTE STATE 24 27 2 WA 005H,2019-05-01,10,4890,22382,22429,44442,148321,248252
300154448300,30-015-44483,EL PRESIDENTE STATE 24 27 2 WA 005H,2019-06-01,11,3006,18677,17816,47448,166998,266068
300154448300,30-015-44483,EL PRESIDENTE STATE 24 27 2 WA 005H,2019-07-01,12,2052,12903,12397,49500,179901,278465
300154448300,30-015-44483,EL PRESIDENTE STATE 24 27 2 WA 005H,2019-08-01,13,1794,6507,9392,51294,186408,287857
300154448300,30-015-44483,EL PRESIDENTE STATE 24 27 2 WA 005H,2019-09-01,14,1157,2952,5393,52451,189360,293250
300154448300,30-015-44483,EL PRESIDENTE STATE 24 27 2 WA 005H,2019-10-01,15,1865,5951,9663,54316,195311,302913
300154448300,30-015-44483,EL PRESIDENTE STATE 24 27 2 WA 005H,2019-11-01,16,468,0,2392,54784,195311,305305
300154448300,30-015-44483,EL PRESIDENTE STATE 24 27 2 WA 005H,2019-12-01,17,703,0,3804,55487,195311,309109
300154448300,30-015-44483,EL PRESIDENTE STATE 24 27 2 WA 005H,2020-01-01,18,1712,4124,8074,57199,199435,317183
300154448300,30-015-44483,EL PRESIDENTE STATE 24 27 2 WA 005H,2020-02-01,19,848,2431,4471,58047,201866,321654
300154448300,30-015-44483,EL PRESIDENTE STATE 24 27 2 WA 005H,2020-03-01,20,1233,3880,6260,59280,205746,327914
300154448300,30-015-44483,EL PRESIDENTE STATE 24 27 2 WA 005H,2020-04-01,21,1573,6215,8184,60853,211961,336098
300154448300,30-015-44483,EL PRESIDENTE STATE 24 27 2 WA 005H,2020-05-01,22,1889,12153,12603,62742,224114,348701
300154448300,30-015-44483,EL PRESIDENTE STATE 24 27 2 WA 005H,2020-06-01,23,1610,19768,14738,64352,243882,363439
300154448300,30-015-44483,EL PRESIDENTE STATE 24 27 2 WA 005H,2020-07-01,24,1187,10712,9544,65539,254594,372983
300154448300,30-015-44483,EL PRESIDENTE STATE 24 27 2 WA 005H,2020-08-01,25,1196,9695,8814,66735,264289,381797
300154448300,30-015-44483,EL PRESIDENTE STATE 24 27 2 WA 005H,2020-09-01,26,1226,11191,9891,67961,275480,391688
300154448300,30-015-44483,EL PRESIDENTE STATE 24 27 2 WA 005H,2020-10-01,27,997,9655,8171,68958,285135,399859
300154448300,30-015-44483,EL PRESIDENTE STATE 24 27 2 WA 005H,2020-11-01,28,759,7719,7851,69717,292854,407710
300154448300,30-015-44483,EL PRESIDENTE STATE 24 27 2 WA 005H,2020-12-01,29,677,5621,5651,70394,298475,413361
300154448300,30-015-44483,EL PRESIDENTE STATE 24 27 2 WA 005H,2021-01-01,30,792,11374,11173,71186,309849,424534
300154448300,30-015-44483,EL PRESIDENTE STATE 24 27 2 WA 005H,2021-02-01,31,616,6549,6389,71802,316398,430923
300154448300,30-015-44483,EL PRESIDENTE STATE 24 27 2 WA 005H,2021-03-01,32,1240,7250,8113,73042,323648,439036
300154448300,30-015-44483,EL PRESIDENTE STATE 24 27 2 WA 005H,2021-04-01,33,1452,13862,11156,74494,337510,450192
300154448300,30-015-44483,EL PRESIDENTE STATE 24 27 2 WA 005H,2021-05-01,34,1345,13779,10928,75839,351289,461120
300154448300,30-015-44483,EL PRESIDENTE STATE 24 27 2 WA 005H,2021-06-01,35,1210,13721,10206,77049,365010,471326
300154448300,30-015-44483,EL PRESIDENTE STATE 24 27 2 WA 005H,2021-07-01,36,735,7792,7164,77784,372802,478490
300154448300,30-015-44483,EL PRESIDENTE STATE 24 27 2 WA 005H,2021-08-01,37,1144,7530,9676,78928,380332,488166
300154448300,30-015-44483,EL PRESIDENTE STATE 24 27 2 WA 005H,2021-09-01,38,1088,6066,8449,80016,386398,496615
300154448300,30-015-44483,EL PRESIDENTE STATE 24 27 2 WA 005H,2021-10-01,39,1294,9322,9072,81310,395720,505687
300154448300,30-015-44483,EL PRESIDENTE STATE 24 27 2 WA 005H,2021-11-01,40,963,9051,5629,82273,404771,511316
300154448300,30-015-44483,EL PRESIDENTE STATE 24 27 2 WA 005H,2021-12-01,41,772,8257,5617,83045,413028,516933
300154448300,30-015-44483,EL PRESIDENTE STATE 24 27 2 WA 005H,2022-01-01,42,210,6389,770,83255,419417,517703
300154448300,30-015-44483,EL PRESIDENTE STATE 24 27 2 WA 005H,2022-02-01,43,0,0,0,83255,419417,517703
300154448300,30-015-44483,EL PRESIDENTE STATE 24 27 2 WA 005H,2022-03-01,44,0,0,0,83255,419417,517703
300154448300,30-015-44483,EL PRESIDENTE STATE 24 27 2 WA 005H,2022-04-01,45,1079,6444,4631,84334,425861,522334
300154448300,30-015-44483,EL PRESIDENTE STATE 24 27 2 WA 005H,2022-05-01,46,964,6029,4669,85298,431890,527003
300154448300,30-015-44483,EL PRESIDENTE STATE 24 27 2 WA 005H,2022-06-01,47,1028,5054,4765,86326,436944,531768
300154448300,30-015-44483,EL PRESIDENTE STATE 24 27 2 WA 005H,2022-07-01,48,820,4257,3470,87146,441201,535238
300154448300,30-015-44483,EL PRESIDENTE STATE 24 27 2 WA 005H,2022-08-01,49,1133,4084,6094,88279,445285,541332
300154448300,30-015-44483,EL PRESIDENTE STATE 24 27 2 WA 005H,2022-09-01,50,1083,4824,5619,89362,450109,546951
300154448300,30-015-44483,EL PRESIDENTE STATE 24 27 2 WA 005H,2022-10-01,51,1277,8509,7263,90639,458618,554214
300154448300,30-015-44483,EL PRESIDENTE STATE 24 27 2 WA 005H,2022-11-01,52,1336,8701,7965,91975,467319,562179
300154448300,30-015-44483,EL PRESIDENTE STATE 24 27 2 WA 005H,2022-12-01,53,956,7751,6884,92931,475070,569063
300154448300,30-015-44483,EL PRESIDENTE STATE 24 27 2 WA 005H,2023-01-01,54,904,6747,6467,93835,481817,575530
300154448300,30-015-44483,EL PRESIDENTE STATE 24 27 2 WA 005H,2023-02-01,55,631,4818,3949,94466,486635,579479
300154448300,30-015-44483,EL PRESIDENTE STATE 24 27 2 WA 005H,2023-03-01,56,994,7478,5882,95460,494113,585361
300154448300,30-015-44483,EL PRESIDENTE STATE 24 27 2 WA 005H,2023-04-01,57,967,9692,7404,96427,503805,592765
300154448300,30-015-44483,EL PRESIDENTE STATE 24 27 2 WA 005H,2023-05-01,58,836,9398,6736,97263,513203,599501
300154448300,30-015-44483,EL PRESIDENTE STATE 24 27 2 WA 005H,2023-06-01,59,704,8246,5965,97967,521449,605466
300152442900,30-015-24429,LOVING 1 STATE 002,2007-09-01,1,0,335,9,0,3020446,41692
300152442900,30-015-24429,LOVING 1 STATE 002,2007-10-01,2,0,199,21,0,3020645,41713
300152442900,30-015-24429,LOVING 1 STATE 002,2007-11-01,3,0,167,51,0,3020812,41764
300152442900,30-015-24429,LOVING 1 STATE 002,2007-12-01,4,0,162,18,0,3020974,41782
300152442900,30-015-24429,LOVING 1 STATE 002,2008-01-01,5,0,161,0,0,3021135,41782
300152442900,30-015-24429,LOVING 1 STATE 002,2008-02-01,6,0,135,3,0,3021270,41785
300152442900,30-015-24429,LOVING 1 STATE 002,2008-03-01,7,0,97,9,0,3021367,41794
300152442900,30-015-24429,LOVING 1 STATE 002,2008-04-01,8,0,145,0,0,3021512,41794
300152442900,30-015-24429,LOVING 1 STATE 002,2008-05-01,9,0,102,0,0,3021614,41794
300152442900,30-015-24429,LOVING 1 STATE 002,2008-06-01,10,0,89,0,0,3021703,41794
300152442900,30-015-24429,LOVING 1 STATE 002,2008-07-01,11,0,65,0,0,3021768,41794
300152442900,30-015-24429,LOVING 1 STATE 002,2008-08-01,12,0,119,0,0,3021887,41794
300152442900,30-015-24429,LOVING 1 STATE 002,2008-09-01,13,0,144,0,0,3022031,41794
300152442900,30-015-24429,LOVING 1 STATE 002,2008-10-01,14,0,86,0,0,3022117,41794
300152442900,30-015-24429,LOVING 1 STATE 002,2008-11-01,15,0,94,0,0,3022211,41794
300152442900,30-015-24429,LOVING 1 STATE 002,2008-12-01,16,0,59,0,0,3022270,41794
300152442900,30-015-24429,LOVING 1 STATE 002,2009-01-01,17,0,13,0,0,3022283,41794
300152442900,30-015-24429,LOVING 1 STATE 002,2009-02-01,18,0,0,0,0,3022283,41794
300152442900,30-015-24429,LOVING 1 STATE 002,2009-03-01,19,0,0,0,0,3022283,41794
300152442900,30-015-24429,LOVING 1 STATE 002,2009-04-01,20,0,0,0,0,3022283,41794
300152442900,30-015-24429,LOVING 1 STATE 002,2009-05-01,21,0,0,0,0,3022283,41794
300152442900,30-015-24429,LOVING 1 STATE 002,2009-06-01,22,0,0,0,0,3022283,41794
300152442900,30-015-24429,LOVING 1 STATE 002,2009-07-01,23,0,0,0,0,3022283,41794
300152442900,30-015-24429,LOVING 1 STATE 002,2009-08-01,24,0,0,0,0,3022283,41794
300152442900,30-015-24429,LOVING 1 STATE 002,2009-09-01,25,0,0,0,0,3022283,41794
300152442900,30-015-24429,LOVING 1 STATE 002,2009-10-01,26,0,0,0,0,3022283,41794
300152442900,30-015-24429,LOVING 1 STATE 002,2009-11-01,27,0,0,0,0,3022283,41794
300152442900,30-015-24429,LOVING 1 STATE 002,2009-12-01,28,0,0,0,0,3022283,41794
300152442900,30-015-24429,LOVING 1 STATE 002,2010-01-01,29,0,0,0,0,3022283,41794
300152442900,30-015-24429,LOVING 1 STATE 002,2010-02-01,30,0,0,0,0,3022283,41794
300152442900,30-015-24429,LOVING 1 STATE 002,2010-03-01,31,0,0,0,0,3022283,41794
300152442900,30-015-24429,LOVING 1 STATE 002,2010-04-01,32,0,0,0,0,3022283,41794
300152442900,30-015-24429,LOVING 1 STATE 002,2010-05-01,33,0,0,0,0,3022283,41794
300152442900,30-015-24429,LOVING 1 STATE 002,2010-06-01,34,0,0,0,0,3022283,41794
300152442900,30-015-24429,LOVING 1 STATE 002,2010-07-01,35,0,0,0,0,3022283,41794
300152442900,30-015-24429,LOVING 1 STATE 002,2010-08-01,36,0,0,0,0,3022283,41794
300152442900,30-015-24429,LOVING 1 STATE 002,2010-09-01,37,0,0,0,0,3022283,41794
300152442900,30-015-24429,LOVING 1 STATE 002,2010-10-01,38,0,0,0,0,3022283,41794
300152442900,30-015-24429,LOVING 1 STATE 002,2010-11-01,39,0,0,0,0,3022283,41794
300152442900,30-015-24429,LOVING 1 STATE 002,2010-12-01,40,0,0,0,0,3022283,41794
300152442900,30-015-24429,LOVING 1 STATE 002,2011-01-01,41,0,0,0,0,3022283,41794
300152442900,30-015-24429,LOVING 1 STATE 002,2011-02-01,42,0,0,0,0,3022283,41794
300152442900,30-015-24429,LOVING 1 STATE 002,2011-03-01,43,0,0,0,0,3022283,41794
300152442900,30-015-24429,LOVING 1 STATE 002,2011-04-01,44,0,0,0,0,3022283,41794
300152442900,30-015-24429,LOVING 1 STATE 002,2011-05-01,45,0,0,0,0,3022283,41794
300152442900,30-015-24429,LOVING 1 STATE 002,2011-06-01,46,0,0,0,0,3022283,41794
300152442900,30-015-24429,LOVING 1 STATE 002,2011-07-01,47,0,0,0,0,3022283,41794
300152442900,30-015-24429,LOVING 1 STATE 002,2011-08-01,48,0,0,0,0,3022283,41794
300152442900,30-015-24429,LOVING 1 STATE 002,2011-09-01,49,0,0,0,0,3022283,41794
300152442900,30-015-24429,LOVING 1 STATE 002,2011-10-01,50,0,0,0,0,3022283,41794
300152442900,30-015-24429,LOVING 1 STATE 002,2011-11-01,51,0,0,0,0,3022283,41794
300152442900,30-015-24429,LOVING 1 STATE 002,2011-12-01,52,0,0,0,0,3022283,41794
300152442900,30-015-24429,LOVING 1 STATE 002,2012-02-01,1,1151,592,0,1151,3022875,41794
300152442900,30-015-24429,LOVING 1 STATE 002,2012-03-01,2,1067,6380,8066,2218,3029255,49860
300152442900,30-015-24429,LOVING 1 STATE 002,2012-04-01,3,547,5431,3201,2765,3034686,53061
300152442900,30-015-24429,LOVING 1 STATE 002,2012-05-01,4,497,4941,3706,3262,3039627,56767
300152442900,30-015-24429,LOVING 1 STATE 002,2012-06-01,5,376,4447,3204,3638,3044074,59971
300152442900,30-015-24429,LOVING 1 STATE 002,2012-07-01,6,385,4475,2845,4023,3048549,62816
300152442900,30-015-24429,LOVING 1 STATE 002,2012-08-01,7,135,3925,2236,4158,3052474,65052
300152442900,30-015-24429,LOVING 1 STATE 002,2012-09-01,8,523,3962,1336,4681,3056436,66388
300152442900,30-015-24429,LOVING 1 STATE 002,2012-10-01,9,270,4044,1619,4951,3060480,68007
300152442900,30-015-24429,LOVING 1 STATE 002,2012-11-01,10,295,3439,1827,5246,3063919,69834
300152442900,30-015-24429,LOVING 1 STATE 002,2012-12-01,11,277,3867,1780,5523,3067786,71614
300152442900,30-015-24429,LOVING 1 STATE 002,2013-01-01,12,262,3824,1644,5785,3071610,73258
300152442900,30-015-24429,LOVING 1 STATE 002,2013-02-01,13,232,4058,1629,6017,3075668,74887
300152442900,30-015-24429,LOVING 1 STATE 002,2013-03-01,14,216,3761,1522,6233,3079429,76409
300152442900,30-015-24429,LOVING 1 STATE 002,2013-04-01,15,184,2475,1109,6417,3081904,77518
300152442900,30-015-24429,LOVING 1 STATE 002,2013-05-01,16,60,1050,506,6477,3082954,78024
300152442900,30-015-24429,LOVING 1 STATE 002,2013-06-01,17,94,80,30,6571,3083034,78054
300152442900,30-015-24429,LOVING 1 STATE 002,2013-07-01,18,153,437,144,6724,3083471,78198
300152442900,30-015-24429,LOVING 1 STATE 002,2013-08-01,19,114,201,12,6838,3083672,78210
300152442900,30-015-24429,LOVING 1 STATE 002,2013-09-01,20,268,1874,3539,7106,3085546,81749
300152442900,30-015-24429,LOVING 1 STATE 002,2013-10-01,21,86,976,715,7192,3086522,82464
300152442900,30-015-24429,LOVING 1 STATE 002,2013-11-01,22,134,602,847,7326,3087124,83311
300152442900,30-015-24429,LOVING 1 STATE 002,2013-12-01,23,78,541,753,7404,3087665,84064
300152442900,30-015-24429,LOVING 1 STATE 002,2014-01-01,24,145,292,192,7549,3087957,84256
300152442900,30-015-24429,LOVING 1 STATE 002,2014-02-01,25,166,1146,2042,7715,3089103,86298
300152442900,30-015-24429,LOVING 1 STATE 002,2014-03-01,26,81,544,228,7796,3089647,86526
300152442900,30-015-24429,LOVING 1 STATE 002,2014-04-01,27,102,534,484,7898,3090181,87010
300152442900,30-015-24429,LOVING 1 STATE 002,2014-05-01,28,103,2,2,8001,3090183,87012
300152442900,30-015-24429,LOVING 1 STATE 002,2014-06-01,29,68,0,0,8069,3090183,87012
300152442900,30-015-24429,LOVING 1 STATE 002,2014-07-01,30,104,0,0,8173,3090183,87012
300152442900,30-015-24429,LOVING 1 STATE 002,2014-08-01,31,19,19,0,8192,3090202,87012
300152442900,30-015-24429,LOVING 1 STATE 002,2014-09-01,32,0,0,0,8192,3090202,87012
300152442900,30-015-24429,LOVING 1 STATE 002,2014-10-01,33,0,0,0,8192,3090202,87012
300152442900,30-015-24429,LOVING 1 STATE 002,2014-11-01,34,0,37,0,8192,3090239,87012
300152442900,30-015-24429,LOVING 1 STATE 002,2014-12-01,35,0,0,0,8192,3090239,87012
300152442900,30-015-24429,LOVING 1 STATE 002,2015-01-01,36,362,1,0,8554,3090240,87012
300152442900,30-015-24429,LOVING 1 STATE 002,2015-02-01,37,75,0,0,8629,3090240,87012
300152442900,30-015-24429,LOVING 1 STATE 002,2015-03-01,38,62,7,0,8691,3090247,87012
300152442900,30-015-24429,LOVING 1 STATE 002,2015-04-01,39,3,9,0,8694,3090256,87012
300152442900,30-015-24429,LOVING 1 STATE 002,2015-05-01,40,226,49,65,8920,3090305,87077
300152442900,30-015-24429,LOVING 1 STATE 002,2015-06-01,41,25,12,33,8945,3090317,87110
300152442900,30-015-24429,LOVING 1 STATE 002,2015-07-01,42,0,9,0,8945,3090326,87110
300152442900,30-015-24429,LOVING 1 STATE 002,2015-08-01,43,22,12,160,8967,3090338,87270
300152442900,30-015-24429,LOVING 1 STATE 002,2015-09-01,44,113,30,87,9080,3090368,87357
300152442900,30-015-24429,LOVING 1 STATE 002,2015-10-01,45,41,6,21,9121,3090374,87378
300152442900,30-015-24429,LOVING 1 STATE 002,2015-11-01,46,0,0,0,9121,3090374,87378
300152442900,30-015-24429,LOVING 1 STATE 002,2015-12-01,47,3,22,0,9124,3090396,87378
300152442900,30-015-24429,LOVING 1 STATE 002,2016-01-01,48,72,1,0,9196,3090397,87378
300152442900,30-015-24429,LOVING 1 STATE 002,2016-02-01,49,44,69,0,9240,3090466,87378
300152442900,30-015-24429,LOVING 1 STATE 002,2016-03-01,50,62,34,0,9302,3090500,87378
300152442900,30-015-24429,LOVING 1 STATE 002,2016-04-01,51,8,0,0,9310,3090500,87378
300152442900,30-015-24429,LOVING 1 STATE 002,2016-05-01,52,6,0,0,9316,3090500,87378
300152442900,30-015-24429,LOVING 1 STATE 002,2016-06-01,53,28,0,0,9344,3090500,87378
300154864700,30-015-48647,PERDOMO 25 STATE COM 702H,2023-06-01,1,17291,36617,67917,17291,36617,67917
300154864700,30-015-48647,PERDOMO 25 STATE COM 702H,2023-07-01,2,31126,63087,120970,48417,99704,188887
300154127000,30-015-41270,TAOS FEDERAL 004H,2013-08-01,1,1181,47,9277,1181,47,9277
300154127000,30-015-41270,TAOS FEDERAL 004H,2013-09-01,2,7061,27420,25628,8242,27467,34905
300154127000,30-015-41270,TAOS FEDERAL 004H,2013-10-01,3,3471,22212,13343,11713,49679,48248
300154127000,30-015-41270,TAOS FEDERAL 004H,2013-11-01,4,1773,12760,6264,13486,62439,54512
300154127000,30-015-41270,TAOS FEDERAL 004H,2013-12-01,5,2636,14305,6804,16122,76744,61316
300154127000,30-015-41270,TAOS FEDERAL 004H,2014-01-01,6,1692,12414,5081,17814,89158,66397
300154127000,30-015-41270,TAOS FEDERAL 004H,2014-02-01,7,1576,12177,5329,19390,101335,71726
300154127000,30-015-41270,TAOS FEDERAL 004H,2014-03-01,8,1516,8396,5328,20906,109731,77054
300154127000,30-015-41270,TAOS FEDERAL 004H,2014-04-01,9,1360,7863,4885,22266,117594,81939
300154127000,30-015-41270,TAOS FEDERAL 004H,2014-05-01,10,1332,7458,4545,23598,125052,86484
300154127000,30-015-41270,TAOS FEDERAL 004H,2014-06-01,11,1173,7296,3499,24771,132348,89983
300154127000,30-015-41270,TAOS FEDERAL 004H,2014-07-01,12,1179,6566,3485,25950,138914,93468
300154127000,30-015-41270,TAOS FEDERAL 004H,2014-08-01,13,1165,7093,3476,27115,146007,96944
300154127000,30-015-41270,TAOS FEDERAL 004H,2014-09-01,14,537,3658,1478,27652,149665,98422
300154127000,30-015-41270,TAOS FEDERAL 004H,2014-10-01,15,1340,6211,3399,28992,155876,101821
300154127000,30-015-41270,TAOS FEDERAL 004H,2014-11-01,16,1009,5066,2726,30001,160942,104547
300154127000,30-015-41270,TAOS FEDERAL 004H,2014-12-01,17,876,4493,2285,30877,165435,106832
300154127000,30-015-41270,TAOS FEDERAL 004H,2015-01-01,18,673,3543,1459,31550,168978,108291
300154127000,30-015-41270,TAOS FEDERAL 004H,2015-02-01,19,894,7077,2249,32444,176055,110540
300154127000,30-015-41270,TAOS FEDERAL 004H,2015-03-01,20,1108,9170,2934,33552,185225,113474
300154127000,30-015-41270,TAOS FEDERAL 004H,2015-04-01,21,861,8504,2764,34413,193729,116238
300154127000,30-015-41270,TAOS FEDERAL 004H,2015-05-01,22,822,7067,3076,35235,200796,119314
300154127000,30-015-41270,TAOS FEDERAL 004H,2015-06-01,23,781,4875,2630,36016,205671,121944
300154127000,30-015-41270,TAOS FEDERAL 004H,2015-07-01,24,771,4987,2832,36787,210658,124776
300154127000,30-015-41270,TAOS FEDERAL 004H,2015-08-01,25,749,3324,2893,37536,213982,127669
300154127000,30-015-41270,TAOS FEDERAL 004H,2015-09-01,26,666,4563,2596,38202,218545,130265
300154127000,30-015-41270,TAOS FEDERAL 004H,2015-10-01,27,786,4525,2623,38988,223070,132888
300154127000,30-015-41270,TAOS FEDERAL 004H,2015-11-01,28,651,4346,2233,39639,227416,135121
300154127000,30-015-41270,TAOS FEDERAL 004H,2015-12-01,29,575,3254,1985,40214,230670,137106
300154127000,30-015-41270,TAOS FEDERAL 004H,2016-01-01,30,634,3301,1688,40848,233971,138794
300154127000,30-015-41270,TAOS FEDERAL 004H,2016-02-01,31,736,3619,2491,41584,237590,141285
300154127000,30-015-41270,TAOS FEDERAL 004H,2016-03-01,32,619,3540,2433,42203,241130,143718
300154127000,30-015-41270,TAOS FEDERAL 004H,2016-04-01,33,683,3716,2702,42886,244846,146420
300154127000,30-015-41270,TAOS FEDERAL 004H,2016-05-01,34,648,3423,2673,43534,248269,149093
300154127000,30-015-41270,TAOS FEDERAL 004H,2016-06-01,35,591,3193,2536,44125,251462,151629
300154127000,30-015-41270,TAOS FEDERAL 004H,2016-07-01,36,585,3145,2695,44710,254607,154324
300154127000,30-015-41270,TAOS FEDERAL 004H,2016-08-01,37,603,2963,2717,45313,257570,157041
300154127000,30-015-41270,TAOS FEDERAL 004H,2016-09-01,38,545,2936,2614,45858,260506,159655
300154127000,30-015-41270,TAOS FEDERAL 004H,2016-10-01,39,548,3069,2625,46406,263575,162280
300154127000,30-015-41270,TAOS FEDERAL 004H,2016-11-01,40,568,2811,2394,46974,266386,164674
300154127000,30-015-41270,TAOS FEDERAL 004H,2016-12-01,41,569,2798,2393,47543,269184,167067
300154127000,30-015-41270,TAOS FEDERAL 004H,2017-01-01,42,550,2667,2040,48093,271851,169107
300154127000,30-015-41270,TAOS FEDERAL 004H,2017-02-01,43,495,2604,1565,48588,274455,170672
300154127000,30-015-41270,TAOS FEDERAL 004H,2017-03-01,44,529,2749,1606,49117,277204,172278
300154127000,30-015-41270,TAOS FEDERAL 004H,2017-04-01,45,486,2581,1547,49603,279785,173825
300154127000,30-015-41270,TAOS FEDERAL 004H,2017-05-01,46,517,2752,1579,50120,282537,175404
300154127000,30-015-41270,TAOS FEDERAL 004H,2017-06-01,47,369,1775,965,50489,284312,176369
300154127000,30-015-41270,TAOS FEDERAL 004H,2017-07-01,48,531,1713,1675,51020,286025,178044
300154127000,30-015-41270,TAOS FEDERAL 004H,2017-08-01,49,464,2085,1645,51484,288110,179689
300154127000,30-015-41270,TAOS FEDERAL 004H,2017-09-01,50,469,2228,1514,51953,290338,181203
300154127000,30-015-41270,TAOS FEDERAL 004H,2017-10-01,51,425,1858,1468,52378,292196,182671
300154127000,30-015-41270,TAOS FEDERAL 004H,2017-11-01,52,419,1795,1396,52797,293991,184067
300154127000,30-015-41270,TAOS FEDERAL 004H,2017-12-01,53,388,1860,1526,53185,295851,185593
300154127000,30-015-41270,TAOS FEDERAL 004H,2018-01-01,54,445,2003,1541,53630,297854,187134
300154127000,30-015-41270,TAOS FEDERAL 004H,2018-02-01,55,467,1849,3112,54097,299703,190246
300154127000,30-015-41270,TAOS FEDERAL 004H,2018-03-01,56,595,2086,1779,54692,301789,192025
300154127000,30-015-41270,TAOS FEDERAL 004H,2018-04-01,57,435,2391,1614,55127,304180,193639
300154127000,30-015-41270,TAOS FEDERAL 004H,2018-05-01,58,447,2449,1718,55574,306629,195357
300154127000,30-015-41270,TAOS FEDERAL 004H,2018-06-01,59,407,2399,1567,55981,309028,196924
300154127000,30-015-41270,TAOS FEDERAL 004H,2018-07-01,60,439,2381,1902,56420,311409,198826
300154127000,30-015-41270,TAOS FEDERAL 004H,2018-08-01,61,416,2303,1655,56836,313712,200481
300154127000,30-015-41270,TAOS FEDERAL 004H,2018-09-01,62,392,2218,1540,57228,315930,202021
300154127000,30-015-41270,TAOS FEDERAL 004H,2018-10-01,63,423,2232,1466,57651,318162,203487
300154127000,30-015-41270,TAOS FEDERAL 004H,2018-11-01,64,339,1342,1696,57990,319504,205183
300154127000,30-015-41270,TAOS FEDERAL 004H,2018-12-01,65,450,1938,4452,58440,321442,209635
300154127000,30-015-41270,TAOS FEDERAL 004H,2019-01-01,66,284,1266,2987,58724,322708,212622
300154127000,30-015-41270,TAOS FEDERAL 004H,2019-02-01,67,443,1745,2937,59167,324453,215559
300154127000,30-015-41270,TAOS FEDERAL 004H,2019-03-01,68,451,1864,4032,59618,326317,219591
300154127000,30-015-41270,TAOS FEDERAL 004H,2019-04-01,69,388,2001,3338,60006,328318,222929
300154127000,30-015-41270,TAOS FEDERAL 004H,2019-05-01,70,366,2533,3471,60372,330851,226400
300154127000,30-015-41270,TAOS FEDERAL 004H,2019-06-01,71,409,2046,3274,60781,332897,229674
300154127000,30-015-41270,TAOS FEDERAL 004H,2019-07-01,72,425,2012,3117,61206,334909,232791
300154127000,30-015-41270,TAOS FEDERAL 004H,2019-08-01,73,420,2149,3017,61626,337058,235808
300154127000,30-015-41270,TAOS FEDERAL 004H,2019-09-01,74,384,1580,2709,62010,338638,238517
300154127000,30-015-41270,TAOS FEDERAL 004H,2019-10-01,75,400,1757,2722,62410,340395,241239
300154127000,30-015-41270,TAOS FEDERAL 004H,2019-11-01,76,401,1980,1911,62811,342375,243150
300154127000,30-015-41270,TAOS FEDERAL 004H,2019-12-01,77,449,2813,2645,63260,345188,245795
300154127000,30-015-41270,TAOS FEDERAL 004H,2020-01-01,78,517,2129,2253,63777,347317,248048
300154127000,30-015-41270,TAOS FEDERAL 004H,2020-02-01,79,356,148,1535,64133,347465,249583
300154127000,30-015-41270,TAOS FEDERAL 004H,2020-03-01,80,292,2070,900,64425,349535,250483
300154127000,30-015-41270,TAOS FEDERAL 004H,2020-04-01,81,0,0,0,64425,349535,250483
300154127000,30-015-41270,TAOS FEDERAL 004H,2020-05-01,82,0,0,97,64425,349535,250580
300154127000,30-015-41270,TAOS FEDERAL 004H,2020-06-01,83,234,3376,1967,64659,352911,252547
300154127000,30-015-41270,TAOS FEDERAL 004H,2020-07-01,84,374,2704,1514,65033,355615,254061
300154127000,30-015-41270,TAOS FEDERAL 004H,2020-08-01,85,406,3136,1451,65439,358751,255512
300154127000,30-015-41270,TAOS FEDERAL 004H,2020-09-01,86,602,2943,1951,66041,361694,257463
300154127000,30-015-41270,TAOS FEDERAL 004H,2020-10-01,87,429,2213,1573,66470,363907,259036
300154127000,30-015-41270,TAOS FEDERAL 004H,2020-11-01,88,592,2387,1771,67062,366294,260807
300154127000,30-015-41270,TAOS FEDERAL 004H,2020-12-01,89,318,2613,1521,67380,368907,262328
300154127000,30-015-41270,TAOS FEDERAL 004H,2021-01-01,90,431,2287,1488,67811,371194,263816
300154127000,30-015-41270,TAOS FEDERAL 004H,2021-02-01,91,307,128,1563,68118,371322,265379
300154127000,30-015-41270,TAOS FEDERAL 004H,2021-03-01,92,422,2466,1693,68540,373788,267072
300154127000,30-015-41270,TAOS FEDERAL 004H,2021-04-01,93,386,2304,1417,68926,376092,268489
300154127000,30-015-41270,TAOS FEDERAL 004H,2021-05-01,94,332,2293,1421,69258,378385,269910
300154127000,30-015-41270,TAOS FEDERAL 004H,2021-06-01,95,316,2230,1397,69574,380615,271307
300154127000,30-015-41270,TAOS FEDERAL 004H,2021-07-01,96,393,3016,2032,69967,383631,273339
300154127000,30-015-41270,TAOS FEDERAL 004H,2021-08-01,97,332,2633,1545,70299,386264,274884
300154127000,30-015-41270,TAOS FEDERAL 004H,2021-09-01,98,307,2820,1523,70606,389084,276407
300154127000,30-015-41270,TAOS FEDERAL 004H,2021-10-01,99,324,2736,1395,70930,391820,277802
300154127000,30-015-41270,TAOS FEDERAL 004H,2021-11-01,100,342,2958,1544,71272,394778,279346
300154127000,30-015-41270,TAOS FEDERAL 004H,2021-12-01,101,353,2983,1501,71625,397761,280847
300154127000,30-015-41270,TAOS FEDERAL 004H,2022-01-01,102,338,2544,1410,71963,400305,282257
300154127000,30-015-41270,TAOS FEDERAL 004H,2022-02-01,103,292,2261,1178,72255,402566,283435
300154127000,30-015-41270,TAOS FEDERAL 004H,2022-03-01,104,331,2633,1384,72586,405199,284819
300154127000,30-015-41270,TAOS FEDERAL 004H,2022-04-01,105,267,1730,1136,72853,406929,285955
300154127000,30-015-41270,TAOS FEDERAL 004H,2022-05-01,106,268,2212,993,73121,409141,286948
300154127000,30-015-41270,TAOS FEDERAL 004H,2022-06-01,107,275,2128,1224,73396,411269,288172
300154127000,30-015-41270,TAOS FEDERAL 004H,2022-07-01,108,296,2054,1294,73692,413323,289466
300154127000,30-015-41270,TAOS FEDERAL 004H,2022-08-01,109,312,2028,1356,74004,415351,290822
300154127000,30-015-41270,TAOS FEDERAL 004H,2022-09-01,110,252,1915,1133,74256,417266,291955
300154127000,30-015-41270,TAOS FEDERAL 004H,2022-10-01,111,310,1961,1292,74566,419227,293247
300154127000,30-015-41270,TAOS FEDERAL 004H,2022-11-01,112,270,1869,1261,74836,421096,294508
300154127000,30-015-41270,TAOS FEDERAL 004H,2022-12-01,113,346,1814,1114,75182,422910,295622
300154127000,30-015-41270,TAOS FEDERAL 004H,2023-01-01,114,302,1855,1360,75484,424765,296982
300154127000,30-015-41270,TAOS FEDERAL 004H,2023-02-01,115,279,1637,1132,75763,426402,298114
300154127000,30-015-41270,TAOS FEDERAL 004H,2023-03-01,116,276,1934,1159,76039,428336,299273
300154127000,30-015-41270,TAOS FEDERAL 004H,2023-04-01,117,258,1306,1103,76297,429642,300376
300154127000,30-015-41270,TAOS FEDERAL 004H,2023-05-01,118,269,2076,1167,76566,431718,301543
300154127000,30-015-41270,TAOS FEDERAL 004H,2023-06-01,119,202,906,688,76768,432624,302231
300154448500,30-015-44485,EL PRESIDENTE STATE 24 27 2 WXY 010H,2018-07-01,1,20699,42410,0,20699,42410,0
300154448500,30-015-44485,EL PRESIDENTE STATE 24 27 2 WXY 010H,2018-08-01,2,16975,24684,54176,37674,67094,54176
300154448500,30-015-44485,EL PRESIDENTE STATE 24 27 2 WXY 010H,2018-09-01,3,6234,5158,21869,43908,72252,76045
300154448500,30-015-44485,EL PRESIDENTE STATE 24 27 2 WXY 010H,2018-10-01,4,11167,27689,39229,55075,99941,115274
300154448500,30-015-44485,EL PRESIDENTE STATE 24 27 2 WXY 010H,2018-11-01,5,628,1650,2643,55703,101591,117917
300154448500,30-015-44485,EL PRESIDENTE STATE 24 27 2 WXY 010H,2018-12-01,6,5877,6837,21607,61580,108428,139524
300154448500,30-015-44485,EL PRESIDENTE STATE 24 27 2 WXY 010H,2019-01-01,7,5029,7371,16104,66609,115799,155628
300154448500,30-015-44485,EL PRESIDENTE STATE 24 27 2 WXY 010H,2019-02-01,8,4549,19806,28188,71158,135605,183816
300154448500,30-015-44485,EL PRESIDENTE STATE 24 27 2 WXY 010H,2019-03-01,9,3602,15927,21894,74760,151532,205710
300154448500,30-015-44485,EL PRESIDENTE STATE 24 27 2 WXY 010H,2019-04-01,10,3677,12955,17595,78437,164487,223305
300154448500,30-015-44485,EL PRESIDENTE STATE 24 27 2 WXY 010H,2019-05-01,11,5196,17798,21973,83633,182285,245278
300154448500,30-015-44485,EL PRESIDENTE STATE 24 27 2 WXY 010H,2019-06-01,12,3554,17220,19033,87187,199505,264311
300154448500,30-015-44485,EL PRESIDENTE STATE 24 27 2 WXY 010H,2019-07-01,13,2458,12470,13174,89645,211975,277485
300154448500,30-015-44485,EL PRESIDENTE STATE 24 27 2 WXY 010H,2019-08-01,14,2982,9030,7583,92627,221005,285068
300154448500,30-015-44485,EL PRESIDENTE STATE 24 27 2 WXY 010H,2019-09-01,15,2457,7710,6267,95084,228715,291335
300154448500,30-015-44485,EL PRESIDENTE STATE 24 27 2 WXY 010H,2019-10-01,16,1846,5776,6260,96930,234491,297595
300154448500,30-015-44485,EL PRESIDENTE STATE 24 27 2 WXY 010H,2019-11-01,17,1938,4835,6941,98868,239326,304536
300154448500,30-015-44485,EL PRESIDENTE STATE 24 27 2 WXY 010H,2019-12-01,18,2060,4098,6307,100928,243424,310843
300154448500,30-015-44485,EL PRESIDENTE STATE 24 27 2 WXY 010H,2020-01-01,19,2348,5973,9155,103276,249397,319998
300154448500,30-015-44485,EL PRESIDENTE STATE 24 27 2 WXY 010H,2020-02-01,20,1911,6213,7843,105187,255610,327841
300154448500,30-015-44485,EL PRESIDENTE STATE 24 27 2 WXY 010H,2020-03-01,21,2147,8715,7988,107334,264325,335829
300154448500,30-015-44485,EL PRESIDENTE STATE 24 27 2 WXY 010H,2020-04-01,22,1980,9365,4767,109314,273690,340596
300154448500,30-015-44485,EL PRESIDENTE STATE 24 27 2 WXY 010H,2020-05-01,23,1827,10470,3080,111141,284160,343676
300154448500,30-015-44485,EL PRESIDENTE STATE 24 27 2 WXY 010H,2020-06-01,24,1360,9808,1506,112501,293968,345182
300154448500,30-015-44485,EL PRESIDENTE STATE 24 27 2 WXY 010H,2020-07-01,25,1325,7069,6785,113826,301037,351967
300154448500,30-015-44485,EL PRESIDENTE STATE 24 27 2 WXY 010H,2020-08-01,26,919,4402,2903,114745,305439,354870
300154448500,30-015-44485,EL PRESIDENTE STATE 24 27 2 WXY 010H,2020-09-01,27,1157,5184,4984,115902,310623,359854
300154448500,30-015-44485,EL PRESIDENTE STATE 24 27 2 WXY 010H,2020-10-01,28,1335,4932,6702,117237,315555,366556
300154448500,30-015-44485,EL PRESIDENTE STATE 24 27 2 WXY 010H,2020-11-01,29,130,704,677,117367,316259,367233
300154448500,30-015-44485,EL PRESIDENTE STATE 24 27 2 WXY 010H,2020-12-01,30,1321,3774,3368,118688,320033,370601
300154448500,30-015-44485,EL PRESIDENTE STATE 24 27 2 WXY 010H,2021-01-01,31,1447,3482,4039,120135,323515,374640
300154448500,30-015-44485,EL PRESIDENTE STATE 24 27 2 WXY 010H,2021-02-01,32,1238,2683,2204,121373,326198,376844
300154448500,30-015-44485,EL PRESIDENTE STATE 24 27 2 WXY 010H,2021-03-01,33,1013,3254,3825,122386,329452,380669
300154448500,30-015-44485,EL PRESIDENTE STATE 24 27 2 WXY 010H,2021-04-01,34,1270,3517,3951,123656,332969,384620
300154448500,30-015-44485,EL PRESIDENTE STATE 24 27 2 WXY 010H,2021-05-01,35,1384,4738,5153,125040,337707,389773
300154448500,30-015-44485,EL PRESIDENTE STATE 24 27 2 WXY 010H,2021-06-01,36,1325,5302,0,126365,343009,389773
300154448500,30-015-44485,EL PRESIDENTE STATE 24 27 2 WXY 010H,2021-07-01,37,959,4970,2821,127324,347979,392594
300154448500,30-015-44485,EL PRESIDENTE STATE 24 27 2 WXY 010H,2021-08-01,38,1259,5654,5688,128583,353633,398282
300154448500,30-015-44485,EL PRESIDENTE STATE 24 27 2 WXY 010H,2021-09-01,39,313,1014,1063,128896,354647,399345
300154448500,30-015-44485,EL PRESIDENTE STATE 24 27 2 WXY 010H,2021-10-01,40,186,0,3,129082,354647,399348
300154448500,30-015-44485,EL PRESIDENTE STATE 24 27 2 WXY 010H,2021-11-01,41,22,0,0,129104,354647,399348
300154448500,30-015-44485,EL PRESIDENTE STATE 24 27 2 WXY 010H,2021-12-01,42,21,0,0,129125,354647,399348
300154448500,30-015-44485,EL PRESIDENTE STATE 24 27 2 WXY 010H,2022-01-01,43,937,4569,1717,130062,359216,401065
300154448500,30-015-44485,EL PRESIDENTE STATE 24 27 2 WXY 010H,2022-02-01,44,1069,4594,3572,131131,363810,404637
300154448500,30-015-44485,EL PRESIDENTE STATE 24 27 2 WXY 010H,2022-03-01,45,935,4430,3558,132066,368240,408195
300154448500,30-015-44485,EL PRESIDENTE STATE 24 27 2 WXY 010H,2022-04-01,46,902,2853,3285,132968,371093,411480
300154448500,30-015-44485,EL PRESIDENTE STATE 24 27 2 WXY 010H,2022-05-01,47,1096,3512,3693,134064,374605,415173
300154448500,30-015-44485,EL PRESIDENTE STATE 24 27 2 WXY 010H,2022-06-01,48,1004,3197,3246,135068,377802,418419
300154448500,30-015-44485,EL PRESIDENTE STATE 24 27 2 WXY 010H,2022-07-01,49,871,3245,3253,135939,381047,421672
300154448500,30-015-44485,EL PRESIDENTE STATE 24 27 2 WXY 010H,2022-08-01,50,540,3264,3633,136479,384311,425305
300154448500,30-015-44485,EL PRESIDENTE STATE 24 27 2 WXY 010H,2022-09-01,51,1028,4408,4290,137507,388719,429595
300154448500,30-015-44485,EL PRESIDENTE STATE 24 27 2 WXY 010H,2022-10-01,52,1160,5581,5220,138667,394300,434815
300154448500,30-015-44485,EL PRESIDENTE STATE 24 27 2 WXY 010H,2022-11-01,53,1243,5093,5284,139910,399393,440099
300154448500,30-015-44485,EL PRESIDENTE STATE 24 27 2 WXY 010H,2022-12-01,54,261,960,975,140171,400353,441074
300154448500,30-015-44485,EL PRESIDENTE STATE 24 27 2 WXY 010H,2023-01-01,55,9,0,0,140180,400353,441074
300154448500,30-015-44485,EL PRESIDENTE STATE 24 27 2 WXY 010H,2023-02-01,56,0,3,0,140180,400356,441074
300154448500,30-015-44485,EL PRESIDENTE STATE 24 27 2 WXY 010H,2023-03-01,57,913,2889,2622,141093,403245,443696
300154448500,30-015-44485,EL PRESIDENTE STATE 24 27 2 WXY 010H,2023-04-01,58,913,3436,1818,142006,406681,445514
300154448500,30-015-44485,EL PRESIDENTE STATE 24 27 2 WXY 010H,2023-05-01,59,914,2845,3070,142920,409526,448584
300154448500,30-015-44485,EL PRESIDENTE STATE 24 27 2 WXY 010H,2023-06-01,60,908,3099,3674,143828,412625,452258
300153570500,30-015-35705,ALMOSTGON STATE 001,2008-01-01,1,2,23943,0,2,23943,0
300153570500,30-015-35705,ALMOSTGON STATE 001,2008-02-01,2,3,26400,0,5,50343,0
300153570500,30-015-35705,ALMOSTGON STATE 001,2008-03-01,3,7,27644,0,12,77987,0
300153570500,30-015-35705,ALMOSTGON STATE 001,2008-04-01,4,20,58101,16,32,136088,16
300153570500,30-015-35705,ALMOSTGON STATE 001,2008-05-01,5,13,60448,25,45,196536,41
300153570500,30-015-35705,ALMOSTGON STATE 001,2008-06-01,6,12,56271,23,57,252807,64
300153570500,30-015-35705,ALMOSTGON STATE 001,2008-07-01,7,14,56046,25,71,308853,89
300153570500,30-015-35705,ALMOSTGON STATE 001,2008-08-01,8,8,43774,14,79,352627,103
300153570500,30-015-35705,ALMOSTGON STATE 001,2008-09-01,9,5,26525,6,84,379152,109
300153570500,30-015-35705,ALMOSTGON STATE 001,2008-10-01,10,2,8686,3,86,387838,112
300153570500,30-015-35705,ALMOSTGON STATE 001,2008-11-01,11,0,0,0,86,387838,112
300153570500,30-015-35705,ALMOSTGON STATE 001,2008-12-01,12,0,26333,0,86,414171,112
300153570500,30-015-35705,ALMOSTGON STATE 001,2009-01-01,13,5,25501,0,91,439672,112
300153570500,30-015-35705,ALMOSTGON STATE 001,2009-02-01,14,3,25465,0,94,465137,112
300153570500,30-015-35705,ALMOSTGON STATE 001,2009-03-01,15,0,2202,0,94,467339,112
300153570500,30-015-35705,ALMOSTGON STATE 001,2009-04-01,16,0,3814,0,94,471153,112
300153570500,30-015-35705,ALMOSTGON STATE 001,2009-05-01,17,0,3550,0,94,474703,112
300153570500,30-015-35705,ALMOSTGON STATE 001,2009-06-01,18,0,846,0,94,475549,112
300153570500,30-015-35705,ALMOSTGON STATE 001,2009-07-01,19,0,2587,0,94,478136,112
300153570500,30-015-35705,ALMOSTGON STATE 001,2009-08-01,20,0,4655,0,94,482791,112
300153570500,30-015-35705,ALMOSTGON STATE 001,2009-09-01,21,7,3232,3,101,486023,115
300153570500,30-015-35705,ALMOSTGON STATE 001,2009-10-01,22,0,15701,0,101,501724,115
300153570500,30-015-35705,ALMOSTGON STATE 001,2009-11-01,23,0,25901,0,101,527625,115
300153570500,30-015-35705,ALMOSTGON STATE 001,2009-12-01,24,15,34216,0,116,561841,115
300153570500,30-015-35705,ALMOSTGON STATE 001,2010-01-01,25,0,33683,42,116,595524,157
300153570500,30-015-35705,ALMOSTGON STATE 001,2010-02-01,26,0,51425,0,116,646949,157
300153570500,30-015-35705,ALMOSTGON STATE 001,2010-03-01,27,0,58458,12,116,705407,169
300153570500,30-015-35705,ALMOSTGON STATE 001,2010-04-01,28,5,56897,17,121,762304,186
300153570500,30-015-35705,ALMOSTGON STATE 001,2010-05-01,29,0,58871,8,121,821175,194
300153570500,30-015-35705,ALMOSTGON STATE 001,2010-06-01,30,13,69114,39,134,890289,233
300153570500,30-015-35705,ALMOSTGON STATE 001,2010-07-01,31,0,76523,36,134,966812,269
300153570500,30-015-35705,ALMOSTGON STATE 001,2010-08-01,32,7,77973,56,141,1044785,325
300153570500,30-015-35705,ALMOSTGON STATE 001,2010-09-01,33,8,74203,44,149,1118988,369
300153570500,30-015-35705,ALMOSTGON STATE 001,2010-10-01,34,0,75119,18,149,1194107,387
300153570500,30-015-35705,ALMOSTGON STATE 001,2010-11-01,35,0,71368,0,149,1265475,387
300153570500,30-015-35705,ALMOSTGON STATE 001,2010-12-01,36,22,72361,105,171,1337836,492
300153570500,30-015-35705,ALMOSTGON STATE 001,2011-01-01,37,3,70985,12,174,1408821,504
300153570500,30-015-35705,ALMOSTGON STATE 001,2011-02-01,38,31,58488,6,205,1467309,510
300153570500,30-015-35705,ALMOSTGON STATE 001,2011-03-01,39,13,68851,32,218,1536160,542
300153570500,30-015-35705,ALMOSTGON STATE 001,2011-04-01,40,8,65330,35,226,1601490,577
300153570500,30-015-35705,ALMOSTGON STATE 001,2011-05-01,41,10,66349,58,236,1667839,635
300153570500,30-015-35705,ALMOSTGON STATE 001,2011-06-01,42,5,63061,60,241,1730900,695
300153570500,30-015-35705,ALMOSTGON STATE 001,2011-07-01,43,0,64997,43,241,1795897,738
300153570500,30-015-35705,ALMOSTGON STATE 001,2011-08-01,44,18,64628,61,259,1860525,799
300153570500,30-015-35705,ALMOSTGON STATE 001,2011-09-01,45,4,61933,52,263,1922458,851
300153570500,30-015-35705,ALMOSTGON STATE 001,2011-10-01,46,0,63462,52,263,1985920,903
300153570500,30-015-35705,ALMOSTGON STATE 001,2011-11-01,47,7,60805,65,270,2046725,968
300153570500,30-015-35705,ALMOSTGON STATE 001,2011-12-01,48,18,62345,57,288,2109070,1025
300153570500,30-015-35705,ALMOSTGON STATE 001,2012-01-01,49,13,62112,66,301,2171182,1091
300153570500,30-015-35705,ALMOSTGON STATE 001,2012-02-01,50,7,57432,49,308,2228614,1140
300153570500,30-015-35705,ALMOSTGON STATE 001,2012-03-01,51,11,61210,58,319,2289824,1198
300153570500,30-015-35705,ALMOSTGON STATE 001,2012-04-01,52,8,59012,72,327,2348836,1270
300153570500,30-015-35705,ALMOSTGON STATE 001,2012-05-01,53,0,60782,80,327,2409618,1350
300153570500,30-015-35705,ALMOSTGON STATE 001,2012-06-01,54,8,57897,58,335,2467515,1408
300153570500,30-015-35705,ALMOSTGON STATE 001,2012-07-01,55,9,56010,75,344,2523525,1483
300153570500,30-015-35705,ALMOSTGON STATE 001,2012-08-01,56,8,53700,68,352,2577225,1551
300153570500,30-015-35705,ALMOSTGON STATE 001,2012-09-01,57,6,50771,73,358,2627996,1624
300153570500,30-015-35705,ALMOSTGON STATE 001,2012-10-01,58,5,51179,81,363,2679175,1705
300153570500,30-015-35705,ALMOSTGON STATE 001,2012-11-01,59,7,47572,77,370,2726747,1782
300153570500,30-015-35705,ALMOSTGON STATE 001,2012-12-01,60,10,47463,89,380,2774210,1871
300153570500,30-015-35705,ALMOSTGON STATE 001,2013-01-01,61,9,47225,92,389,2821435,1963
300153570500,30-015-35705,ALMOSTGON STATE 001,2013-02-01,62,7,42588,84,396,2864023,2047
300153570500,30-015-35705,ALMOSTGON STATE 001,2013-03-01,63,10,45914,87,406,2909937,2134
300153570500,30-015-35705,ALMOSTGON STATE 001,2013-04-01,64,6,42736,81,412,2952673,2215
300153570500,30-015-35705,ALMOSTGON STATE 001,2013-05-01,65,10,42160,84,422,2994833,2299
300153570500,30-015-35705,ALMOSTGON STATE 001,2013-06-01,66,3,40276,85,425,3035109,2384
300153570500,30-015-35705,ALMOSTGON STATE 001,2013-07-01,67,5,40899,83,430,3076008,2467
300153570500,30-015-35705,ALMOSTGON STATE 001,2013-08-01,68,4,39803,105,434,3115811,2572
300153570500,30-015-35705,ALMOSTGON STATE 001,2013-09-01,69,6,38353,62,440,3154164,2634
300153570500,30-015-35705,ALMOSTGON STATE 001,2013-10-01,70,2,45863,78,442,3200027,2712
300153570500,30-015-35705,ALMOSTGON STATE 001,2013-11-01,71,5,38566,50,447,3238593,2762
300153570500,30-015-35705,ALMOSTGON STATE 001,2013-12-01,72,1,35599,46,448,3274192,2808
300153570500,30-015-35705,ALMOSTGON STATE 001,2014-01-01,73,5,33993,51,453,3308185,2859
300153570500,30-015-35705,ALMOSTGON STATE 001,2014-02-01,74,4,28367,36,457,3336552,2895
300153570500,30-015-35705,ALMOSTGON STATE 001,2014-03-01,75,5,25664,36,462,3362216,2931
300153570500,30-015-35705,ALMOSTGON STATE 001,2014-04-01,76,18,33034,83,480,3395250,3014
300153570500,30-015-35705,ALMOSTGON STATE 001,2014-05-01,77,0,28464,77,480,3423714,3091
300153570500,30-015-35705,ALMOSTGON STATE 001,2014-06-01,78,5,26407,55,485,3450121,3146
300153570500,30-015-35705,ALMOSTGON STATE 001,2014-07-01,79,3,27102,25,488,3477223,3171
300153570500,30-015-35705,ALMOSTGON STATE 001,2014-08-01,80,2,26719,69,490,3503942,3240
300153570500,30-015-35705,ALMOSTGON STATE 001,2014-09-01,81,2,25800,24,492,3529742,3264
300153570500,30-015-35705,ALMOSTGON STATE 001,2014-10-01,82,1,26299,6,493,3556041,3270
300153570500,30-015-35705,ALMOSTGON STATE 001,2014-11-01,83,5,23261,47,498,3579302,3317
300153570500,30-015-35705,ALMOSTGON STATE 001,2014-12-01,84,0,27562,0,498,3606864,3317
300153570500,30-015-35705,ALMOSTGON STATE 001,2015-01-01,85,0,25699,102,498,3632563,3419
300153570500,30-015-35705,ALMOSTGON STATE 001,2015-02-01,86,0,18293,0,498,3650856,3419
300153570500,30-015-35705,ALMOSTGON STATE 001,2015-03-01,87,0,11742,0,498,3662598,3419
300153570500,30-015-35705,ALMOSTGON STATE 001,2015-04-01,88,0,14552,0,498,3677150,3419
300153570500,30-015-35705,ALMOSTGON STATE 001,2015-05-01,89,0,4227,0,498,3681377,3419
300153570500,30-015-35705,ALMOSTGON STATE 001,2015-06-01,90,0,19796,0,498,3701173,3419
300153570500,30-015-35705,ALMOSTGON STATE 001,2015-07-01,91,0,26209,0,498,3727382,3419
300153570500,30-015-35705,ALMOSTGON STATE 001,2015-08-01,92,0,23157,0,498,3750539,3419
300153570500,30-015-35705,ALMOSTGON STATE 001,2015-09-01,93,0,21610,0,498,3772149,3419
300153570500,30-015-35705,ALMOSTGON STATE 001,2015-10-01,94,0,23279,0,498,3795428,3419
300153570500,30-015-35705,ALMOSTGON STATE 001,2015-11-01,95,0,25709,65,498,3821137,3484
300153570500,30-015-35705,ALMOSTGON STATE 001,2015-12-01,96,0,8663,180,498,3829800,3664
300153570500,30-015-35705,ALMOSTGON STATE 001,2016-01-01,97,0,0,0,498,3829800,3664
300153570500,30-015-35705,ALMOSTGON STATE 001,2016-02-01,98,0,0,0,498,3829800,3664
300153570500,30-015-35705,ALMOSTGON STATE 001,2016-03-01,99,0,0,0,498,3829800,3664
300153570500,30-015-35705,ALMOSTGON STATE 001,2016-04-01,100,0,0,0,498,3829800,3664
300153570500,30-015-35705,ALMOSTGON STATE 001,2016-05-01,101,0,0,0,498,3829800,3664
300153570500,30-015-35705,ALMOSTGON STATE 001,2016-06-01,102,0,0,0,498,3829800,3664
300153570500,30-015-35705,ALMOSTGON STATE 001,2016-07-01,103,0,0,0,498,3829800,3664
300153570500,30-015-35705,ALMOSTGON STATE 001,2016-08-01,104,0,8584,3,498,3838384,3667
300153570500,30-015-35705,ALMOSTGON STATE 001,2016-09-01,105,0,26193,55,498,3864577,3722
300153570500,30-015-35705,ALMOSTGON STATE 001,2016-10-01,106,0,25851,101,498,3890428,3823
300153570500,30-015-35705,ALMOSTGON STATE 001,2016-11-01,107,0,27862,93,498,3918290,3916
300153570500,30-015-35705,ALMOSTGON STATE 001,2016-12-01,108,0,26453,99,498,3944743,4015
300153570500,30-015-35705,ALMOSTGON STATE 001,2017-01-01,109,0,22636,45,498,3967379,4060
300153570500,30-015-35705,ALMOSTGON STATE 001,2017-02-01,110,0,15503,24,498,3982882,4084
300153570500,30-015-35705,ALMOSTGON STATE 001,2017-03-01,111,0,23340,85,498,4006222,4169
300153570500,30-015-35705,ALMOSTGON STATE 001,2017-04-01,112,0,21812,86,498,4028034,4255
300153570500,30-015-35705,ALMOSTGON STATE 001,2017-05-01,113,0,21349,75,498,4049383,4330
300153570500,30-015-35705,ALMOSTGON STATE 001,2017-06-01,114,0,14931,53,498,4064314,4383
300153570500,30-015-35705,ALMOSTGON STATE 001,2017-07-01,115,0,19840,80,498,4084154,4463
300153570500,30-015-35705,ALMOSTGON STATE 001,2017-08-01,116,8,13327,12,506,4097481,4475
300153570500,30-015-35705,ALMOSTGON STATE 001,2017-09-01,117,0,19892,100,506,4117373,4575
300153570500,30-015-35705,ALMOSTGON STATE 001,2017-10-01,118,0,16703,42,506,4134076,4617
300153570500,30-015-35705,ALMOSTGON STATE 001,2017-11-01,119,0,9282,17,506,4143358,4634
300153570500,30-015-35705,ALMOSTGON STATE 001,2017-12-01,120,0,9695,12,506,4153053,4646
300153570500,30-015-35705,ALMOSTGON STATE 001,2018-01-01,121,0,9618,0,506,4162671,4646
300153570500,30-015-35705,ALMOSTGON STATE 001,2018-02-01,122,0,9215,0,506,4171886,4646
300153570500,30-015-35705,ALMOSTGON STATE 001,2018-03-01,123,0,10963,6,506,4182849,4652
300153570500,30-015-35705,ALMOSTGON STATE 001,2018-04-01,124,0,11350,21,506,4194199,4673
300153570500,30-015-35705,ALMOSTGON STATE 001,2018-05-01,125,0,10838,11,506,4205037,4684
300153570500,30-015-35705,ALMOSTGON STATE 001,2018-06-01,126,0,9298,6,506,4214335,4690
300153570500,30-015-35705,ALMOSTGON STATE 001,2018-07-01,127,0,8420,0,506,4222755,4690
300153570500,30-015-35705,ALMOSTGON STATE 001,2018-08-01,128,12,7849,0,518,4230604,4690
300153570500,30-015-35705,ALMOSTGON STATE 001,2018-09-01,129,1,7281,0,519,4237885,4690
300153570500,30-015-35705,ALMOSTGON STATE 001,2018-10-01,130,0,10547,6,519,4248432,4696
300153570500,30-015-35705,ALMOSTGON STATE 001,2018-11-01,131,0,10187,2,519,4258619,4698
300153570500,30-015-35705,ALMOSTGON STATE 001,2018-12-01,132,5,9512,9,524,4268131,4707
300153570500,30-015-35705,ALMOSTGON STATE 001,2019-01-01,133,0,12632,8,524,4280763,4715
300153570500,30-015-35705,ALMOSTGON STATE 001,2019-02-01,134,0,10610,22,524,4291373,4737
300153570500,30-015-35705,ALMOSTGON STATE 001,2019-03-01,135,17,10768,12,541,4302141,4749
300153570500,30-015-35705,ALMOSTGON STATE 001,2019-04-01,136,0,9391,11,541,4311532,4760
300153570500,30-015-35705,ALMOSTGON STATE 001,2019-05-01,137,0,10495,6,541,4322027,4766
300153570500,30-015-35705,ALMOSTGON STATE 001,2019-06-01,138,0,7829,0,541,4329856,4766
300153570500,30-015-35705,ALMOSTGON STATE 001,2019-07-01,139,0,7384,0,541,4337240,4766
300153570500,30-015-35705,ALMOSTGON STATE 001,2019-08-01,140,0,7015,0,541,4344255,4766
300153570500,30-015-35705,ALMOSTGON STATE 001,2019-09-01,141,0,8455,0,541,4352710,4766
300153570500,30-015-35705,ALMOSTGON STATE 001,2019-10-01,142,0,8528,0,541,4361238,4766
300153570500,30-015-35705,ALMOSTGON STATE 001,2019-11-01,143,0,6207,0,541,4367445,4766
300153570500,30-015-35705,ALMOSTGON STATE 001,2019-12-01,144,0,9371,0,541,4376816,4766
300153570500,30-015-35705,ALMOSTGON STATE 001,2020-01-01,145,0,11213,0,541,4388029,4766
300153570500,30-015-35705,ALMOSTGON STATE 001,2020-02-01,146,0,10652,0,541,4398681,4766
300153570500,30-015-35705,ALMOSTGON STATE 001,2020-03-01,147,0,9925,0,541,4408606,4766
300153570500,30-015-35705,ALMOSTGON STATE 001,2020-04-01,148,0,7256,0,541,4415862,4766
300153570500,30-015-35705,ALMOSTGON STATE 001,2020-05-01,149,0,7258,0,541,4423120,4766
300153570500,30-015-35705,ALMOSTGON STATE 001,2020-06-01,150,0,7611,0,541,4430731,4766
300153570500,30-015-35705,ALMOSTGON STATE 001,2020-07-01,151,0,6660,0,541,4437391,4766
300153570500,30-015-35705,ALMOSTGON STATE 001,2020-08-01,152,0,10969,0,541,4448360,4766
300153570500,30-015-35705,ALMOSTGON STATE 001,2020-09-01,153,0,9043,0,541,4457403,4766
300153570500,30-015-35705,ALMOSTGON STATE 001,2020-10-01,154,0,6854,0,541,4464257,4766
300153570500,30-015-35705,ALMOSTGON STATE 001,2020-11-01,155,0,6559,0,541,4470816,4766
300153570500,30-015-35705,ALMOSTGON STATE 001,2020-12-01,156,0,7050,0,541,4477866,4766
300153570500,30-015-35705,ALMOSTGON STATE 001,2021-01-01,157,0,5491,0,541,4483357,4766
300153570500,30-015-35705,ALMOSTGON STATE 001,2021-02-01,158,0,4900,0,541,4488257,4766
300153570500,30-015-35705,ALMOSTGON STATE 001,2021-03-01,159,0,8164,0,541,4496421,4766
300153570500,30-015-35705,ALMOSTGON STATE 001,2021-04-01,160,0,8085,25,541,4504506,4791
300153570500,30-015-35705,ALMOSTGON STATE 001,2021-05-01,161,0,8992,22,541,4513498,4813
300153570500,30-015-35705,ALMOSTGON STATE 001,2021-06-01,162,0,6965,0,541,4520463,4813
300153570500,30-015-35705,ALMOSTGON STATE 001,2021-07-01,163,4,7073,0,545,4527536,4813
300153570500,30-015-35705,ALMOSTGON STATE 001,2021-08-01,164,0,6948,0,545,4534484,4813
300153570500,30-015-35705,ALMOSTGON STATE 001,2021-09-01,165,0,7076,0,545,4541560,4813
300153570500,30-015-35705,ALMOSTGON STATE 001,2021-10-01,166,0,7374,0,545,4548934,4813
300153570500,30-015-35705,ALMOSTGON STATE 001,2021-11-01,167,0,6134,0,545,4555068,4813
300153570500,30-015-35705,ALMOSTGON STATE 001,2021-12-01,168,0,6404,0,545,4561472,4813
300153570500,30-015-35705,ALMOSTGON STATE 001,2022-01-01,169,0,7098,0,545,4568570,4813
300153570500,30-015-35705,ALMOSTGON STATE 001,2022-02-01,170,0,5401,0,545,4573971,4813
300153570500,30-015-35705,ALMOSTGON STATE 001,2022-03-01,171,0,4209,0,545,4578180,4813
300153570500,30-015-35705,ALMOSTGON STATE 001,2022-04-01,172,0,6316,0,545,4584496,4813
300153570500,30-015-35705,ALMOSTGON STATE 001,2022-05-01,173,0,1870,0,545,4586366,4813
300153570500,30-015-35705,ALMOSTGON STATE 001,2022-06-01,174,0,7055,0,545,4593421,4813
300153570500,30-015-35705,ALMOSTGON STATE 001,2022-07-01,175,0,8165,0,545,4601586,4813
300153570500,30-015-35705,ALMOSTGON STATE 001,2022-08-01,176,0,1107,0,545,4602693,4813
300153570500,30-015-35705,ALMOSTGON STATE 001,2022-09-01,177,0,4406,0,545,4607099,4813
300153570500,30-015-35705,ALMOSTGON STATE 001,2022-10-01,178,0,7285,0,545,4614384,4813
300153570500,30-015-35705,ALMOSTGON STATE 001,2022-11-01,179,0,6235,0,545,4620619,4813
300153570500,30-015-35705,ALMOSTGON STATE 001,2022-12-01,180,0,5838,0,545,4626457,4813
300153570500,30-015-35705,ALMOSTGON STATE 001,2023-01-01,181,0,5757,0,545,4632214,4813
300153570500,30-015-35705,ALMOSTGON STATE 001,2023-02-01,182,0,5383,0,545,4637597,4813
300153570500,30-015-35705,ALMOSTGON STATE 001,2023-03-01,183,0,3025,0,545,4640622,4813
300153570500,30-015-35705,ALMOSTGON STATE 001,2023-04-01,184,0,4547,0,545,4645169,4813
300153570500,30-015-35705,ALMOSTGON STATE 001,2023-05-01,185,0,8840,0,545,4654009,4813
300153570500,30-015-35705,ALMOSTGON STATE 001,2023-06-01,186,0,6800,0,545,4660809,4813
300153570500,30-015-35705,ALMOSTGON STATE 001,2023-07-01,187,0,7208,0,545,4668017,4813
300153549500,30-015-35495,WOODY'S HOPE FEDERAL COM 001,2008-02-01,1,0,21647,185,0,21647,185
300153549500,30-015-35495,WOODY'S HOPE FEDERAL COM 001,2008-03-01,2,0,25861,159,0,47508,344
300153549500,30-015-35495,WOODY'S HOPE FEDERAL COM 001,2008-04-01,3,0,25485,135,0,72993,479
300153549500,30-015-35495,WOODY'S HOPE FEDERAL COM 001,2008-05-01,4,0,16797,82,0,89790,561
300153549500,30-015-35495,WOODY'S HOPE FEDERAL COM 001,2008-06-01,5,0,10203,47,0,99993,608
300153549500,30-015-35495,WOODY'S HOPE FEDERAL COM 001,2008-07-01,6,0,6845,34,0,106838,642
300153549500,30-015-35495,WOODY'S HOPE FEDERAL COM 001,2008-08-01,7,0,5254,25,0,112092,667
300153549500,30-015-35495,WOODY'S HOPE FEDERAL COM 001,2008-09-01,8,0,3926,26,0,116018,693
300153549500,30-015-35495,WOODY'S HOPE FEDERAL COM 001,2008-10-01,9,0,483,3,0,116501,696
300153549500,30-015-35495,WOODY'S HOPE FEDERAL COM 001,2008-11-01,10,0,1484,0,0,117985,696
300153549500,30-015-35495,WOODY'S HOPE FEDERAL COM 001,2008-12-01,11,0,5217,40,0,123202,736
300153549500,30-015-35495,WOODY'S HOPE FEDERAL COM 001,2009-01-01,12,0,3925,19,0,127127,755
300153549500,30-015-35495,WOODY'S HOPE FEDERAL COM 001,2009-02-01,13,0,4595,65,0,131722,820
300153549500,30-015-35495,WOODY'S HOPE FEDERAL COM 001,2009-03-01,14,0,209,2,0,131931,822
300153549500,30-015-35495,WOODY'S HOPE FEDERAL COM 001,2009-04-01,15,0,984,0,0,132915,822
300153549500,30-015-35495,WOODY'S HOPE FEDERAL COM 001,2009-05-01,16,0,249,0,0,133164,822
300153549500,30-015-35495,WOODY'S HOPE FEDERAL COM 001,2009-06-01,17,0,910,0,0,134074,822
300153549500,30-015-35495,WOODY'S HOPE FEDERAL COM 001,2009-07-01,18,0,179,0,0,134253,822
300153549500,30-015-35495,WOODY'S HOPE FEDERAL COM 001,2009-08-01,19,0,1705,0,0,135958,822
300153549500,30-015-35495,WOODY'S HOPE FEDERAL COM 001,2009-09-01,20,0,357,0,0,136315,822
300153549500,30-015-35495,WOODY'S HOPE FEDERAL COM 001,2009-10-01,21,0,7625,2,0,143940,824
300153549500,30-015-35495,WOODY'S HOPE FEDERAL COM 001,2009-11-01,22,0,4944,0,0,148884,824
300153549500,30-015-35495,WOODY'S HOPE FEDERAL COM 001,2009-12-01,23,0,2927,0,0,151811,824
300153549500,30-015-35495,WOODY'S HOPE FEDERAL COM 001,2010-01-01,24,0,2433,154,0,154244,978
300153549500,30-015-35495,WOODY'S HOPE FEDERAL COM 001,2010-02-01,25,0,2187,23,0,156431,1001
300153549500,30-015-35495,WOODY'S HOPE FEDERAL COM 001,2010-03-01,26,0,3203,23,0,159634,1024
300153549500,30-015-35495,WOODY'S HOPE FEDERAL COM 001,2010-04-01,27,0,2051,0,0,161685,1024
300153549500,30-015-35495,WOODY'S HOPE FEDERAL COM 001,2010-05-01,28,0,1604,22,0,163289,1046
300153549500,30-015-35495,WOODY'S HOPE FEDERAL COM 001,2010-06-01,29,0,1199,5,0,164488,1051
300153549500,30-015-35495,WOODY'S HOPE FEDERAL COM 001,2010-07-01,30,0,1647,13,0,166135,1064
300153549500,30-015-35495,WOODY'S HOPE FEDERAL COM 001,2010-08-01,31,0,2509,24,0,168644,1088
300153549500,30-015-35495,WOODY'S HOPE FEDERAL COM 001,2010-09-01,32,0,1820,17,0,170464,1105
300153549500,30-015-35495,WOODY'S HOPE FEDERAL COM 001,2010-10-01,33,0,1191,7,0,171655,1112
300153549500,30-015-35495,WOODY'S HOPE FEDERAL COM 001,2010-11-01,34,0,926,0,0,172581,1112
300153549500,30-015-35495,WOODY'S HOPE FEDERAL COM 001,2010-12-01,35,0,1331,60,0,173912,1172
300153549500,30-015-35495,WOODY'S HOPE FEDERAL COM 001,2011-01-01,36,0,864,0,0,174776,1172
300153549500,30-015-35495,WOODY'S HOPE FEDERAL COM 001,2011-02-01,37,0,830,0,0,175606,1172
300153549500,30-015-35495,WOODY'S HOPE FEDERAL COM 001,2011-03-01,38,0,981,0,0,176587,1172
300153549500,30-015-35495,WOODY'S HOPE FEDERAL COM 001,2011-04-01,39,0,855,0,0,177442,1172
300153549500,30-015-35495,WOODY'S HOPE FEDERAL COM 001,2011-05-01,40,0,1450,0,0,178892,1172
300153549500,30-015-35495,WOODY'S HOPE FEDERAL COM 001,2011-06-01,41,0,1195,0,0,180087,1172
300153549500,30-015-35495,WOODY'S HOPE FEDERAL COM 001,2011-07-01,42,0,905,18,0,180992,1190
300153549500,30-015-35495,WOODY'S HOPE FEDERAL COM 001,2011-08-01,43,0,1669,20,0,182661,1210
300153549500,30-015-35495,WOODY'S HOPE FEDERAL COM 001,2011-09-01,44,0,775,0,0,183436,1210
300153549500,30-015-35495,WOODY'S HOPE FEDERAL COM 001,2011-10-01,45,0,545,0,0,183981,1210
300153549500,30-015-35495,WOODY'S HOPE FEDERAL COM 001,2011-11-01,46,0,475,0,0,184456,1210
300153549500,30-015-35495,WOODY'S HOPE FEDERAL COM 001,2011-12-01,47,0,471,0,0,184927,1210
300153549500,30-015-35495,WOODY'S HOPE FEDERAL COM 001,2012-01-01,48,0,413,0,0,185340,1210
300153549500,30-015-35495,WOODY'S HOPE FEDERAL COM 001,2012-02-01,49,0,715,0,0,186055,1210
300153549500,30-015-35495,WOODY'S HOPE FEDERAL COM 001,2012-03-01,50,0,655,0,0,186710,1210
300153549500,30-015-35495,WOODY'S HOPE FEDERAL COM 001,2012-04-01,51,0,3194,137,0,189904,1347
300153549500,30-015-35495,WOODY'S HOPE FEDERAL COM 001,2012-05-01,52,0,2002,0,0,191906,1347
300153549500,30-015-35495,WOODY'S HOPE FEDERAL COM 001,2012-06-01,53,0,4985,60,0,196891,1407
300153549500,30-015-35495,WOODY'S HOPE FEDERAL COM 001,2012-07-01,54,0,3730,40,0,200621,1447
300153549500,30-015-35495,WOODY'S HOPE FEDERAL COM 001,2012-08-01,55,0,2588,25,0,203209,1472
300153549500,30-015-35495,WOODY'S HOPE FEDERAL COM 001,2012-09-01,56,0,1812,19,0,205021,1491
300153549500,30-015-35495,WOODY'S HOPE FEDERAL COM 001,2012-10-01,57,0,1666,19,0,206687,1510
300153549500,30-015-35495,WOODY'S HOPE FEDERAL COM 001,2012-11-01,58,0,1429,0,0,208116,1510
300153549500,30-015-35495,WOODY'S HOPE FEDERAL COM 001,2012-12-01,59,0,1167,0,0,209283,1510
300153549500,30-015-35495,WOODY'S HOPE FEDERAL COM 001,2013-01-01,60,0,796,0,0,210079,1510
300153549500,30-015-35495,WOODY'S HOPE FEDERAL COM 001,2013-02-01,61,0,909,0,0,210988,1510
300153549500,30-015-35495,WOODY'S HOPE FEDERAL COM 001,2013-03-01,62,0,998,0,0,211986,1510
300153549500,30-015-35495,WOODY'S HOPE FEDERAL COM 001,2013-04-01,63,0,1390,0,0,213376,1510
300153549500,30-015-35495,WOODY'S HOPE FEDERAL COM 001,2013-05-01,64,0,849,0,0,214225,1510
300153549500,30-015-35495,WOODY'S HOPE FEDERAL COM 001,2013-06-01,65,0,711,0,0,214936,1510
300153549500,30-015-35495,WOODY'S HOPE FEDERAL COM 001,2013-07-01,66,0,667,0,0,215603,1510
300153549500,30-015-35495,WOODY'S HOPE FEDERAL COM 001,2013-08-01,67,0,1253,8,0,216856,1518
300153549500,30-015-35495,WOODY'S HOPE FEDERAL COM 001,2013-09-01,68,0,979,0,0,217835,1518
300153549500,30-015-35495,WOODY'S HOPE FEDERAL COM 001,2013-10-01,69,0,735,0,0,218570,1518
300153549500,30-015-35495,WOODY'S HOPE FEDERAL COM 001,2013-11-01,70,0,650,0,0,219220,1518
300153549500,30-015-35495,WOODY'S HOPE FEDERAL COM 001,2013-12-01,71,0,825,0,0,220045,1518
300153549500,30-015-35495,WOODY'S HOPE FEDERAL COM 001,2014-01-01,72,0,895,0,0,220940,1518
300153549500,30-015-35495,WOODY'S HOPE FEDERAL COM 001,2014-02-01,73,0,971,8,0,221911,1526
300153549500,30-015-35495,WOODY'S HOPE FEDERAL COM 001,2014-03-01,74,0,844,0,0,222755,1526
300153549500,30-015-35495,WOODY'S HOPE FEDERAL COM 001,2014-04-01,75,0,641,20,0,223396,1546
300153549500,30-015-35495,WOODY'S HOPE FEDERAL COM 001,2014-05-01,76,0,667,0,0,224063,1546
300153549500,30-015-35495,WOODY'S HOPE FEDERAL COM 001,2014-06-01,77,0,570,0,0,224633,1546
300153549500,30-015-35495,WOODY'S HOPE FEDERAL COM 001,2014-07-01,78,0,577,0,0,225210,1546
300153549500,30-015-35495,WOODY'S HOPE FEDERAL COM 001,2014-08-01,79,0,494,0,0,225704,1546
300153549500,30-015-35495,WOODY'S HOPE FEDERAL COM 001,2014-09-01,80,0,1547,0,0,227251,1546
300153549500,30-015-35495,WOODY'S HOPE FEDERAL COM 001,2014-10-01,81,0,76,0,0,227327,1546
300153549500,30-015-35495,WOODY'S HOPE FEDERAL COM 001,2014-11-01,82,0,309,0,0,227636,1546
300153549500,30-015-35495,WOODY'S HOPE FEDERAL COM 001,2014-12-01,83,0,512,0,0,228148,1546
300153549500,30-015-35495,WOODY'S HOPE FEDERAL COM 001,2015-01-01,84,0,598,0,0,228746,1546
300153549500,30-015-35495,WOODY'S HOPE FEDERAL COM 001,2015-02-01,85,0,673,0,0,229419,1546
300153549500,30-015-35495,WOODY'S HOPE FEDERAL COM 001,2015-03-01,86,0,494,0,0,229913,1546
300153549500,30-015-35495,WOODY'S HOPE FEDERAL COM 001,2015-04-01,87,0,516,0,0,230429,1546
300153549500,30-015-35495,WOODY'S HOPE FEDERAL COM 001,2015-05-01,88,0,571,0,0,231000,1546
300153549500,30-015-35495,WOODY'S HOPE FEDERAL COM 001,2015-06-01,89,0,523,0,0,231523,1546
300153549500,30-015-35495,WOODY'S HOPE FEDERAL COM 001,2015-07-01,90,0,556,0,0,232079,1546
300153549500,30-015-35495,WOODY'S HOPE FEDERAL COM 001,2015-08-01,91,0,582,0,0,232661,1546
300153549500,30-015-35495,WOODY'S HOPE FEDERAL COM 001,2015-09-01,92,0,544,0,0,233205,1546
300153549500,30-015-35495,WOODY'S HOPE FEDERAL COM 001,2015-10-01,93,0,560,0,0,233765,1546
300153549500,30-015-35495,WOODY'S HOPE FEDERAL COM 001,2015-11-01,94,0,535,0,0,234300,1546
300153549500,30-015-35495,WOODY'S HOPE FEDERAL COM 001,2015-12-01,95,0,499,0,0,234799,1546
300153549500,30-015-35495,WOODY'S HOPE FEDERAL COM 001,2016-01-01,96,0,612,0,0,235411,1546
300153549500,30-015-35495,WOODY'S HOPE FEDERAL COM 001,2016-02-01,97,0,526,0,0,235937,1546
300153549500,30-015-35495,WOODY'S HOPE FEDERAL COM 001,2016-03-01,98,0,556,0,0,236493,1546
300153549500,30-015-35495,WOODY'S HOPE FEDERAL COM 001,2016-04-01,99,0,548,0,0,237041,1546
300153549500,30-015-35495,WOODY'S HOPE FEDERAL COM 001,2016-05-01,100,0,553,0,0,237594,1546
300153549500,30-015-35495,WOODY'S HOPE FEDERAL COM 001,2016-06-01,101,0,533,0,0,238127,1546
300153549500,30-015-35495,WOODY'S HOPE FEDERAL COM 001,2016-07-01,102,0,540,0,0,238667,1546
300153549500,30-015-35495,WOODY'S HOPE FEDERAL COM 001,2016-08-01,103,0,1034,0,0,239701,1546
300153549500,30-015-35495,WOODY'S HOPE FEDERAL COM 001,2016-09-01,104,0,2969,6,0,242670,1552
300153549500,30-015-35495,WOODY'S HOPE FEDERAL COM 001,2016-10-01,105,0,2915,18,0,245585,1570
300153549500,30-015-35495,WOODY'S HOPE FEDERAL COM 001,2016-11-01,106,0,1684,0,0,247269,1570
300153549500,30-015-35495,WOODY'S HOPE FEDERAL COM 001,2016-12-01,107,0,2137,0,0,249406,1570
300153549500,30-015-35495,WOODY'S HOPE FEDERAL COM 001,2017-01-01,108,0,1293,6,0,250699,1576
300153549500,30-015-35495,WOODY'S HOPE FEDERAL COM 001,2017-02-01,109,0,1210,6,0,251909,1582
300153549500,30-015-35495,WOODY'S HOPE FEDERAL COM 001,2017-03-01,110,0,1187,3,0,253096,1585
300153549500,30-015-35495,WOODY'S HOPE FEDERAL COM 001,2017-04-01,111,0,472,3,0,253568,1588
300153549500,30-015-35495,WOODY'S HOPE FEDERAL COM 001,2017-05-01,112,0,144,0,0,253712,1588
300153549500,30-015-35495,WOODY'S HOPE FEDERAL COM 001,2017-06-01,113,0,220,0,0,253932,1588
300153549500,30-015-35495,WOODY'S HOPE FEDERAL COM 001,2017-07-01,114,0,266,0,0,254198,1588
300153549500,30-015-35495,WOODY'S HOPE FEDERAL COM 001,2017-08-01,115,0,283,0,0,254481,1588
300153549500,30-015-35495,WOODY'S HOPE FEDERAL COM 001,2017-09-01,116,0,192,0,0,254673,1588
300153549500,30-015-35495,WOODY'S HOPE FEDERAL COM 001,2017-10-01,117,0,205,0,0,254878,1588
300153549500,30-015-35495,WOODY'S HOPE FEDERAL COM 001,2017-11-01,118,0,186,0,0,255064,1588
300153549500,30-015-35495,WOODY'S HOPE FEDERAL COM 001,2017-12-01,119,0,214,0,0,255278,1588
300153549500,30-015-35495,WOODY'S HOPE FEDERAL COM 001,2018-01-01,120,0,195,0,0,255473,1588
300153549500,30-015-35495,WOODY'S HOPE FEDERAL COM 001,2018-02-01,121,0,175,0,0,255648,1588
300153549500,30-015-35495,WOODY'S HOPE FEDERAL COM 001,2018-03-01,122,0,186,0,0,255834,1588
300153549500,30-015-35495,WOODY'S HOPE FEDERAL COM 001,2018-04-01,123,0,201,0,0,256035,1588
300153549500,30-015-35495,WOODY'S HOPE FEDERAL COM 001,2018-05-01,124,0,197,0,0,256232,1588
300153549500,30-015-35495,WOODY'S HOPE FEDERAL COM 001,2018-06-01,125,0,199,0,0,256431,1588
300153549500,30-015-35495,WOODY'S HOPE FEDERAL COM 001,2018-07-01,126,0,173,0,0,256604,1588
300153549500,30-015-35495,WOODY'S HOPE FEDERAL COM 001,2018-08-01,127,0,131,0,0,256735,1588
300153549500,30-015-35495,WOODY'S HOPE FEDERAL COM 001,2018-09-01,128,0,124,0,0,256859,1588
300153549500,30-015-35495,WOODY'S HOPE FEDERAL COM 001,2018-10-01,129,0,151,0,0,257010,1588
300153549500,30-015-35495,WOODY'S HOPE FEDERAL COM 001,2018-11-01,130,0,139,0,0,257149,1588
300153549500,30-015-35495,WOODY'S HOPE FEDERAL COM 001,2018-12-01,131,0,158,0,0,257307,1588
300153549500,30-015-35495,WOODY'S HOPE FEDERAL COM 001,2019-01-01,132,0,208,0,0,257515,1588
300153549500,30-015-35495,WOODY'S HOPE FEDERAL COM 001,2019-02-01,133,0,127,0,0,257642,1588
300153549500,30-015-35495,WOODY'S HOPE FEDERAL COM 001,2019-03-01,134,0,347,0,0,257989,1588
300153549500,30-015-35495,WOODY'S HOPE FEDERAL COM 001,2019-04-01,135,0,81,0,0,258070,1588
300153549500,30-015-35495,WOODY'S HOPE FEDERAL COM 001,2019-05-01,136,0,268,0,0,258338,1588
300153549500,30-015-35495,WOODY'S HOPE FEDERAL COM 001,2019-06-01,137,0,162,0,0,258500,1588
300153549500,30-015-35495,WOODY'S HOPE FEDERAL COM 001,2019-07-01,138,0,95,0,0,258595,1588
300153549500,30-015-35495,WOODY'S HOPE FEDERAL COM 001,2019-08-01,139,0,138,0,0,258733,1588
300153549500,30-015-35495,WOODY'S HOPE FEDERAL COM 001,2019-09-01,140,0,120,0,0,258853,1588
300153549500,30-015-35495,WOODY'S HOPE FEDERAL COM 001,2019-10-01,141,0,119,0,0,258972,1588
300153549500,30-015-35495,WOODY'S HOPE FEDERAL COM 001,2019-11-01,142,0,112,0,0,259084,1588
300153549500,30-015-35495,WOODY'S HOPE FEDERAL COM 001,2019-12-01,143,0,120,0,0,259204,1588
300153549500,30-015-35495,WOODY'S HOPE FEDERAL COM 001,2020-01-01,144,0,140,0,0,259344,1588
300153549500,30-015-35495,WOODY'S HOPE FEDERAL COM 001,2020-02-01,145,0,115,0,0,259459,1588
300153549500,30-015-35495,WOODY'S HOPE FEDERAL COM 001,2020-03-01,146,0,104,0,0,259563,1588
300153549500,30-015-35495,WOODY'S HOPE FEDERAL COM 001,2020-04-01,147,0,4,0,0,259567,1588
300153549500,30-015-35495,WOODY'S HOPE FEDERAL COM 001,2020-05-01,148,0,577,0,0,260144,1588
300153549500,30-015-35495,WOODY'S HOPE FEDERAL COM 001,2020-06-01,149,0,273,0,0,260417,1588
300153549500,30-015-35495,WOODY'S HOPE FEDERAL COM 001,2020-07-01,150,0,713,0,0,261130,1588
300153549500,30-015-35495,WOODY'S HOPE FEDERAL COM 001,2020-08-01,151,0,216,0,0,261346,1588
300153549500,30-015-35495,WOODY'S HOPE FEDERAL COM 001,2020-09-01,152,0,159,0,0,261505,1588
300153549500,30-015-35495,WOODY'S HOPE FEDERAL COM 001,2020-10-01,153,0,326,0,0,261831,1588
300153549500,30-015-35495,WOODY'S HOPE FEDERAL COM 001,2020-11-01,154,0,264,0,0,262095,1588
300153549500,30-015-35495,WOODY'S HOPE FEDERAL COM 001,2020-12-01,155,0,600,0,0,262695,1588
300153549500,30-015-35495,WOODY'S HOPE FEDERAL COM 001,2021-01-01,156,0,310,0,0,263005,1588
300153549500,30-015-35495,WOODY'S HOPE FEDERAL COM 001,2021-02-01,157,0,446,0,0,263451,1588
300153549500,30-015-35495,WOODY'S HOPE FEDERAL COM 001,2021-03-01,158,0,952,0,0,264403,1588
300153549500,30-015-35495,WOODY'S HOPE FEDERAL COM 001,2021-04-01,159,0,457,0,0,264860,1588
300153549500,30-015-35495,WOODY'S HOPE FEDERAL COM 001,2021-05-01,160,0,433,0,0,265293,1588
300153549500,30-015-35495,WOODY'S HOPE FEDERAL COM 001,2021-06-01,161,0,414,0,0,265707,1588
300153549500,30-015-35495,WOODY'S HOPE FEDERAL COM 001,2021-07-01,162,0,428,0,0,266135,1588
300153549500,30-015-35495,WOODY'S HOPE FEDERAL COM 001,2021-08-01,163,0,394,0,0,266529,1588
300153549500,30-015-35495,WOODY'S HOPE FEDERAL COM 001,2021-09-01,164,0,400,0,0,266929,1588
300153549500,30-015-35495,WOODY'S HOPE FEDERAL COM 001,2021-10-01,165,0,415,0,0,267344,1588
300153549500,30-015-35495,WOODY'S HOPE FEDERAL COM 001,2021-11-01,166,0,258,0,0,267602,1588
300153549500,30-015-35495,WOODY'S HOPE FEDERAL COM 001,2021-12-01,167,0,445,0,0,268047,1588
300153549500,30-015-35495,WOODY'S HOPE FEDERAL COM 001,2022-01-01,168,0,276,0,0,268323,1588
300153549500,30-015-35495,WOODY'S HOPE FEDERAL COM 001,2022-02-01,169,0,343,0,0,268666,1588
300153549500,30-015-35495,WOODY'S HOPE FEDERAL COM 001,2022-03-01,170,0,0,0,0,268666,1588
300153549500,30-015-35495,WOODY'S HOPE FEDERAL COM 001,2022-04-01,171,0,288,0,0,268954,1588
300153549500,30-015-35495,WOODY'S HOPE FEDERAL COM 001,2022-05-01,172,0,332,0,0,269286,1588
300153549500,30-015-35495,WOODY'S HOPE FEDERAL COM 001,2022-06-01,173,0,231,0,0,269517,1588
300153549500,30-015-35495,WOODY'S HOPE FEDERAL COM 001,2022-07-01,174,0,251,0,0,269768,1588
300153549500,30-015-35495,WOODY'S HOPE FEDERAL COM 001,2022-08-01,175,0,184,0,0,269952,1588
300153549500,30-015-35495,WOODY'S HOPE FEDERAL COM 001,2022-09-01,176,0,214,0,0,270166,1588
300153549500,30-015-35495,WOODY'S HOPE FEDERAL COM 001,2022-10-01,177,0,199,0,0,270365,1588
300153549500,30-015-35495,WOODY'S HOPE FEDERAL COM 001,2022-11-01,178,0,169,0,0,270534,1588
300153549500,30-015-35495,WOODY'S HOPE FEDERAL COM 001,2022-12-01,179,0,188,0,0,270722,1588
300153549500,30-015-35495,WOODY'S HOPE FEDERAL COM 001,2023-01-01,180,0,225,0,0,270947,1588
300153549500,30-015-35495,WOODY'S HOPE FEDERAL COM 001,2023-02-01,181,0,436,0,0,271383,1588
300153549500,30-015-35495,WOODY'S HOPE FEDERAL COM 001,2023-03-01,182,0,314,0,0,271697,1588
300153549500,30-015-35495,WOODY'S HOPE FEDERAL COM 001,2023-04-01,183,0,270,0,0,271967,1588
300153549500,30-015-35495,WOODY'S HOPE FEDERAL COM 001,2023-05-01,184,0,47,0,0,272014,1588
300153549500,30-015-35495,WOODY'S HOPE FEDERAL COM 001,2023-06-01,185,0,10,0,0,272024,1588
300153549500,30-015-35495,WOODY'S HOPE FEDERAL COM 001,2023-07-01,186,0,22,0,0,272046,1588
300153520800,30-015-35208,BEHIKE BKE STATE COM 001,2008-09-01,1,0,7133,129,0,7133,129
300153520800,30-015-35208,BEHIKE BKE STATE COM 001,2008-10-01,2,0,24112,219,0,31245,348
300153520800,30-015-35208,BEHIKE BKE STATE COM 001,2008-11-01,3,0,20162,118,0,51407,466
300153520800,30-015-35208,BEHIKE BKE STATE COM 001,2008-12-01,4,0,16896,92,0,68303,558
300153520800,30-015-35208,BEHIKE BKE STATE COM 001,2009-01-01,5,0,14970,63,0,83273,621
300153520800,30-015-35208,BEHIKE BKE STATE COM 001,2009-02-01,6,0,11751,42,0,95024,663
300153520800,30-015-35208,BEHIKE BKE STATE COM 001,2009-03-01,7,0,11621,34,0,106645,697
300153520800,30-015-35208,BEHIKE BKE STATE COM 001,2009-04-01,8,0,10061,47,0,116706,744
300153520800,30-015-35208,BEHIKE BKE STATE COM 001,2009-05-01,9,0,9813,39,0,126519,783
300153520800,30-015-35208,BEHIKE BKE STATE COM 001,2009-06-01,10,0,10910,86,0,137429,869
300153520800,30-015-35208,BEHIKE BKE STATE COM 001,2009-07-01,11,0,12037,86,0,149466,955
300153520800,30-015-35208,BEHIKE BKE STATE COM 001,2009-08-01,12,0,9482,25,0,158948,980
300153520800,30-015-35208,BEHIKE BKE STATE COM 001,2009-09-01,13,0,9478,65,0,168426,1045
300153520800,30-015-35208,BEHIKE BKE STATE COM 001,2009-10-01,14,0,8685,31,0,177111,1076
300153520800,30-015-35208,BEHIKE BKE STATE COM 001,2009-11-01,15,0,7765,28,0,184876,1104
300153520800,30-015-35208,BEHIKE BKE STATE COM 001,2009-12-01,16,0,7712,30,0,192588,1134
300153520800,30-015-35208,BEHIKE BKE STATE COM 001,2010-01-01,17,0,7194,16,0,199782,1150
300153520800,30-015-35208,BEHIKE BKE STATE COM 001,2010-02-01,18,0,6159,24,0,205941,1174
300153520800,30-015-35208,BEHIKE BKE STATE COM 001,2010-03-01,19,0,7141,31,0,213082,1205
300153520800,30-015-35208,BEHIKE BKE STATE COM 001,2010-04-01,20,0,6674,30,0,219756,1235
300153520800,30-015-35208,BEHIKE BKE STATE COM 001,2010-05-01,21,0,6513,44,0,226269,1279
300153520800,30-015-35208,BEHIKE BKE STATE COM 001,2010-06-01,22,0,5717,18,0,231986,1297
300153520800,30-015-35208,BEHIKE BKE STATE COM 001,2010-07-01,23,0,5453,28,0,237439,1325
300153520800,30-015-35208,BEHIKE BKE STATE COM 001,2010-08-01,24,0,4984,18,0,242423,1343
300153520800,30-015-35208,BEHIKE BKE STATE COM 001,2010-09-01,25,0,4192,11,0,246615,1354
300153520800,30-015-35208,BEHIKE BKE STATE COM 001,2010-10-01,26,0,4089,8,0,250704,1362
300153520800,30-015-35208,BEHIKE BKE STATE COM 001,2010-11-01,27,0,4024,0,0,254728,1362
300153520800,30-015-35208,BEHIKE BKE STATE COM 001,2010-12-01,28,0,3931,0,0,258659,1362
300153520800,30-015-35208,BEHIKE BKE STATE COM 001,2011-01-01,29,0,3022,0,0,261681,1362
300153520800,30-015-35208,BEHIKE BKE STATE COM 001,2011-02-01,30,0,2228,0,0,263909,1362
300153520800,30-015-35208,BEHIKE BKE STATE COM 001,2011-03-01,31,0,3062,0,0,266971,1362
300153520800,30-015-35208,BEHIKE BKE STATE COM 001,2011-04-01,32,0,4438,102,0,271409,1464
300153520800,30-015-35208,BEHIKE BKE STATE COM 001,2011-05-01,33,9,4982,142,9,276391,1606
300153520800,30-015-35208,BEHIKE BKE STATE COM 001,2011-06-01,34,14,4516,68,23,280907,1674
300153520800,30-015-35208,BEHIKE BKE STATE COM 001,2011-07-01,35,0,4184,25,23,285091,1699
300153520800,30-015-35208,BEHIKE BKE STATE COM 001,2011-08-01,36,0,3912,16,23,289003,1715
300153520800,30-015-35208,BEHIKE BKE STATE COM 001,2011-09-01,37,0,3832,32,23,292835,1747
300153520800,30-015-35208,BEHIKE BKE STATE COM 001,2011-10-01,38,0,3438,46,23,296273,1793
300153520800,30-015-35208,BEHIKE BKE STATE COM 001,2011-11-01,39,0,3571,42,23,299844,1835
300153520800,30-015-35208,BEHIKE BKE STATE COM 001,2011-12-01,40,0,3741,14,23,303585,1849
300153520800,30-015-35208,BEHIKE BKE STATE COM 001,2012-01-01,41,0,4031,2,23,307616,1851
300153520800,30-015-35208,BEHIKE BKE STATE COM 001,2012-02-01,42,0,3291,0,23,310907,1851
300153520800,30-015-35208,BEHIKE BKE STATE COM 001,2012-03-01,43,0,3588,0,23,314495,1851
300153520800,30-015-35208,BEHIKE BKE STATE COM 001,2012-04-01,44,0,3367,92,23,317862,1943
300153520800,30-015-35208,BEHIKE BKE STATE COM 001,2012-05-01,45,0,3149,0,23,321011,1943
300153520800,30-015-35208,BEHIKE BKE STATE COM 001,2012-06-01,46,0,4495,0,23,325506,1943
300153520800,30-015-35208,BEHIKE BKE STATE COM 001,2012-07-01,47,0,4020,141,23,329526,2084
300153520800,30-015-35208,BEHIKE BKE STATE COM 001,2012-08-01,48,0,3931,3,23,333457,2087
300153520800,30-015-35208,BEHIKE BKE STATE COM 001,2012-09-01,49,0,3129,0,23,336586,2087
300153520800,30-015-35208,BEHIKE BKE STATE COM 001,2012-10-01,50,0,2981,0,23,339567,2087
300153520800,30-015-35208,BEHIKE BKE STATE COM 001,2012-11-01,51,0,3144,0,23,342711,2087
300153520800,30-015-35208,BEHIKE BKE STATE COM 001,2012-12-01,52,0,2623,73,23,345334,2160
300153520800,30-015-35208,BEHIKE BKE STATE COM 001,2013-01-01,53,0,1977,0,23,347311,2160
300153520800,30-015-35208,BEHIKE BKE STATE COM 001,2013-02-01,54,0,2322,74,23,349633,2234
300153520800,30-015-35208,BEHIKE BKE STATE COM 001,2013-03-01,55,0,2093,0,23,351726,2234
300153520800,30-015-35208,BEHIKE BKE STATE COM 001,2013-04-01,56,0,2069,14,23,353795,2248
300153520800,30-015-35208,BEHIKE BKE STATE COM 001,2013-05-01,57,0,1483,0,23,355278,2248
300153520800,30-015-35208,BEHIKE BKE STATE COM 001,2013-06-01,58,0,1086,16,23,356364,2264
300153520800,30-015-35208,BEHIKE BKE STATE COM 001,2013-07-01,59,0,918,0,23,357282,2264
300153520800,30-015-35208,BEHIKE BKE STATE COM 001,2013-08-01,60,0,544,3,23,357826,2267
300153520800,30-015-35208,BEHIKE BKE STATE COM 001,2013-09-01,61,0,798,0,23,358624,2267
300153520800,30-015-35208,BEHIKE BKE STATE COM 001,2013-10-01,62,0,741,0,23,359365,2267
300153520800,30-015-35208,BEHIKE BKE STATE COM 001,2013-11-01,63,0,621,0,23,359986,2267
300153520800,30-015-35208,BEHIKE BKE STATE COM 001,2013-12-01,64,0,166,0,23,360152,2267
300153520800,30-015-35208,BEHIKE BKE STATE COM 001,2014-01-01,65,0,287,0,23,360439,2267
300153520800,30-015-35208,BEHIKE BKE STATE COM 001,2014-02-01,66,0,471,0,23,360910,2267
300153520800,30-015-35208,BEHIKE BKE STATE COM 001,2014-03-01,67,0,498,0,23,361408,2267
300153520800,30-015-35208,BEHIKE BKE STATE COM 001,2014-04-01,68,0,418,0,23,361826,2267
300153520800,30-015-35208,BEHIKE BKE STATE COM 001,2014-05-01,69,0,464,0,23,362290,2267
300153520800,30-015-35208,BEHIKE BKE STATE COM 001,2014-06-01,70,0,4162,0,23,366452,2267
300153520800,30-015-35208,BEHIKE BKE STATE COM 001,2014-07-01,71,0,2072,0,23,368524,2267
300153520800,30-015-35208,BEHIKE BKE STATE COM 001,2014-08-01,72,0,1449,0,23,369973,2267
300153520800,30-015-35208,BEHIKE BKE STATE COM 001,2014-09-01,73,0,1132,0,23,371105,2267
300153520800,30-015-35208,BEHIKE BKE STATE COM 001,2014-10-01,74,0,1044,0,23,372149,2267
300153520800,30-015-35208,BEHIKE BKE STATE COM 001,2014-11-01,75,0,836,0,23,372985,2267
300153520800,30-015-35208,BEHIKE BKE STATE COM 001,2014-12-01,76,0,693,227,23,373678,2494
300153520800,30-015-35208,BEHIKE BKE STATE COM 001,2015-01-01,77,0,613,0,23,374291,2494
300153520800,30-015-35208,BEHIKE BKE STATE COM 001,2015-02-01,78,0,462,0,23,374753,2494
300153520800,30-015-35208,BEHIKE BKE STATE COM 001,2015-03-01,79,0,435,0,23,375188,2494
300153520800,30-015-35208,BEHIKE BKE STATE COM 001,2015-04-01,80,0,385,0,23,375573,2494
300153520800,30-015-35208,BEHIKE BKE STATE COM 001,2015-05-01,81,0,411,0,23,375984,2494
300153520800,30-015-35208,BEHIKE BKE STATE COM 001,2015-06-01,82,0,338,0,23,376322,2494
300153520800,30-015-35208,BEHIKE BKE STATE COM 001,2015-07-01,83,0,343,0,23,376665,2494
300153520800,30-015-35208,BEHIKE BKE STATE COM 001,2015-08-01,84,0,292,0,23,376957,2494
300153520800,30-015-35208,BEHIKE BKE STATE COM 001,2015-09-01,85,0,444,0,23,377401,2494
300153520800,30-015-35208,BEHIKE BKE STATE COM 001,2015-10-01,86,0,404,0,23,377805,2494
300153520800,30-015-35208,BEHIKE BKE STATE COM 001,2015-11-01,87,0,307,0,23,378112,2494
300153520800,30-015-35208,BEHIKE BKE STATE COM 001,2015-12-01,88,0,273,0,23,378385,2494
300153520800,30-015-35208,BEHIKE BKE STATE COM 001,2016-01-01,89,0,350,0,23,378735,2494
300153520800,30-015-35208,BEHIKE BKE STATE COM 001,2016-02-01,90,0,290,0,23,379025,2494
300153520800,30-015-35208,BEHIKE BKE STATE COM 001,2016-03-01,91,0,249,0,23,379274,2494
300153520800,30-015-35208,BEHIKE BKE STATE COM 001,2016-04-01,92,0,228,0,23,379502,2494
300153520800,30-015-35208,BEHIKE BKE STATE COM 001,2016-05-01,93,0,169,0,23,379671,2494
300153520800,30-015-35208,BEHIKE BKE STATE COM 001,2016-06-01,94,0,214,0,23,379885,2494
300153520800,30-015-35208,BEHIKE BKE STATE COM 001,2016-07-01,95,0,187,0,23,380072,2494
300153520800,30-015-35208,BEHIKE BKE STATE COM 001,2016-08-01,96,0,123,0,23,380195,2494
300153520800,30-015-35208,BEHIKE BKE STATE COM 001,2016-09-01,97,0,291,0,23,380486,2494
300153520800,30-015-35208,BEHIKE BKE STATE COM 001,2016-10-01,98,0,331,0,23,380817,2494
300153520800,30-015-35208,BEHIKE BKE STATE COM 001,2016-11-01,99,0,367,0,23,381184,2494
300153520800,30-015-35208,BEHIKE BKE STATE COM 001,2016-12-01,100,0,243,0,23,381427,2494
300153520800,30-015-35208,BEHIKE BKE STATE COM 001,2017-01-01,101,0,426,0,23,381853,2494
300153520800,30-015-35208,BEHIKE BKE STATE COM 001,2017-02-01,102,0,164,0,23,382017,2494
300153520800,30-015-35208,BEHIKE BKE STATE COM 001,2017-03-01,103,0,464,0,23,382481,2494
300153520800,30-015-35208,BEHIKE BKE STATE COM 001,2017-04-01,104,0,963,0,23,383444,2494
300153520800,30-015-35208,BEHIKE BKE STATE COM 001,2017-05-01,105,0,0,0,23,383444,2494
300153520800,30-015-35208,BEHIKE BKE STATE COM 001,2017-06-01,106,0,4033,36,23,387477,2530
300153520800,30-015-35208,BEHIKE BKE STATE COM 001,2017-07-01,107,0,3994,0,23,391471,2530
300153520800,30-015-35208,BEHIKE BKE STATE COM 001,2017-08-01,108,0,3928,0,23,395399,2530
300153520800,30-015-35208,BEHIKE BKE STATE COM 001,2017-09-01,109,0,4187,27,23,399586,2557
300153520800,30-015-35208,BEHIKE BKE STATE COM 001,2017-10-01,110,0,3391,12,23,402977,2569
300153520800,30-015-35208,BEHIKE BKE STATE COM 001,2017-11-01,111,0,2736,0,23,405713,2569
300153520800,30-015-35208,BEHIKE BKE STATE COM 001,2017-12-01,112,0,2530,0,23,408243,2569
300153520800,30-015-35208,BEHIKE BKE STATE COM 001,2018-01-01,113,0,3755,0,23,411998,2569
300153520800,30-015-35208,BEHIKE BKE STATE COM 001,2018-02-01,114,0,2351,39,23,414349,2608
300153520800,30-015-35208,BEHIKE BKE STATE COM 001,2018-03-01,115,0,2798,6,23,417147,2614
300153520800,30-015-35208,BEHIKE BKE STATE COM 001,2018-04-01,116,0,2703,0,23,419850,2614
300153520800,30-015-35208,BEHIKE BKE STATE COM 001,2018-05-01,117,0,2384,0,23,422234,2614
300153520800,30-015-35208,BEHIKE BKE STATE COM 001,2018-06-01,118,0,3073,0,23,425307,2614
300153520800,30-015-35208,BEHIKE BKE STATE COM 001,2018-07-01,119,0,2832,0,23,428139,2614
300153520800,30-015-35208,BEHIKE BKE STATE COM 001,2018-08-01,120,0,1820,0,23,429959,2614
300153520800,30-015-35208,BEHIKE BKE STATE COM 001,2018-09-01,121,0,1545,0,23,431504,2614
300153520800,30-015-35208,BEHIKE BKE STATE COM 001,2018-10-01,122,0,1513,0,23,433017,2614
300153520800,30-015-35208,BEHIKE BKE STATE COM 001,2018-11-01,123,2,2650,35,25,435667,2649
300153520800,30-015-35208,BEHIKE BKE STATE COM 001,2018-12-01,124,3,2450,22,28,438117,2671
300153520800,30-015-35208,BEHIKE BKE STATE COM 001,2019-01-01,125,3,2595,11,31,440712,2682
300153520800,30-015-35208,BEHIKE BKE STATE COM 001,2019-02-01,126,0,2517,19,31,443229,2701
300153520800,30-015-35208,BEHIKE BKE STATE COM 001,2019-03-01,127,0,2639,3,31,445868,2704
300153520800,30-015-35208,BEHIKE BKE STATE COM 001,2019-04-01,128,0,2391,0,31,448259,2704
300153520800,30-015-35208,BEHIKE BKE STATE COM 001,2019-05-01,129,0,2260,0,31,450519,2704
300153520800,30-015-35208,BEHIKE BKE STATE COM 001,2019-06-01,130,0,2031,6,31,452550,2710
300153520800,30-015-35208,BEHIKE BKE STATE COM 001,2019-07-01,131,0,1975,0,31,454525,2710
300153520800,30-015-35208,BEHIKE BKE STATE COM 001,2019-08-01,132,0,1762,0,31,456287,2710
300153520800,30-015-35208,BEHIKE BKE STATE COM 001,2019-09-01,133,0,1368,0,31,457655,2710
300153520800,30-015-35208,BEHIKE BKE STATE COM 001,2019-10-01,134,0,1380,0,31,459035,2710
300153520800,30-015-35208,BEHIKE BKE STATE COM 001,2019-11-01,135,0,1207,0,31,460242,2710
300153520800,30-015-35208,BEHIKE BKE STATE COM 001,2019-12-01,136,0,1099,0,31,461341,2710
300153520800,30-015-35208,BEHIKE BKE STATE COM 001,2020-01-01,137,0,919,54,31,462260,2764
300153520800,30-015-35208,BEHIKE BKE STATE COM 001,2020-02-01,138,0,733,0,31,462993,2764
300153520800,30-015-35208,BEHIKE BKE STATE COM 001,2020-03-01,139,0,435,0,31,463428,2764
300153520800,30-015-35208,BEHIKE BKE STATE COM 001,2020-04-01,140,0,341,0,31,463769,2764
300153520800,30-015-35208,BEHIKE BKE STATE COM 001,2020-05-01,141,0,3,0,31,463772,2764
300153520800,30-015-35208,BEHIKE BKE STATE COM 001,2020-06-01,142,0,0,0,31,463772,2764
300153520800,30-015-35208,BEHIKE BKE STATE COM 001,2020-07-01,143,0,0,0,31,463772,2764
300153520800,30-015-35208,BEHIKE BKE STATE COM 001,2020-08-01,144,0,0,0,31,463772,2764
300153520800,30-015-35208,BEHIKE BKE STATE COM 001,2020-09-01,145,0,0,0,31,463772,2764
300153520800,30-015-35208,BEHIKE BKE STATE COM 001,2020-10-01,146,0,0,0,31,463772,2764
300153520800,30-015-35208,BEHIKE BKE STATE COM 001,2020-11-01,147,0,12,0,31,463784,2764
300153520800,30-015-35208,BEHIKE BKE STATE COM 001,2020-12-01,148,0,5,0,31,463789,2764
300153520800,30-015-35208,BEHIKE BKE STATE COM 001,2021-01-01,149,0,0,0,31,463789,2764
300153520800,30-015-35208,BEHIKE BKE STATE COM 001,2021-02-01,150,0,0,0,31,463789,2764
300153520800,30-015-35208,BEHIKE BKE STATE COM 001,2021-03-01,151,0,1704,0,31,465493,2764
300153520800,30-015-35208,BEHIKE BKE STATE COM 001,2021-04-01,152,0,1057,0,31,466550,2764
300153520800,30-015-35208,BEHIKE BKE STATE COM 001,2021-05-01,153,0,518,0,31,467068,2764
300153520800,30-015-35208,BEHIKE BKE STATE COM 001,2021-06-01,154,0,347,0,31,467415,2764
300153520800,30-015-35208,BEHIKE BKE STATE COM 001,2021-07-01,155,0,286,0,31,467701,2764
300153520800,30-015-35208,BEHIKE BKE STATE COM 001,2021-08-01,156,0,276,0,31,467977,2764
300153520800,30-015-35208,BEHIKE BKE STATE COM 001,2021-09-01,157,0,239,0,31,468216,2764
300153520800,30-015-35208,BEHIKE BKE STATE COM 001,2021-10-01,158,0,215,0,31,468431,2764
300153520800,30-015-35208,BEHIKE BKE STATE COM 001,2021-11-01,159,0,192,0,31,468623,2764
300153520800,30-015-35208,BEHIKE BKE STATE COM 001,2021-12-01,160,0,180,0,31,468803,2764
300153520800,30-015-35208,BEHIKE BKE STATE COM 001,2022-01-01,161,0,193,0,31,468996,2764
300153520800,30-015-35208,BEHIKE BKE STATE COM 001,2022-02-01,162,0,173,0,31,469169,2764
300153520800,30-015-35208,BEHIKE BKE STATE COM 001,2022-03-01,163,0,184,0,31,469353,2764
300153520800,30-015-35208,BEHIKE BKE STATE COM 001,2022-04-01,164,0,190,0,31,469543,2764
300153520800,30-015-35208,BEHIKE BKE STATE COM 001,2022-05-01,165,0,209,0,31,469752,2764
300153520800,30-015-35208,BEHIKE BKE STATE COM 001,2022-06-01,166,0,202,0,31,469954,2764
300153520800,30-015-35208,BEHIKE BKE STATE COM 001,2022-07-01,167,0,202,0,31,470156,2764
300153520800,30-015-35208,BEHIKE BKE STATE COM 001,2022-08-01,168,0,186,0,31,470342,2764
300153520800,30-015-35208,BEHIKE BKE STATE COM 001,2022-09-01,169,0,178,0,31,470520,2764
300153520800,30-015-35208,BEHIKE BKE STATE COM 001,2022-10-01,170,0,180,0,31,470700,2764
300153520800,30-015-35208,BEHIKE BKE STATE COM 001,2022-11-01,171,0,178,0,31,470878,2764
300153520800,30-015-35208,BEHIKE BKE STATE COM 001,2022-12-01,172,0,140,0,31,471018,2764
300153520800,30-015-35208,BEHIKE BKE STATE COM 001,2023-01-01,173,0,182,0,31,471200,2764
300153520800,30-015-35208,BEHIKE BKE STATE COM 001,2023-02-01,174,0,162,0,31,471362,2764
300153520800,30-015-35208,BEHIKE BKE STATE COM 001,2023-03-01,175,0,176,0,31,471538,2764
300153520800,30-015-35208,BEHIKE BKE STATE COM 001,2023-04-01,176,0,156,0,31,471694,2764
300153520800,30-015-35208,BEHIKE BKE STATE COM 001,2023-05-01,177,0,89,0,31,471783,2764
300153520800,30-015-35208,BEHIKE BKE STATE COM 001,2023-06-01,178,0,93,0,31,471876,2764
300153520800,30-015-35208,BEHIKE BKE STATE COM 001,2023-07-01,179,0,81,0,31,471957,2764